-----------------------------------------------------------------------------------------------------------------%-----------------------------------------------%--------------
-----------------------------------------------------------------------------------------------------------------|-----------------------------------------------|--------------
-----------------------------------------------------------------------------------------------------------------|-----------------------------------------------|--------------
SSSSSSSSSSSSSSSS-------------------SSSSSSSSSSSSS-----------------------------------------------------------------|-----------------------------------------------|--------------
SSSSSS-------S-----------------------------------------------------k---------------------------------------------|-----------------------------------------------|--------------
-SS-SS----S--S--------------------------------------------------%%%%---------------------------------------------|-----------------------------------------------|--------------
---------------------------------o----U-----o---------r----------||---r---------------r---------------r----------|----U-------------------------------r--------o-|----r---------
--------------------------------------%%-------------%%%--------%%%%%%%%%----------%%%%%--------%%%%%%%%%--------|%%%%%%--------------%%--------%%%%%%%%--------%%%%%%%%--------
--------------------------------------||--------------|----------|||||||------------|||----------|||||||---------|-||||---------------||---------||||||----------||||||---------
-K-----------ooo----------------------||--------------|----------|||||||------------|||----------|||||||---------|-||||---------------||---------||||||----------||||||---------
-------------%%%----------------QS----||--------------SS---------|||||||o---TT------||SS----TT---|||||QQU-------QQQS|||SU--------TTT--||---------||||||Q@--------|||||QQQQQ-----
--------------|-----------------------||--------------------TT---|||TT||----TT------||------TT---|TT||------TT------|||-----##---TTT--||----TT---|TT|||-----TT---|TT||----------
--------------|-----------------------||--------------------TT---|||TT||----TT------||------TT---|TT||------TT------|||-----##---TTTT-||----TT---|TT|||-----TT---|TT||----------
--------------|-----------g-g--k------|k-------k-------k----TT-k-|k|TT||-yk-TT------||-ggg--TT---|TT||-ggg--TT-k-g--|||gg---##---TTTT-|g----TT-k-|TT|||--gg-TT---|TT||---g-----g
---------%%%%-|-XXXXXXXXXXXXXXXXXXXXXXXXXXX-XXXXXXXXXXXXXXXXXXXXXXXXXXXXXXXXXXXXXXXXXXXXXXXXXXXXXXXXXXXXXXXXXXXXXXXXXXXXXXXXXXXXXXXXXXXXXXXXXXXXXXXXXXXXXXXXXXXXXXXXXXXXXXXXXXXX
----------||--|-XXXXXXXXXXXXXXXXXXXXXXXXXXXXXXXXXXXXXXXXXXXXXXXXXXXXXXXXXXXXXXXXXXXXXXXXXXXXXXXXXXXXXXXXXXXXXXXXXXXXXXXXXXXXXXXXXXXXXXXXXXXXXXXXXXXXXXXXXXXXXXXXXXXXXXXXXXXXXXXX
