------------------------------------------------------------------------------------------------------------------------------------------------------------------------------------------------
------------------------------------------------------------------------------------------------------------------------------------------------------------------------------------------------
------------------------------------------------------------------------------------------------------------------------------------------------------------------------------------------------
--------------------------------SSS-------------SSSSSSSSSSSSSS----------------------------------SSSSSSSSS----------SSSSSSSS---------------------SSSSSSSS--------SSSSSSSSSSSSSSS-----------------
------------------------------------------------------------------------------------------------------------------------------------------------------------------------------------------------
------------------------------------------------------------------------------------------------------------------------------------------------------------------------------------------------
--------%%%%%%%%---------------S------------------------------------SSS----------ooo--SSSS----So----------------oooo---------SSSSooSSSSSSSS--SSS-----------------oo-----oo------SooSSS-------SSS
---------||||||---------------------------------------------------------------------------------------------------------------------------------------------------------------------------------
---------||||||-------------------------------------------------------------------------------------------------------------------------------o-------------------------------------------------
---------||||||-----------------------------------------------------------------o-------------------------------o--------------oo-----------------------------------------------g---------------
------%%%%%%%%%%-------------U-o--------------------------------------------------------------------------------S---o-----------S---Q--------US---------------------------------##QQQ--------USS
-------||||||||---------------------------------------------------------------------------------------------------------------------------------------------------------------------------------
-------||||||||--------------------------##---------tt---#---------------------------------------------------------------#------------------------------------------tt---#-#--------------------
-------||||||||----gg------------------k-##----g----tt--------k------kkk------k------g---------------g---k----g---------###--------ggggg----------g---g-------------tt---###----------g-#-k-----
XXXXXXXXXXXXXXXXXXXXXXXXXXXXXXXXXXXXXXXXXXXXX-XXXXXXXXXXXXXXXXXXXXXXXXXXXXXXXXXXXXXXXXXXXXXXXXXXXXXXXXXXXXXXXXXXXXXXXXXXXXXXXXXXXXXXXXXXXXXXXXXXXXXXXXXXXXXXXXXXXXXXXXXXXXXXXXXXXXXXXXXXXXXXXXXX
XXXXXXXXXXXXXXXXXXXXXXXXXXXXXXXX-XXXXXXXXXXXX-XXXXXXXXXXXXXXXXXXXXXXXXXXXXXXXXXXXXXXXXXXXXXXXXXXXXXXXXXXXXXXXXXXXXXXXXXXXXXXXXXXXXXXXXXXXXXXXXXXXXXXXXXXXXXXXXXXXXXXXXXXXXXXXXXXXXXXXXXXXXXXXXXX
