------------------------------------------------------------------------------------------------------------------------------------------------------------------------------------------------
------------------------------------------------------------------------------------------------------------------------------------------------------------------------------------------------
------------------------------------------------------------------------------------------------------------------------------------------------------------------------------------------------
----------------SSSSS----------------------------------------------------------------------------------------------------------------------------S----------------------------------------------
------------------------------------------------------------------------------------------------------------------------------------------------------------------------------------------------
------------------------------------------ooooo---------------------------------------------------------o---------------------------------------------------------------------------------------
--------%%%%%%%%--------------------------------%----------------------------------------------------------------------------------------------------------------------------------------------o
---------||||||----------------#-oo-----------o-|--------------#-----------------------------------%--------------------------------------------------------------------------------------------
---------||||||---------------##----------------|-------------##-----------------------------------|----------------------------------------------------------------#----------------------#----
---------||||||-------------#-##-----------##---|-------------##-----------------------------------|---------------------------------------------------------------------------------------#----
------%%%%%%%%%%-----------#####----------###---S--------S%S-k-#---------TT-------#----------------|--tt-----------------------------2------------#-------------------------Sooo---------TT#----
-------||||||||------------#####----------###-------------|----o---------TT------------------------|--tt-----------------T#-------------TT------#------t---------------------------------TT-----
-------||||||||--------t--######--------#####-------------|--###---------TT------------------------|--tt-----------------###------B-----TT----T-#-----tt---------------B----------------####----
-------||||||||--------t--######--gg---######-------------|---##--k--g---TT---#T--#----------kkg---|--tt-----g-g--kgg---#TT#k-----g----kTt---gTT#-----tt----gg-g--gg---b-------g--kk----####----
XXXXXXXXXXXXXXXXXXXXXXXXXXXXXXXXXXXXXXXXXXXXX----%%%%X-XXXXXXXXXXXXXXXXXXXXXXXXXXXXXXXXXXXXXXXXXXXXXXXXXXXXXXXXXXXXXXXXXXXXXXXXXXXXXXXXXXXXXXXXXXXXXXXXXXXXXXXXXXXXXXXXXXXXXXXXXXXXXXXXXXXXXXXXX
XXXXXXXXXXXXXXXXXXXXXXXXXXXXXXX-XXXXXXXXXXXXX-----||----XXXXXXX-XXXXXXXXXXXXXXXXXXXXXXXXXXXXXXXXXXXXXXXXXXXXXXXXXXXXXXXXXXXXXXXXXXXXXXXXXXXXXXXXXXXXXXXXXXXXXXXXXXXXXXXXXXXXXXXXXXXXXXXXXXXXXXXX
