------------------------------------------------------------------------------------------------------------------------------------------------------------------------------------------------
------------------------------------------------------------------------------------------------------------------------------------------------------S-----------------------------------------
------------------------------------------------------------------------------------------------------------------------------------------------------------------------------------------------
------------------------------------------------------------------------------------------------SSSSSSSS----------------------------------------SSSSSS------------------------------------------
------------------------------------------------------------------------------------------------------------------------------------------------------------------------------------------------
------------------------------------------------------------------------------------------------------------------------------------------------------------------------------------------------
--------%%%%%%%%-------------------------------------ooSo-------------SSSS--------o-----------------------------S-----------------o------------o-------SS---------------------------------------
---------||||||--------------U-----------------------%%-----------------------------------------SS--------------S------------------------------------%----------S-------------------------------
---------||||||--------------------------------------||-----------------------------------------S---------------S---B--------------------------------|----------S-------------------------------
---------||||||--------------------------------------||------------------------------------------------------------------------------------#---------|------------------------------------------
------%%%%%%%%%%--TT---------------------------------|tt---------------------o-----------TT----------------------------------------------#####-------|------------------------------------------
-------||||||||---TT----TT---------------------------|tt---------------------#-----------TT----------------------------------------------#####-------ttt---------------------------------TT---#-
-------||||||||---TT----TT----------------#----------ttt---------------------------------TT----------------------------------#----------######-------ttt-----------------TT---U----------TT---#-
-------||||||||---TT--k-TT-----------g----#---##-----ttt---k-g----gg---------k----k---y-###-----g----------kkkk--------------#-----k---#######-------ttt----ggg---gg-----TT---g---kggg---TT---#-
XXXXXXXXXXXXXXXXXXXXXXXXXXXXXXXXXXXXXXXXXXXXXXXXXXXXXXXXXXXXXXXXXXXXXXXXXXXXXXXXXXXXXXXXXXXXXXXXXXXXXXXXXXXXXXXXXXXXXXXXXXXXXXXXXXXXXXXXXXXXXXXXXXXXXXXXXXXXXXXXXXXXXXXXXXXXXXXXXXXXXXXXXXXXXXXX
XXXXXXXXXXXXXXXXXXXXXXXXXXXXXXXXXXXXXXXXXXXXXXXXXXXXXXXXXXXXXXXXXXXXXXXXXXXXXXXXXXXXXXXXXXXXXXXXXXXXXXXXXXXXXXXXXXXXXXXXXXXXXXXXXXXXXXXXXXXXXXXXXXXXXXXXXXXXXXXXXXXXXXXXXXXXXXXXXXXXXXXXXXXXXXXX
