------------------------------------------------------------------------------------------------------------------------------------------------------------------------------------------------
------------------------------------------------------------------------------------------------------------------------------------------------------------------------------------------------
------------------------------------------------------------------------------------------------------------------------------------------------------------------------------------------------
--------------------SSSSS------------------------SSSSSSSSS----------------------SSSSSSSSSS------SSSSSSSSSSSSSS------------------SSSSSSSSSSSSSS--SSSSSSSSS---------------------------------------
------------------------------------------------------------------------------------------------------------------------------------------------------------------------------------------------
------------------------------------------------------------------------------------------------------------------------------------------------------------------------------------------------
--------%%%%%%%%--------S--------ooo----oo-----S-ooo--------------SSSSSS------S-----------------SSoSS--------SSS--------SS--------------------------------------SSSS@SSS-----SSS----------------
---------||||||---%%%%%-------------------------------------------------------------------------------------------------------------------------------------------------------------------------
---------||||||----|||--------------------------------------------------------------------------------------------------------------------------------------------------------------------------
---------||||||----|||----S-----o---------------oo----------------------------------------------ooooo----------o--------------------------------------------------------------------------------
------%%%%%%%%%%---|||------------------------------------#---------S---------------------------SSSSS-----------------------------------------------------------SSQQQ--------US-----------------
-------||||||||----|||-----------------------------------##---------------#------------------------------#-------------------------------------------------------------------------------TT-----
-------||||||||----|tt---#-------------------------------##---------------#-------------------TT--------##-------------------------------TT----------------------------------------------TT-----
-------||||||||----|tt---#---gr------k----#-------------###---------gggg--#-------------------TT------g###k--------------------g---------TT---k---k---g-------g-----gggg--k-------kggg-k-TT---kg
XXXXXXXXXXXXXXXX--XXXXXXXXXXXXXXXXXXXXXXXXXXXXXXXXXXXXXXXXXXXXXXXXXXXXXXXXXXXXXXXXXXXXXXXXXXXXXXXXXXXXXXXXXXXXXXXXXXXXXXXXXXXXXXXXXXXXXXXXXXXXXXXXXXXXXXXXXXXXXXXXXXXXXXXXXXXXXXXXXXXXXXXXXXXXXX
XXXXXXXXXXXXXXXXX-XXXXXXXXXXXXXXXXXXXXXXXXXXXXXXXXXXXXXXXXXXXXXXXXXXXXXXXXXXXXXXXXXXXXXXXXXXXXXXXXXXXXXXXXXXXXXXXXXXXXXXXXXXXXXXXXXXXXXXXXXXXXXXXXXXXXXXXXXXXXXXXXXXXXXXXXXXXXXXXXXXXXXXXXXXXXXX
