------------------------------------------------------------------------------------------------------------------------------------------------------------------------------------------------
------------------------------------------------------------------------------------------------------------------------------------------------------------------------------------------------
------------------------------------------------------------------------------------------------------------------------------------------------------------------------------------------------
--------------------------------SSSSSSSSSS------------------------------------------------------SSSSSSSSSSSSSSSS--------------------------------SSSSSSSSSSS-------------------------------------
------------------------------------------------------------------------------------------------SS---S------------------------------------------------------------------------------------------
------------------------------------------------------------------------------------------------SS-------------S--------------------------------------------------------------------------------
--------%%%%%%%%------Soo--------oo-----So-------ooo----------SS-----------------o----SSSS---SSS----------SSSSSSSSooS---oo----oo--------------------------------oooo---Soo---SSo-ooSS---------SS
---------||||||---------------------------------------------------------------------%%%---------------------------------------------------------------------------------------------------------
---------||||||-----------------------------------------------SS----------------S----|----------------------------------------------------------------------------------------------------------
---------||||||-----------------o---------------oo------------------------------So---|----------------------------------------------------------------------------------------------------------
------%%%%%%%%%%SS------------------------------S------------SSS----S----TT-----S----|--------------------------##Q-QQQ-Q---SSSS-------------US-------------------------------------------------
-------||||||||---------------------------#------------------------------TT----------|----------------tt-------------------------------------------------TT---------tt--------------------#-----
-------||||||||--------------------------###-----------------------------TT----------|----------------tt-------------------------------------------------TT---TT----tt-------------------##-----
-------||||||||------------k-k-------k--###----#---koy-g------------gg---TT----------y-------g-g------tt-------#---k-ggg----k-----ggggg-------k------g---TT---TT----tt---#----------gggg###-----
XXXXXXXXXXXXXXXXXXXXXXXXXXXXXXXXXXXXXXXXXXXXXXXXXXXXXXXXXXXXXXXXXXXXXXXXXXXXXXXXXXXXXXXXXXXXXXXXXXXXXXXXXXXXXXXXXXXXXXXXXXXXXXXXXXXXXXXXXXXXXXXXXXXXXXXXXXXXXXXXXXXXXXXXXXXXXXXXXXXXXXXXXXXXXXXX
XXXXXXXXXXXXXXXXXXXXXXXXXXXXXXXXXXXXXXXXXXXXXXXXXXXXXXXXXXXXXXXXXXXXXXXXXXXXXXXXXXXXXXXXXXXXXXXXXXXXXXXXXXXXXXXXXXXXXXXXXXXXXXXXXXXXXXXXXXXXXXXXXXXXXXXXXXXXXXXXXXXXXXXXXXXXXXXXXXXXXXXXXXXXXXXX
