------------------------------------------------------------------------------------------------------------------------------------------------------------------------------------------------
------------------------------------------------------------------------------------------------------------------------------------------------------------------------------------------------
------------------------------------------------------------------------------------------------------------------------------------------------------------------------------------------------
----------------SSSSSSS---------SSSSSSS-------------------------SSSSSSSS-------S----------------SSSSSSSS----------------SSSS----SS-------------------------------SSSSSS-------------------------
------------------------------------------------------------------------------------------------------------------------------------------------------------------------------------------------
------------------------------------------------------------------------------------------------------------------------------------------------------------------------------------------------
--------%%%%%%%%---------------------------------oo------------S----------------------SSSS-----------------------ooo--------------------------------QQQQSSS--SSS-----------------oo---SS--------
---------||||||--------------------------------------------------------------------------------------------------------------------------------o------------------------------------------------
---------||||||-------------------------------------------------------------------------------------#-------------------------------------------------------------------------------------------
---------||||||--------tt---------------------------------------------------------------------------#--------------------------------------------------o-----------------o----------------------
------%%%%%%%%%%-------tt--------------------------------------------------------S-----UQ----o---------------------------##---------------------------SQQS---U----------------------------------
-------||||||||-------ttt-----T-------t-----##---------------------------------------------------------o-----------------TT----------------------------------------------B-----------t----------
-------||||||||-------ttt----TT-------tt-#####-----------TT-------B-----TT---TT-----------------T------TT----TT------t---TT------------t---------------------------------b----U-----tt---#------
-------||||||||-T-----ttt----kT-------tt-#####g-----gy---kb---##TTb----kTt---TTT---------------gT------TT--##TT------t--###-------g----ttt---##g---k---------------------b#--ggg----tt--###-----
XXXXXXXXXXXXXXXXXXXXXXXXXXXXXXXXXXXXXXXXXXXXXXXXXXXXXXXXXXXXXXXXXXXXXXXXXXXXXXXXXXXXXXXXXXXXXXXXXXXXXXXXXXXXXXXXXXXXXXXXXXXXXXXXXXXXXXXXXXXXXXXXXXXXXXXXXXXXXXXXXXXXXXXXXXXXXXXXXXXXXXXXXXXXXXXX
XXXXXXXXXXXXXXXXXXXXXXXXXXXXXXXXXXXXXXXXXXXXXXXXXXXXXXXXXXXXXXXXXXXXXXXXXXXXXXXXXXXXXXXXXXXXXXXXXXXXXXXXXXXXXXXXXXXXXXXXXXXXXXXXXXXXXXXXXXXXXXXXXXXXXXXXXXXXXXXXXXXXXXXXXXXXXXXXXXXXXXXXXXXXXXXX
