------------------------------------------------------------------------------------------------------------------------------------------------------------------------------------------------
------------------------------------------------------------------------------------------------------------------------------------------------------------------------------------------------
------------------------------------------------------------------------------------------------------------------------------------------------------------------------------------------------
----------------SSSSSSSSSSSSSSSS--------------------------------------------------------------------------------SSSSSSSSSSSSSSSS------------------------------------------------SSSSSSSSSSSSSSS-
--------------------SSSS----------------------------------------------------------------------------------------SS------------------------------------------------------------------------------
---------------------S---------S--------------------------------------------------------------------------------SS------------------------------------------------------------------------------
--------%%%%%%%%--SSSSS-------SS-------------------------------o-o-------------S------------------------o---------------------SS---------------------------------oo-----------------------------
---------||||||----------------------------------------------------------------------------------------------------------------#----------------------------------------------------------------
---------||||||------------------------------------------------------------#--------------------------------------------------##----------------------------------------------------------------
---------||||||---o-o------------------------------------------------------#------------------##---------------------------##-##---------S----------#------------o----------#-------------------
------%%%%%%%%%%----------------------------------------------------------##--------------#-#-##--------------------------######------------------------------#-----------###-------------------
-------||||||||-----------------------------------------------------tt---###--------------#-#-##--------------------------######---------#-------------------##----------####-#----------B------
-------||||||||-------------------------------U---#-----------------tt---###---------tt--#######------------------------TT######--B------B-------------TT---###----------####-#----------b----TT
-------||||||||---------#--#k-----ggg---------k---#---------k-k-----tt--####---------tt--#######--ggg-------k-----------TT######--b--#---b----gg-------TT--####-----ggg-#####-#---#---k--b----TT
XXXXXXXXXXXXXXXXXXXXXXXXXXXXXXXXXXXXXXXXXXXXXXXXXXXXXXXXXXXXXXXXXXXXXXXXXXXXXXXXXXXXXXXXXXXXXXXXXXXXXXXXXXXXXXXXXXXXXXXXXXXXXXXXXXXXXXXXXXXXXXXXXXXXXXXXXXXXXXXXXXXXXXXXXXXXX-XXXXXXXXXXXXXXXXXX
XXXXXXXXXXXXXXXXXXXXXXXXXXXXXXXXXXXXXXXXXXXXXXXXXXXXXXXXXXXXXXXXXXXXXXXXXXXXXXXXXXXXXXXXXXXXXXXXXXXXXXXXXXXXXXXXXXXXXXXXXXXXXXXXXXXXXXXXXXXXXXXXXXXXXXXXXXXXXXX-XXXXXXXXXXXXXXXXXXXXXXXXXXXXXXXX
