------------------------------------------------------------------------------------------------------------------------------------------------------------------------------------------------
------------------------------------------------------------------------------------------------------------------------------------------------------------------------------------------------
------------------------------------------------------------------------------------------------------------------------------------------------------------------------------------------------
------------------------------------------------------------------------------------------------------------------------------------------------------------------------------------------------
----------------t-------------------------------------------------------------------------------------------------gg----------------------------------------------------------------------------
------------------------------------------------------------------------------------------------------------------##----------------------------------------------------------------------------
--------%%%%%%%%-----------QQQ-o------US----------------SS-------------------------------------------S1------S-------------------------------S--SS-------------------------------------------oo-
---------||||||----------------------------------------------------------o------------------------SSSS----------------------------------oooo------------------------------SS-------y------o-----
---------||||||-%%%%%-------------------------------------------------------------------SS---------S--------------------------------------------------------------------S-----------------------
---------||||||--|||---------------------SS---------------------------------------------SSSS-----------------------------------------------------------------------------SSS--------------------
------%%%%%%%%%%-|||--------------SSS--SSS------------------------S---------------------------#----------TT-----------------------------------TT-----------------------TT-----#-----------------
-------||||||||--|||-------------------------------------TT----------------------------TT-----#----------TT---TT----tt-----tt-----------------TTTT-------TT------------TT-----#---------------TT
-------||||||||--|||----------------------------------B--TT----T--------------------tt-TT-----#----------TT---TT----tt-TT--tt-----------------TTTT----B--TT------------TT-----#---------------TT
-------||||||||--|||----------g---k-----ggk-y---------b--TT----T----------k-TT------tt-TT---kk#----------TT---TTg---tt-TT--tt-----------------TTTT------kTT-------K----TT---kk#---------------TT
XXXXXXXXXXXXXXXX-XXXXXXXXXXX--X-XXXXXXXXXXXXXXXXXXXXXXXXXXXXXXXXXXXXXXXXXXXXXXXXXXXXXXXXXXXXXXXXXXXXXXXXXXXXXXXXXXXXXXXXXXXXXXXXXXXXXXXXXXXXXXXXXXXXXXXXXXXXXXXXXXXXXXXXXXXXXXXXXXXXXXXXXXXXXXXX
XXXXXXXXXXXXXXXXXXXXXXX-XXX---X-XXXXXXXXXXXXXXXXXXXXXXXXXXXXXXXXXXXXXXXXXXXXXXXXXXXXXXXXXXXXXXXXXXXXXXXXXXXXXXXXXXXXXXXXXXXXXXXXXXXXXXXXXXXXXXXXXXXXXXXXXXXXXXXXXXXXXXXXXXXXXXXXXXXXXXXXXXXXXXXX
