---------------------------------------Q--------------------------------------------------%----------------------%-------------------------------%------------------------------
------------------------------------------------------------------------------------------|----------------------|-------------------------------|------------------------------
------------------------------------------------------------------------------------------|----------------------|-------------------------------|------------------------------
------------------------------------------------------------------------------------------|----------------------|-------------------------------|------------------------------
----------------------------------------------------------------t-------------------------|----------------------|-------------------------------|------------------------------
------------------------------------------1-----------------------------------------------|----------------------%-------------------------------%------------------------------
---------------------------------------------------------------o---------------o------r---|-----------r----------|----r--------o------r----------|----r---------------r---------
--------------------o-%-----------------------------------------%----%%%--------%%%%%%%%%%%-----%%%%%%%%%%------%%%%%%%%--------%%%%%%%%%-------%%%%%%%%%%------%%%%%%%%%-------
----------------------|-----------------------------------------|-----|----------|||||||||-------||||||||--------||||||----------|||||||---------||||||||--------|||||||--------
--o-------SS----------|-----------------------------------------|-----|----------|||||||||-------||||||||--------||||||----------|||||||---------||||||||--------|||||||--------
-------TT-----#-------|-------------------------QQ------S-------|-TT--QQ---------|||||QQ@S-------|||||SSoS------QQ|||||QQQQ------||||||S@-------QQ|||||S@S-------||||||S@-------
-K-----TT-----#-T-----|-----------------------------------------|-TT-------------|TT||-----------|TT||--|---------|||||----------|TT|||-----TT----|||||----------|TT|||-----TT--
-S-----TT-----#-T-----t-----------------------------------------|-TT-------------|TT||-----------|TT||--|---------|||||----------|TT|||-----TT----|||||------T---|TT|||-----TT--
---kk--TT---kk#-T-----tt------gg-g-------g-------gg-----------g-|-TT--------ggg--|TT||-gggg-g--k-|TT||-ggg-----k--|g|||--g-------|TT|||ggg--TT-k--|gg||g-g---T---|TT|||ggg--TT-k
XXXXX--XXXXXXXXXXXXXXXXXXXXXXXXX-XXXXXXXXXXXXXXXXXXXXXXXXXXXXXXXXXXXXXXXXXXXXXXXXXXXXXXXXXXXXXXXXXXXXXXXXXXXXXXXXXXXXXXXXXXXXXXXXXXXXXXXXXXXXXXXXXXXXXXXXXXXXXXXXXXXXXXXXXXXXXXX
XXXXX--XXXXXXXXXXXXXXXXXXXXXXXXX-XXXXXXXXXXXXXXXXXXXXXXXXXXXXXXXXXXXXXXXXXXXXXXXXXXXXXXXXXXXXXXXXXXXXXXXXXXXXXXXXXXXXXXXXXXXXXXXXXXXXXXXXXXXXXXXXXXXXXXXXXXXXXXXXXXXXXXXXXXXXXXX
