------------------------------------------------------------------------------------------------------------------------------------------------------------------------------------------------
------------------------------------------------------------------------------------------------------------------------------------------------------------------------------------------------
------------------------------------------------------------------------------------------------------------------------------------------------------------------------------------------------
---------------------------------SS------------------------------------------------SSSSS--------SSS--------------------------------------------------------------S------------------------------
------------------------------------------------------------------------------------------------------------------------------------------------------------------------------------------------
------------------------------------------------------------------------------------------------------------------------------------------------------------------------------------------------
--------%%%%%%%%------------------------------------QoSSSS-----o----------------oooo--SSoo---SSS------------------o------------o-----------------oo-------------------------------o------------o
---------||||||--------------------------------------------------#------------------------------------------------------------------------------------------------------------------------------
---------||||||------------------------------------------------------------------------------------------------------------------------------------------------------------------------------o--
---------||||||-----------------------------------------------------------------oo--------------------------------------------------------------------------------------------------------------
------%%%%%%%%%%---------------------------------------------SS---------TT--#---S--------------------------------------------#---------------o-----------------------2-----------------------U--
-------||||||||--------TT-----TT------tt--------------------------------TT--#--------------------------tt--------------------#-----------------------------------------------##----------TT-----
-------||||||||---TT---TT-----TT------tt-----------#--------------TT----TT--TTTT----tt-----------------tt-----TT--------###--#--------tt-----------------TT------------TT----##----------TT-----
-------||||||||---TT---TT-----TT------tt------gg---#-kk-----------TT----TT--TTTT----tt-----------------tt-----TT---k----###--#--------tt-----gg-----g----TT------------TT---####---k-k---TT-----
XXXXXXXXXXXXXXXXXXXXXXXXXXXXX-XXXXXXXXXXXXXXXXXXXXXXXXXXXXXXXXXXXXXXXXXXXXXXXXXXXXXXXXXXXXXXXXXXXXXXXXXXXXXXXXXXXXXXXXXXXXXXXXXXXXXXXXXXXXXXXXXXXXXXXXXXXXXXXXXXXXXXXXXXXXXXXXXXXXXXXXXXXXXXXXXX
XXXXXXXXXXXXXXXXXXXXXXXXXXXXX--XXXXXXXXXXXXXXXXXXXXXXXXXXXXXXXXXXXXXXXXXXXXXXXXXXXXXXXXXXXXXXXXXXXXXXXXXXXXXXXXXXXXXXXXXXXXXXXXXXXXXXXXXXXXXXXXXXXXXXXXXXXXXXXXXXXXXXXXXXXXXXXXXXXXXXXXXXXXXXXXX
