------------------------------------------------------------------------------------------------------------------------------------------------------------------------------------------------
------------------------------------------------------------------------------------------------------------------------------------------------------------------------------------------------
------------------------------------------------------------------------------------------------------------------------------------------------------------------------------------------------
------------------------------------------------------------------------------------------------------------------------------------------------------------------------------------------------
------------------------------------------------------------------------------------------------------------------------------------------------------------------------------------------------
------------------------------------------------------------------------------------------------------------------------------------------------------------------------------------------------
--------%%%%%%%%--------------------SSoo---------------------------------------------------------------------------------------------------SSQ--------------QQQo----------------SSSS------------
---------||||||--------------SS----SSS-------------ooo------------------------------------------------------------------------------------------------------------------------------------------
---------||||||--------#-----------SSS----------------------------------------------------------------------------------------------------------------------------------------------------------
---------||||||--K--S-##---S---------------------------------------------------------------------------------------------------------------------------------------------SS----#----------------
------%%%%%%%%%%------###-----------------------TT--------------------------------S------------------------------------------------------------QQQQQ--------------------------#----------TT-----
-------||||||||-------###----------------TT----TTT-------TT----------------------------------------------TT------------------------------------------------------------------##----------TT-----
-------||||||||-------###----------------TT----TTT----B--TT------------TT--------------TT----------------TT------------------------------------------------------------T----###----------TT-----
-------||||||||-------###---k------------TT----TTT----b--TT----T-------TT--------------TT-k--------ggg---TT---------------------------------g-g-------k----------------TT--####------y---TT----g
XXXXXXXXXXXXXXXXXXXXX-XXX-----XXXXXXXXXXXXXXXXXXXXXXXXXXXXXXXXXXXXXXXXXXXXXXXXXXXXXXXXXXXXXXXXXXXXXXXXXXXXXXXXXXXXXXXXXXXXXXXXXXXXXXXXXXXXXXXXXXXXXXXXXXXXXXXXXXXXXXXXXXXXXXXXXXXXXXXXXXXXXXXXXX
XXXXXXXXXXXXXXXXXXXXX-XXX---X-XXXXXXXXXXXXXXXXXXXXXXXXXXXXXXXXXXXXXXXXXXXXXXXXXXXXXXXXXXXXXXXXXXXXXXXXXXXXXXXXXXXXXXXXXXXXXXXXXXXXXXXXXXXXXXXXXXXXXXXXXXXXXXXXXXXXXXXXXXXXXXXXXXXXXXXXXXXXXXXXXX
