------------------------------------------------------------------------------------------------------------------------------------------------------------------------------------------------
-----------------K------------------------------------------------------------------------------------------------------------------------------------------------------------------------------
------------------------------------------------------------------------------------------------------------------------------------------------------------------------------------------------
------------------------------------------------SSSSSSSSSSSSSSSSSSSSSSSS-------------SSSS-------SSSS--SSSS-------SS-------------SSSSSSSSS---------------------------------------SSSSSSSSSSSSSSSS
------------------------------------------------SS---S------------------------------------------------------------------------------------------------------------------------------------------
------------------------------------------------------------------------------------------------------------------------------------------------------------------------------------------------
--------%%%%%%%%---------------o-oo---------------------------SS----------------oooo----ooo---oo--------------------------------ooo----Sooo---S---oooSSSo----SSS---------------S----------------
---------||||||-------------------------------------------------------------------------------------------------------------------#-------------------------------------------------------------
---------||||||----------------------------------------------------------------------------K----------------------------------------------------------------------------------------------------
---------||||||-----------------------------------------------------------------ooo--------#-----oo--------##-----------------------------------ooo---------------------------------------------
------%%%%%%%%%%--------------------------------------@-----------------------------------##--------------###-----------------------tt----------SQSS--------------------------------------------
-------||||||||----------TT--------------TT-----------t----------------------------------###--------------###------------TT---------tt-----------------------------------TT---------------------
-------||||||||----------TT--------------TT----------tt------------------------#----tt--####-------------####-----------TT----TT----tt------------------##---------------TT---#-------tt--------
-------||||||||---kk-----TT---------k----TT----------tt-------k-------g-------g#----tt######------------####k-##--k-----TT---gTT----tt----------------####---------gg----TT---##------tt------#-
XXXXXXXXXXXXXXXXXXXXXXXXXXXXXXXXXXXXXXXXXXXXXXXXXXXXXXXXXXXXXXXXXXXXXXXXXXXXXXXXooXXXXXXXXXXXXXXXXXXXXXXXXXXXXXXXXXXXXXXXXXXXXXXXXXXXXXXXXXXXXXXXXXXXXXXXXXXXXXXXXXXXXXXXXXXXXXXXXXXXXXXXXXXXXXX
XXXXXXXXXXXXXXXXXXXXXXXXXXXXXXXXXXXXXXXXXXXXXXXXXXXXXXXXXXXXXXXXXXXXXXXXXXXXXXXXXXXXXXXXXXXXXXXXXXXXXXXXXXXXXXXXXXXXXXXXXXXXXXXXXXXXXXXXXXXXXXXXXXXXXXXXXXXXXXXXXXXXXXXXXXXXXXXXXXXXXXXXXXXXXXXX
