-----------------------K------------------------------------------------------------------------------------------------------------------------------------------------------------------------
-----------------------o------------------------------------------------------------------------------------------------------------------------------------------------------------------------
----------------------%%%-----------------------------------------------------------------------------------------------------------------------------------------------------------------------
-----------------------|-------oSSSSSSSSSSSSSS-------------------S--SSS-------------------------SSSSSSSS------------------------SSS---S--------------------------S------------------------------
-----------------------|-------%----------------------------------------------------------------------------------------------------------------------------------------------------------------
-----------------------|-------|----------------------------------------------------------------------------------------------------------------------------------------------------------------
--------%%%%%%%%-------|-------|---------------S-oo--SSSSS-------------------------------------o----------------oooo-SSSoS---SSS-----------------------SSS-----o----------------oooo--SSSSS--SSS
---------||||||--------|-------|----------------------------------------------------------------------------------------------------------------------------------------------------------------
---------||||||--------|---%---|--------------------------------------------------------------------o---------------------------------------------------------------o---------------------------
---------||||||--------|---|---|----------------------------------------------------------------------------------------------------#-------------------------------#-----------oo--------------
------%%%%%%%%%%%%-----|---|---|-------------------------------------------------------------#-------2-----------------------o-------------------------------##------2--------------tt----------
-------||||||||-||-----|---|---|-----S-----##-------------#----------ttt---------------------#----------TT------------------------------------------------#-##---------tt-----------tt----------
-------||||||||-||-----|---|---|-----S-----#--------------#---#------ttt------------------#-------------TT----o-------------------------TT---TT------#---#####---------tt----TT-----tt----------
-------||||||||-||-----|---|---|----------##y-------gg--###-#-##-----ttt-----k-----k-k----#--#--g-g-----TT---##-----gg------------g-----TT---TT------#--######---------tt----TT-----tt----------
XXXXXXXXXXXXXXXX||-----|%%%%%%%%XXXXXXXXXXXXXXXXXXXXXXXXXXXXXXXXXXXXXXXXXXXXXXXXXXXXXXXXXXXXXXXXXXXXXXXXXXXXXXXXXXXXXXXXXXXXXXXXXXXXXXXXXXXXXXXXXXXXXXXXXXXXXXXXXXXXXXXXXXXXXXXXXXXXXXXXXXXXXXXX
XXXXXXXXXXXXXXXX||-----|-||||||-XXXXXXXXXXXXXXXXXXXXXXXXXXXXXXXXXXXXXXXXXXXXXXXXXXXXXXXXXXXXXXXXXXXXXXXXXXXXXXXXXXXXXXXXXXXXXXXXXXXXXXXXXXXXXXXXXXXXXXXXXXXXXXXXXXXXXXXXXXXXXXXXXXXXXXXXXXXXXXXX
