-----------------------------------------------------------------------------------------------------------------%--------------------------------------------------------------
-----------------------------------------------------------------------------------------------------------------|--------------------------------------------------------------
-----------------------------------------------------------------------------------------------------------------|----------------------------------------------t---------------
SSSSSSSS--------------------------#------------------------------------------------------------------------------|----------------------------------------------t---------------
S---------------------------------#-##---------------------------------------------------------------------------|----------------------------------------------t---------------
----------------------------------------------------------------------------------------------o------------------|----------------------------------------------t---------------
SSSoo---------------------------------------------------------------------------SSSSSS2---------SS------QQQQQQ-o-|-------------o--------------------------------SSS-------------
-----------------------------------------------------------------------------------------------------------------|--o--------------------ooo------------ooo---------ooo---------
----------------------------------U-------K----------------------------------------------------------------------|--------------------------------------------------------------
-------------------------------------------------------------------------SS--------------------------------------|--------------------------------------------------------------
---------TT-------SS---------#------------------------So---------------------------------TT--------------------Q-|--------------------------------------------------------------
---------TT---------K-------###--------------T----TT--------TT---------TT----------------TT----------------------|-------------------------------------------------------TT-----
---------TT----#-----------####-------------TT----TT--------TT------tt-TT----------------TT-----------tt---------|---------------------T---B-----------TT-------------tt-TT-----
-----y---TT----#----------#####-------------TT----TT----gg--TT------tt-TT------------y---TT-----------tt-----gg--|-----------k---gg----T---b-----------TT-------------ttkTT----g
XXXXXXXXXXX---XXXXXXXXXXXXXXXXXXXXXXXXXXXXXXXXXXXXXXXXXXXXXXXXXXXXXXXXXXXXXXXXXXXXXXXXXXXXXXXXXXXXXXXXXXXXXXXXXXXXXXXXXXXXXXXXXXXXXXXXXXXXXXXXXXXXXXXXXXXXXXXXXXXXXXXXXXXXXXXXXX
XXXXXXXXXXXX--XXXXXXXXXXXXXXXXXXXXXXXXXXXXXXXXXXXXXXXXXXXXXXXXXXXXXXXXXXXXXXXXXXXXXXXXXXXXXXXXXXXXXXXXXXXXXXXXXXXXXXXXXXXXXXXXXXXXXXXXXXXXXXXXXXXXXXXXXXXXXXXXXXXXXXXXXXXXXXXXXX
