------------------------------------------------------------------------------------------------------------------------------------------------------------------------------------------------
------------------------------------------------------------------------------------------------------------------------------------------------------------------------------------------------
------------------------------------------------------------------------------------------------------------------------------------------------------------------------------------------------
-----------------SSSSSSSSSS-SSS-----------------SSSSSSS------------SSSSSSSSSSSS--SSSSSSSSSS---------------------SSSSSSSSSSSS---S----------------SSSSSSS---------SSSSSSSSSSS-----SSSSSSSSSSS--SSS
----------------------------------------------------------------------------------------------------------------SS------------------------------------------------------------------------------
------------------------------------------------------------------------------------------------------------------------------------------------------------------------------------------------
--------%%%%%%%%---------------S-----------------------Soo-------oo------------------------------o------------------------------Sooo--SSo----SoS----------------ooo-----------------------------
---------||||||------------------------o--------------------------------------------------------------------------------------------------------------------------------------------------------
---------||||||---------------------------------------------------------------------------------------------------------------------------------------------------------------------------------
---------||||||------------------o----------------------------------------------------------------------------------------------oo-------------o----------------oo------------------------------
------%%%%%%%%%%-----#------------------------oo--------------------------------------------------------------------------------SSSS---------SS-------------------------------------------------
-------||||||||------#---------------------------------------------------##--------------TT-------------------------------------------------------------------------------#---------------------
-------||||||||------#---#--------------------------tt-------------------###---#---------TT---TT---------------------------------------------------------TT--------------##-------------TT----TT
-------||||||||------#---#----g--ogg-------g--------tt--------k---------####--##--k------TT---TT---k-g----------------g-----kkk--------------------------TT---k----------##---##--------TT----TT
XXXXXXXXXXXXXXXXXXXXXXXXXXXXXXXXXXXXXXXXXXXXXXXXXXXXXXXXXXXXXXXX--XXXXXXXXXXXXXXXXXXXXXXXXXXXXXXXXXXXXXXXXXXXXXXXXXXXXXXXXXXXXXXXXXXXXXXXXXXXXXXXXXXXXXXXXXXXXXXXXXXXXXXXXXXXXXXXXXXXXXXXXXXXXXX
XXXXXXXXXXXXXXXXXXXXXXXXXXXXXXXXXXXXXXXXXXXXXXXXXXXXXXXXXXXXXXXXX-XXXXXXXXXXXXXXXXXXXXXXXXXXXXXXXXXXXXXXXXXXXXXXXXXXXXXXXXXXXXXXXXXXXXXXXXXXXXXXXXXXXXXXXXXXXXXXXXXXXXXXXXXXXXXXXXXXXXXXXXXXXXXX
