------------------------------------------------------------------------------------------------------------------------------------------------------------------------------------------------
------------------------------------------------------------------------------------------------------------------------------------------------------------------------------------------------
------------------------------------------------------------------------------------------------------------------------------------------------------------------------------------------------
----------------------------------------------------------------------------------SS-------------------------------------------------------------SSSSSSS------------------------SSSSSSSS--------
------------------------------------------------------------------------------------------------------------------------------------------------------------------------------------------------
------------------------------------------------------------------------------------------------------------------------------------------------------------------------------------------------
--------%%%%%%%%----------%%%%-----QQQQQQSSS--@------------------oo-----o------o----------------------SSS-------------------------------oo-----o--------------------QQQSSS---SSS----------------
---------||||||------------||---------------------------------------------------------------------------------o---------------------------------------------------------------------------------
---------||||||------------||-------------------------------------------------------------------------------------------------------------------------------------------------------------------
---------||||||------------||----------g-------------------------------------------------------------------------------------------------------------------------o------------------------------
------%%%%%%%%%%------%%%%%%%%--QQQQQ--SQS---USS-------------------------------------------------------------------------------------Q--------------------------SSQ----S-----SS-----------------
-------||||||||--------||||||----------------------------#---------------------------------------------------------------TT-------------------------------------------------------------TT------
-------||||||||--------||||||---------------------B------#---#-----------------------tt---------------------------#------TT----------------------------TT-----@-------------------B-----TT------
-------||||||||--------||||||-------gg------------b------#---##----------------------tt-----ggg-------------------g------TT--g-------g----#-------g----TT----gg---gggg------------b-----TT---##-
XXXXXXXXXXXXXXXX-%%%%%%%%||||%%%XXXXXXXXXXXXXXXXXXXXXXXXXXXXXXXXXXXXXXXXXXXXXXXXXXXXXXXXXXXXXXXXXXXXXXXXXXXXXXXXXXXXXXXXXXXXXXXXXXXXXXXXXXXXXXXXXXXXXXXXXXXXXXXXXXXXXXXXXXXXXXXXXXXXXXXXXXXXXXXX
XXXXXXXXXXXXXXXX--||||||-||||-|-XXXXXXXXXXXXXXXXXXXXXXXXXXXXXXXXXXXXXXXXXXXXXXXXXXXXXXXXXXXXXXXXXXXXXXXXXXXXXXXXXXXXXXXXXXXXXXXXXXXXXXXXXXXXXXXXXXXXXXXXXXXXXXXXXXXXXXXXXXXXXXXXXXXXXXXXXXXXXXXX
