------------------------------------------------------------------------------------------------------------------------------------------------------------------------------------------------
------------------------------------------------------------------------------------------------------------------------------------------------------------------------------------------------
------------------------------------------------------------------------------------------------------------------------------------------------------------------------------------------------
--------------------------------SSSSSSSSS----------SS-----------SSSSSSSSSSSSSS----------------------------------SSSSSSSSSS------SSSSSSSS----------------------------------------SSSSSSSS-S------
------------------------------------------------------------------------------------------------------------------------------------------------------------------------------------------------
------------------------------------------------------------------------------------------------------------------------------------------------------------------------------------------------
--------%%%%%%%%-orr----%------o-----------------oo------------S---------SSS-SS----------------------------------oo----------------------------------QQQQS-----S----------------ooo----SS-------
---------||||||-%%%%%%%%|-----S%--------------------------------------------------------------oo---------------#-----------------#-----------------------------#--------------------------------
---------||||||--||||||-|---###|-------------------------------------------------------------------------------#-----------y--------------------------------------------------------------------
---------||||||--||||||-|--#####------------------------------------------------------------------------------##-----------#----------------------------------##--------------------------------
------%%%%%%%%%%-||||||-|--#####------tt-----------------##-------------------------##-TT---------------------##----------##----------------------------------##---------------------------#----
-------||||||||--||||||-|-######------tt-----------------##----------tt----------------TT----#---------------###----tt---###---------------------------------###--------TT----------tt----##----
-------||||||||-%|||tt|-|#######-----tt------TT-----tt--###----------tt----------------TT----##---------TT---###----tt---###------B-------------------------####--#-----TT---TT-----tt---##-----
-------||||||||-||||tt|-|#######-----tt------TT-----tt#####----------tt-----k-k-g------TT---###---g-----TT--####----tt--###-------b---##------g---gg--------####--g-----TT---TT-----tt--###-----
XXXXXXXXXXXXXXXXXXXXXXXXXXXXXXX-XXXXXXXXXXXXXXXXXXXXXXXXXXXXXXXXXXXXXXXXXXXXXXXXXXXXXXXXXXXXXXXXXXXXXXXXXXXXXXXXXXXXXXXXXXXXXXXXXXXXXXXXXXXXXXXXXXXXXXXXXXXXXXXXXXXXXXXXXXXXXXXXX-XXXXXXXXXXXXXX
XXXXXXXXXXXXXXXXXXXXXXXXXXXXXXXoXXXXXXXXXXXXXXXXXXXXXXXXXXXXXXXXXXXXXXXXXXXXXXXXXXXXXXXXXXXXXXXXXXXXXXXXXXXXXXXXXXXXXXXXXXXXXXXXXXXXXXXXXXXXXXXXXXXXXXXXXXXXXXXXXXXXXXXXXXXXXXXXX-XXXXXXXXXXXXXX
