------------------------------------------------------------------------------------------------------------------------------------------------------------------------------------------------
------------------------------------------------------------------------------------------------------------------------------------------------------------------------------------------------
------------------------------------------------------------------------------------------------------------------------------------------------------------------------------------------------
----------------SSSSSSSSSSSSSSSS--------------------------------SSSSSSSS--------SSSSSSSSS---------------------------------------SSSSSSSSSSSSSSSS--------------------------------SSSSSS----------
----------------SS--------------------------------------------------------------------------------------------------------------SS--------------------------------------------------------------
------------------------------------------------------------------------------------------------------------------------------------------------------------------------------------------------
--------%%%%%%%%--------SSSo----ooo-----oo---------------------o----------------ooo----Soo-----SSSSSS----------o--------------------------------oooo--SSoo---SoSS--o----------SS----------------
---------||||||---------------------------------------------------------------------------------------------------------------------------------------------------------------------------------
---------||||||-----------------------------------------------------------------------------------------------o---------------------------------------------------------------o-----------------
---------||||||-----------------------------------------------------------------oo--------------ooo---------------------------------------------o----------------------------------------o------
------%%%%%%%%%%--------------------------------------------------------------------------------SSS----------SSS-------------------------------------oS------USS-------------US-----------------
-------||||||||------------------------------------------TT--------------------------------------------------------------TT-------------------TT------------------------------------------------
-------||||||||------tt-------TT---------##--------------TT--------------------------tt----------------------------------TT-------------------TT----------------------------------------------TT
-------||||||||------tt-------TT---------##-------gggg---TT--------------g----##-----tt---#--------ggg------------kgg----TT---g---------##----TT-----k------k------gggg---k---k---g-----------TT
XXXXXXXXXXXXXXXXXXXXXXXXXXXXXXXXXXXXXXXXXXXXXXXXXXXXXXXXXXXXXXXXXXXXXXXXXXXXXXXXXXXXXXXXXXXXXXXXXXXXXXXXXXXXXXXXXXXXXXXXXXXXXXXXXXXXXXXXXXXXXXXXXXXXXXXXXXXXXXXXXXXXXXXXXXXXXXXXXXXXXXXXXXXXXXXX
XXXXXXXXXXXXXXXXXXXXXXXXXXXXXXXXXXXXXXXXXXXXXXXXXXXXXXXXXXXXXXXXXXXXXXXXXXXXXXXXXXXXXXXXXXXXXXXXXXXXXXXXXXXXXXXXXXXXXXXXXXXXXXXXXXXXXXXXXXXXXXXXXXXXXXXXXXXXXXXXXXXXXXXXXXXXXXXXXXXXXXXXXXXXXXXX
