------------------------------------------------------------------------------------------------------------------------------------------------------------------------------------------------
------------------------------------------------------------------------------------------------------------------------------------------------------------------------------------------------
------------------------------------------------------------------------------------------------------------------------------------------------------------------------------------------------
--------------------------------------------------------------------------------SSSSSSSSSS-------------------------------------------------------SSSSSS-----------------------------------------
------------------------------------------------------------------------------------------------------------------------------------------------------------------------------------------------
------------------------------------------------------------------------------------------------------------------------------------------------------------------------------------------------
--------%%%%%%%%-------%%%---------------------o-------------------------o---------------------------------------------Q---------o-------o---------------------------QQQQS---SSS----------------
---------||||||---------|-----------------------------------------------------------------------------------------------------------------------------------------------------------------------
---------||||||---------|-----------------------------------------------------------------------------------------------------------------------------------------------------------------------
---------||||||---------|-----------------------------------------------------------------------------------------------------------------------------------------------------------------------
------%%%%%%%%%%S-------|-------------------------------------#------o----------------t----------------------##------2-------o-------------------------------o---------QQ-----------------------
-------||||||||---------|------------------------------------##----------------------tt----------------t-----##---------------------------#--------------B---TT--------------###---------TT-----
-------||||||||-%%------|------#----------------------tt-----##----------------------tt----------------t----###--------------##------t---##-------B-----Tt---TT-------------####---------TT-----
-------||||||||-||------|----g-#--gk------k-k--------tty-----##-----ot--------##-----tt------kk---g----t----###--------k----#-k#----tt---##-------b-----tt---TTT------------####--k------TT---#-
XXXXXXXXXXXXXXXX||-----XXXXXXXXXXXXXXXXXXXXXXXXXXXXXXXXXXXXXXXXXXXXXXXXXXXXXXXXXXXXXXXXXXXXXXXXXXXXXXXXXXXXXXXXXXXXXXXXXXXXXXXXXXXXXXXXXXXXXXXXXXXXXXXXXXXXXXXXXXXXXXXXXXXXXXXXXXXXXXXXXXXXXXXXX
XXXXXXXXXXXXXXXX||-----XXXXXXXXXXXXXXXXXXXXXXXXXXXXXXXXXXXXXXXXXXXXXXXXXXXXXXXXXXXXXXXXXXXXXXXXXXXXXXXXXXXXXXXXXXXXXXXXXXXXXXXXXXXXXXXXXXXXXXXXXXXXXXXXXXXXXXXXXXXXXXXXXXXXXXXXXXXXXXXXXXXXXXXXX
