--------------------2-----------------------------------------------------------------------------------------------------------------------------------------------------------
-------------------Q------------------------------------------------------------------------------------------------------------------------------------------------------------
------------------#-------------------------------------------------------------------------------------------------------------------------------------------------------------
---------S-------##------------------------------------------------------------------#------------------------------------------------------------------------------------------
-----------------##k#-----------------------------------------------------------------------------------------------------------------------------------------------------------
-----------------#----------------------------------------------------------------##-----------------------------------------------------------------------o--o---##------------
-------------S--------------------------------------------------S%------------------------------------------SSSo-------------------------------o-%------------------------------
--SSS-S-----------%%%%%------------------------------------------|--oo-----------------------------------------------------o-------------o-------|------------------------------
-------------------|||----------------------------------SS-------|-----------------------------------------------------%%%%%---------------------|------------------------------
-------------------|||----------------------------------SSS------|-----------------------SS-----------------------------|||----------------------|------------------------------
------------------S|||------TT-----------------------------------|-------TT---------------------------------------------|||----------------------|TT----------------------------
---------TT----T---|||------TT-----------------------------------|TT-----TT---------tt-TT---------------------TTTT------|||---------tt-----------|TT-----TT---------tt----------
---------TT----T---|||------TT-----------------------------------TTT-----TT----T----tt-TT---------------------TTTT------|||---------tt-----------|TT-----TT---------tt-TT--tt---
-----y---TT----T--ggg|--gk--TT------y---------------------kg-----TTT-----TT----T----tt-TT---------------------TTTT------|||-----g---tt-----------|TT---k-TT----kg---tt-TT--tt---
XXXXXXXXXXXXXXXXXXXXXXXXXXXXXXXXXXXXXXXXXXXXXXXXXXXXXXXXXXXXXXXXXXXXXXXXXXXXXXXXXXXXXXXXXXXXXXXXXXXXXXXXXXXXXXXXXXXXXXXXXXXXXXXXXXXXXXXXXXXXXXXXXXXXXXXXXXXXXXXXXXXXXXXXXXXXXXXX
XXXXXXXXXXXXXXXXXXXXXXXXXXXXXXXXXXXXXXXXXXXXXXXXXXXXXXXXXXXXXXXXXXXXXXXXXXXXXXXXXXXXXXXXXXXXXXXXXXXXXXXXXXXXXXXXXXXXXXXXXXXXXXXXXXXXXXXXXXXXXXXXXXXXXXXXXXXXXXXXXXXXXXXXXXXXXXXX
