------------------------------------------------------------------------------------------------------------------------------------------------------------------------------------------------
------------------------------------------------------------------------------------------------------------------------------------------------------------------------------------------------
------------------------------------------------------------------------------------------------------------------------------------------------------------------------------------------------
----------------SSSSSSSSSS---SSS----------------SSSSSSSSSSSS----SSSSSS---------------------------SSSSSS---------SSSSSSSS----------------------------------------SSSSSSSSSS----------------------
------------------------------------------------------------------------------------------------------------------------------------------------------------------------------------------------
------------------------------------------------------------------------------------------------------------------------------------------------------------------------------------------------
--------%%%%%%%%--------SSSS--------QQS--------o---------------S--------S-------------------------------------------------SS-----------------------U-----------o--------------------QoQSSSS-----
---------||||||-----------------------------------------------------------------------------------------------------------------SS------------oo------------------------------------------------
---------||||||-----------------------------------------------------------------------------------------------------------------SS----------------------------o---------------------------------
---------||||||-----------------o---------------------------------------------------------------------------------------------------#-----------------------------------------------------------
------%%%%%%%%%%-------------##---------------------------------------tt-----o---------------------------------------tt-------------#------------------------SS---------------------------------
-------||||||||-o----------#-#----------------------------------------tt--------------------------------TT-----------tt------------------------------------------------------TT-----------------
-------||||||||-%----------###-----------##--------------#------------tt--------------------------------TT-----------tt----------------B-----------------------------tt------TT-----------------
-------||||||||-|----------###-----kgggg###-------------###-----------tt----ggg-----g-------------k-----TT---###-----tt------g---------b-----------kgggg--#----g-----tt------TT-------k---------
XXXXXXXXXXXXXXXXXXXXXXXXXXXXXXX-XXXXXXXXXXXXXXXXXXXXXXXXXXXXXXXXXXXXXXXXXXXXXXXXXXXXXXXXXXXXXXXXXXXXXXXXXXXXXXXXXXXXXXXXXXXXXXXXXXXXXXXXXXXXXXXXXXXXXXXXXXXXXXXXXXXXXXXXXXXXXXXXXXXXXXXXXXXXXXXX
XXXXXXXXXXXXXXXXXXXXXXXXXXXXXXX-XXXXXXXXXXXXXXXXXXXXXXXXXXXXXXXXXXXXXXXXXXXXXXXXXXXXXXXXXXXXXXXXXXXXXXXXXXXXXXXXXXXXXXXXXXXXXXXXXXXXXXXXXXXXXXXXXXXXXXXXXXXXXXXXXXXXXXXXXXXXXXXXXXXXXXXXXXXXXXXX
