------------------------------------------------------------------------------------------------------------------------------------------------------------------------------------------------
------------------S-----------------------------------------------------------------------------------------------------------------------------------------------------------------------------
------------------------------------------------------------------------------------------------------------------------------------------------------------------------------------------------
----------------SSS------------SSSSSSSS----------------------------------------------------------#------------------------------SSSSSSSS--------SSSSSSSSSSSSSS--SSSSSSSSS------S----------------
------------------------------------------------------------------------------------------------------------------------------------------------------------------------------------------------
-------------------------------------------o----------------------------------------------------------------------------------------------------------------------------------------------------
--------%%%%%%%%---------------------------S-------------------o---------------S--------SS---------------------S---------------o------------------oo-----------o--------S-----SS-oo---QQQS---SSS
---------||||||------------------------------------------------#---------------------------------------------------------------#----------------------------------------------------------------
---------||||||----------------------------------------------###-------------------------------------------------------------###--------------------------------S----------------------------##-
---------||||||------------SSS------------------oo-----------###-------------------------------------------------o-----------###----------------o--------------------------------------------##-
------%%%%%%%%%%-----------------------tt-------------------####--------------------------------------------##---------TT---####--------------------------#---------------------#------SS---###-
-------||||||||------------------#-----tt------------------#####--------------------------------------------###--------TT--####---------------------------#-#--------tt---------------------###-
-------||||||||------------------#-----tt-----------------######-----tt--------------tt--------------------###---------TT--####---B-----tt----TT----------##---------tt-------------------#####-
-------||||||||--------------ro-##-----tt--kgg-----y-y---#######-----tt-----gg-g-----tt---------g---------####--g------TT--####---b-----tt----TT---k-ygg-###k---y----tt-----ggg----k--g-########
XXXXXXXXXXXXXXXX-------%%%%%%%%%XXXXXXXXXXXXXXXXXXXXXXXXXXXXXXXXXXXXXXXXXXXXXXXXXXXXXXXXXXXXXXXXXXXXXXXXXXXXXXXXXXXXXXXXXXXXXXX-XXXXXXXXXXXXXXXXXXXXXXXXXXXXXXXXXXXXXXXXXXXXXXXXXXXXXXXXXXXXXXXX
XXXXXXXXXXXXXXXX--------|||||||XXXXXXXXXXXXXXXXXXXXXXXXXXXXXXXXXXXXXXXXXXXXXXXXXXXXXXXXXXXXXXXXXXXXXXXXXXXXXXXXXXXXXXXXXXXXXXXX-XXXXXXXXXXXXXXXXXXXXXXXXXXXXXXXXXXXXXXXXXXXXXXXXXXXXXXXXXXXXXXXX
