-----------------------------------------------------------------------------------------------------------------------------------------%-%----------------------------------------------------
-----------------------------------------------------------------------------------------------------------------------------------------|-|----------------------------------------------------
-----------------------------------------------------------------------------------------------------------------------------------------|-|----------------------------------------------------
----------------------S------------------------------------------------------------------------------------------------------------------|-|----------------------------------------------------
-----------------------------------------------------------------------------------------------------------------------------------------|-|-------k--------------------------------------------
-------------------------------o---------------o--------------o---##---------------------------------------------------------------------|-|------##--------------------------------------------
--------%%%%%%%%---SSSS-o--oS@SS----------------------------------------------------------------SSS-------------S%-------S------%%-------|-|-----------------------------------oS%%-------------
---------||||||---------------------------------------------------------oooo------------oooo--------oo-----------|---o----------||-------|-|-------------oo---------------o------||--o----------
---------||||||---SS---------------------------------------------------------------------------------------------|--------------||-------|-|-------------------------------------||-------------
---------||||||-----oo-------------------------------------------------------------------------------------------|--------------||-------|-|-------------SSS---------------------||-------------
------%%%%%%%%%%#--SS%%%%-%%%%%-----------%%%%%%------------------S--------------------------------------TT------|TT------------||TT-----|-|-------------------------------------TTT------------
-------||||||||-------||---|||-------------||||----------TT---------tt-----------------TT-------TT-------TT------TTT-----TT-----||TT-----|-|-----------TT-------T--------------T-TTT------------
-------||||||||-------||---|||-------------||||----------TT---------tt-TT--tt----------TT-------TT----B--TT----T-TTT-----TT-----|TTTT----|-|--------tt-TT-------T--------------T-TTT--tt-TT-----
-------||||||||-------||---|||-------------||||k--TT-----TT-----g---tt-TT--tt----------TT-k-----TT----b-kTT----T-TTT-----TT---gg|TTTT----|-|--gg----tt-TT-----#-T----g---------T-TTT--tt-TT---gg
XXXXXXXXXXXXXXXX--%%%-||---|||---XXX----XXXX|XXXXXXXXXXXXXXXXXXXXXXXXXXXXXXXXXXXXXXXXXXXXXXXXXXXXXXXXXXXXXXXXXXXXXXXXXXXXXXXXXXXXXXXXXXXXXXXXXXXXXXXXXXXXXXXXXXXXXXXXXXXXXXXXXXXXXXXXXXXXXXXXXXX
XXXXXXXXXXXXXXXXg-g|--||---|||---XXXX---XXXXXXXXXXXXXXXXXXXXXXXXXXXXXXXXXXXXXXXXXXXXXXXXXXXXXXXXXXXXXXXXXXXXXXXXXXXXXXXXXXXXXXXXXXXXXXXXXXXXXXXXXXXXXXXXXXXXXXXXXXXXXXXXXXXXXXXXXXXXXXXXXXXXXXXX
