------------------------------------------------------------------------------------------------------------------------------------------------------------------------------------------------
------------------------------------------------------------------------------------------------------------------------------------------------------------------------------------------------
------------------------------------------------------------------------------------------------------------------------------------------------------------------------------------------------
------------------------------------------------------------------------------------------------------------------------------------------------------------------------------------------------
------------------------------------------------------------------------------------------------------------------------------------------------------------------------------------------------
-----------------------------------------------------------------------------------------------------------------------------------------------------------------------------------------------o
--------%%%%%%%%--------------------------------------SSSSS-------------o------S-o----------------------------------QQQSSSS--SSS-----------------------SSo-------------oo-----S----------------S
---------||||||------------o-----------------------------------------------------------------------------------------------------------------------%%-----------SS------------------------------
---------||||||------------------------------------------------------------------------------------------------------------------------------------||-----------S-------------------------------
---------||||||-----------------------------------------------------------------------------#----------t-------------------------------------------||---------------------------oo--------------
------%%%%%%%%%%------------------------------------------------------------###-----------###----------t---------------QQ----------------T---------||------------------------o------------------
-------||||||||---------------------------------------t-------------------#-#-#------t---####---------tt--------------------------------TT---------||------------------t------------------------
-------||||||||--------#TT---#-----------T-----------tt------------------####-#------t---####-#-------tt---------------------#----B-----TT---TT----||t-----------------t------------------#-----
-------||||||||-T-----##T#---#-------t---##---g-k----ttt-------#---------####-##----tt--###---#-y-----tt----gg-----k-----------g--b-----TT---##----|tt----------------tt-------g--gggggg-g#-----
XXXXXXXXXXXXXXXXXXXXXXXXXXXXXXXXXXXXXXXXXXXXXXXXXXXXXXXXXXXXXXXXXXXXXXXXXXXXXXXXXXXXXXXXXXXXXXXXXXXXXXXXXXXXXXXXXXXXXXXXXXXXXXXXXXXXXXXXXXXXXXXXXXXXXXXXXXXXXXXXXXXXXXXXXXXXXXXXXXXXXXXXXXXXXXXX
XXXXXXXXXXXXXXXXXXXXXXXXXXXXXXXXXXXXXXXXXXXXXXXXXXXXXXXXXXXXXXXXXXXXXXXXXXXXXXXXXXXXXXXXXXXXXXXXXXXXXXXXXXXXXXXXXXXXXXXXXXXXXXXXXXXXXXXXXXXXXXXXXXXXXXXXXXXXXXXXXXXXXXXXXXXXXXXXXXXXXXXXXXXXXXXX
