-----------------------------------------------------------------------Q------------------------------------------------------------------------------------------------------------------------
------------------------------------------------------------------------------------------------------------------------------------------------------------------------------------------------
------------------------------------------------------------------------------------------------------------------------------------------------------------------------------------------------
------------------------------------------------------------------------------------------------------------------------------------------------------------------------------------------------
-----------------------------------k-------------------------------------------------------------------------------g-----------------------------------------------g----------------------------
--------------------------------%%--------------%%--------------------------------------------------------------%%%%%-------------------------------------------%%%%-------------%--------------
--------%%%%%%%%S--------ooo--2%||----U---------||----r-------------------------------r--------------------------|||--r---------------r---------------r----------||---r----------|----r---------
---------||||||--------------U-|%%%-%%----------%%%%%%%%%-----------------------%%%%%%%%%-------%%---%%---------%%%%%%%%%-------%%%%%%%%%%------%%%%%%%%%%------%%%%%%%%%%------%%%%%%%%%-------
---------||||||----------------|-|--||-----------|||||||-------------------------|||||||--U-----||---||----------|||||||---------||||||||--------||||||||--------||||||||--------|||||||--------
---------||||||-------------U--|-|--||-----------|||||||-------------------------|||||||--------S|---||----------|||||||---------||||||||--------||||||||--------||||||||--------|||||||--------
------%%%%%%%%%%---------USS---|-|--||SSU--------|||||QQ--------QQ---------------|||||SSU--------|TT-|SQ@--------|||||||---------|||||SSU---TT--S|||||SSU---TT---|||||||U---TT---|||||SSU---TT--
-------||||||||----------------|-|--||------TT---|||||---------------------------|||||------TT---|TT-|------TT---|||||||----TT---|||||--|---TT---|TT||--|---TT---||||||||---TT---|TT||------TT--
-------||||||||----------------|-|--||------TT---|||||---------------------------|||||------TT---TTT-|------TT---|||||||----TT---|||||--|---TT---|TT||--|---TT---||||||||---TT---|TT||------TT--
-------||||||||-------R------ggg-gggg|--ggg-TT---|||||-ggg---ggg-gg--------------|||||-ggg--TT-k-TTT-|-ggg--TT---|||||||--k-TT---|||||-ggg--TT-k-|TT||-ggg--TT---||||||||---TT---|TT||-ggg--TT-k
XXXXXXXXXXXXXXXXXXXXXXXXXXX-XXXXXXXXXXXXXXXXXXXXXXXXXXXXXXXXXXXXXXXXXXXXXXXXXXXXXXXXXXXXXXXXXXXX-XXXXXXXXXX-XXX-XXXXXXXXXXXXXXXXXXXXXXXXXXXXXXXXXXXXXXXXXXXXXXXXXXXXXXXXXXXXXXXXXXXXXXXXXXXXXXXX
XXXXXXXXXXXXXXXXXXXXXXXXXXX-XXXXXXXXXXXXXXXXXXXXXXXXXXXXXXXXXXXXXXXXXXXXXXXXXXXXXXXXXXXXXXXXXXXXXXXXXXXXXXX-XX--XXXXXXXXXXXXXXXXXXXXXXXXXXXXXXXXXXXXXXXXXXXXXXXXXXXXXXXXXXXXXXXXXXXXXXXXXXXXXXXX
