------------------------------------------------------------------------------------------------------------------------------------------------------------------------------------------------
------------------------------------------------------------------------------------------------------------------------------------------------------------------------------------------------
------------------------------------------------------------------------------------------------------------------------------------------------------------------------------------------------
----------------SSSSSSSS----------------------------------------SSSSSSSSSSS-------------------------------------SSSS-------------SSSSSSS----------------------------------------SSSSSSSSSSS-----
------------------------------------------------------------------------------------------------------------------------------------------------------------------------------------------------
------------------------------------------------------------------------------------------------------------------------------------------------------------------------------------------------
--------%%%%%%%%--------S---------o-----oo-----o--------------------------------SS-----------SSSSSoo--SSSS-----S--------------------------------SSoS@SSS-----SSS--------------------------------
---------||||||---------------------------------------------------------------------------------------------------------------------------------------------------------------------------------
---------||||||----------------------------------------------------------------------------------------------------------------------------------------------oo-----------------#---------------
---------||||||-----------------oo--------------------------------------------------------------oo----------------------------------------------g-----------------------------------------------
------%%%%%%%%%%----------------S------------------------------------------------------------##-SS-----------SSS--------------------------------#------------@S---------------------------------
-------||||||||----------------------------------------------------------#-------------------##--------------------------------------------------------------------------TT---------------------
-------||||||||------tt------------------------#-------------------------#------------------###--------------------------TT---TT------##-----TT--------------------------TT-------------------TT
-------||||||||------tt------------ggy-------g-g--g------------g-----g--##----------g--k----###----gggk----kk-----k----k-TT---TT-----###-----TT----ggg----k-k-----kggg---TT---k---g----k-g----TT
XXXXXXXXXXXXXXXXXXXXXXXXXXXXXXXXXXXXXXXXXXXXXXXXXXXXXXXXXXXXXXXX-XXXXXXXXXXXXXXXXXXXXXXXXXXXXXXXXXXXXXXXXXXXXXXXXXXXXXXXXXXXXXXXXXXXXXXXXXXXXXXXXXXXXXXXXXXXXXXXXXXXXXXXXXXXXXXXXXXXXXXXXXXXXXXX
XXXXXXXXXXXXXXXXXXXXXXXXXXXXXXXXXXXXXXXXXXXXXXXXXXXXXXXXXXXXXXXXX-XXXXXXXXX-XXXXXXXXXXXXXXXXXXXXXXXXXXXXXXXXXXXXXXXXXXXXXXXXXXXXXXXXXXXXXXXXXXXXXXXXXXXXXXXXXXXXXXXXXXXXXXXXXXXXXXXXXXXXXXXXXXXX
