------------------------------------------------------------------------------------------------------------------------------------------------------------------------------------------------
------------------------------------------------------------------------------------------------------------------------------------------------------------------------------------------------
------------------------------------------------------------------------------------------------------------------------------------------------------------------------------------------------
-------------------------------------SS---------SSSSSSSSSS---------------------------------------SS-------------SSSSSSSSSS--------------------------------------SSSSSSSSS-----------SS----------
------------------------------------------------------------------------------------------------------------------------------------------------------------------------------------------------
------------------------------------------------------------------------------------------------------------------------------------------------------------------------------------------------
--------%%%%%%%%------SSSS--------o---Soo-----oo------------------------------------USSSSS---SSS--------------------------------SSoSSSS------SSS--------------------------------oooo---Soo---SSS
---------||||||----S%%%--------------------------------------------------------------------------#----------------------------------------------------------------------------------------------
---------||||||------|--------------------------------------------------------------------------------------------------------------------------------------------------------------------------
---------||||||------|----------o-----------------------------------------------------------------------------------------------o-----------------------------------------------o---------------
------%%%%%%%%%%-----|-----------------------------------------------------------------SS----SS-------------------------------------S------------------------U----------------------------------
-------||||||||------|-----------------------------------------------------------------------------------------------tt-------------------#-----------------------------------------------------
-------||||||||------tt----------------------------------##----------tt--------------------------------tt-----TT-----tt------------------##------------------------------##---TT----------------
-------||||||||------tt------k-------k-------------------##---#------tt-----k-k---gggg-----------------tt-----TT-----tt-----k-k-----gggg###-------gy------k-k--------k---##---TT-----k----------
XXXXXXXXXXXXXXXXXXXXXXXXXXXXXXXXXXXXXXXXXXXXXXXXXXXXXXXXXXXXXXXXXXXXXXXXXXXXXXXXXXXXXXXXXXXXXXXXXXXXXXXXXXXXXXXXXXXXXXXXXXXXXXXXXXXXXXXXXXXXXXXXXXXXXXXXXXXXXXXXXXXXXXXXXXXXX-XXXXXXXXXXXXXXXXXX
XXXXXXXXXXXXXXXXXXXXXXXXXXXXXXXXXXXXXXXXXXXXXXXXXXXXXXXXXXXXXXXXXXXXXXXXXXXXXXXXXXXXXXXXXXXXXXXXXXXXXXXXXXXXXXXXXXXXXXXXXXXXXXXXXXXXXXXXXXXXXXXXXXXXXXXXXXXXXXXXXXXXXXXXXXXXX-XXXXXXXXXXXXXXXXXX
