-------------------------------------------------%---------------%---------------------------------------------------------------%----------------------------------------------
-------------------------------------------------|---------------|---------------------------------------------------------------|----------------------------------------------
-------------------------------------------------|---------------|---------------------------------------------------------------|----------------------------------------------
----------SSSSSS---------------------------------|---------------|---------------------------------------------------------------|----------------------------------------------
-------SSSS--------------------------------------|---------------|---------------------------------------------------------------|----------------------------------------------
-------SSS------%%-------------------------------|---------------|---------------------------------------------------------------|--------------%%--------------%%--------------
-------------S--||----r---------------r----------|----r----------|----r--------o------r---------------r---------------r----------|----r---------||----r---------||----r---------
----------------%%%%%%%%%-------%%%%%%%%%-------%%%%%%%%%%------%%%%%%%%%-------%%%%%%%%%%------%%%%%%%%%%------%%%%%%%%%-------%%%%%%%%%-------%%%%%%%%%-------%%%%%%%%%-------
-----------------|||||||---------|||||||---------||||||||--------|||||||---------||||||||--------||||||||--------|||||||---------|||||||---------|||||||---------|||||||--------
-------r--S-SSS--|||||||---------|||||||---------||||||||--------|||||||---------||||||||--------||||||||--------|||||||---------|||||||---------|||||||---------|||||||--------
---%%%%%%%%-%%S--|||||SQ---------|||||U|QQQQ-----|||||Q|QQQ-----QQ|||||QQQQ-----S|||||SSU--------|||||SSU--------|||||SQS--------|||||||---------|TT||||U--------||||||S@-------
----||||||--||---|||||-----------|||||||---------|||||-|----------|||||----------|TT||--|---TT---|TT||--|---TT---|||||-----------|TT||||----TT---|TT||||----TT---|TT|||-----TT--
----||||||%%%%---|||||-----------|TT||||---------|||||-|----------|||||----------|TT||--|---TT---|TT||--|---TT---|TT||-----------|TT||||----TT---|TT||||----TT---|TT|||-----TT--
----||||||-g|----|||||-ggg----gk-|TT||g|----gggg-|||||-g------gg--|||||--gg---g--|TT||-ggg--TT-k-|TT||-ggg--TT-k-|T-||---g----gg-|TT|||ggg--TT-k-|TT|||ggg--TT-k-|TT|||ggg--TT-k
----||||||XX|-XX-XXXXXXXXXXXXXXXXXXXXXXXXXXXXXXXXXXXXXXXXXXXXXXXXXXXXXXXXXXXXXXXXXXXXXXXXXXXXXXXXXXXXXXXXXXXXXXXXXXXXXXXXXXXXXXXXXXXXXXXXXXXXXXXXXXXXXXXXXXXXXXXXXXXXXXXXXXXXXXX
----||||||XX|-XXXXXXXXXXXXXXXXXXXXXXXXXXXXXXXXXXXXXXXXXXXXXXXXXXXXXXXXXXXXXXXXXXXXXXXXXXXXXXXXXXXXXXXXXXXXXXXXXXXXXXXXXXXXXXXXXXXXXXXXXXXXXXXXXXXXXXXXXXXXXXXXXXXXXXXXXXXXXXXXXX
