------------------------------------------------------------------------------------------------------------------------------------------------------------------------------------------------
------------------------------------------------------------------------------------------------------------------------------------------------------------------------------------------------
------------------------------------------------------------------------------------------------------------------------------------------------------------------------------------------------
----------------#-------------------------------------------------------------------------------SSSSSSSSS------------------------------------------SSSS---------SS------------------------------
------------------------------------------------------------------------------------------------------------------------------------------------------------------------------------------------
------------------------------------------------------------------------------------------------------------------------------------------------------------------------------------------------
--------%%%%%%%%--------------------Q---o------o------SS-------------QQSQS-----o---QQSQQQS----SS--------------------QQQQQSS--S@S----QQQQQS-----U------------------------------------QQQQQS---SSS
---------||||||--oo-----------oo----------------------K-----------------------------------------------------------------------------------------------------------------------------------------
---------||||||-%%------------------------------------------------------------------------------------------------------------------------------------------------------------------------------
---------||||||-||----------#--#-------------------------------------------------------o------------------------S-------------------------------------------------------------------------------
------%%%%%%%%%%||--------###--#-##-------------------------------------------------S--S----SoS------------------------QQ----Q--------------So------------------------tt-----o-------SQQQS---o--
-------||||||||-||-------####-oo-------------------------------------------------------------------------------------------------------------------------##-----------tt------T-----------------
-------||||||||-||-------####-%%---------------------t-----------------------------------------------------------------------------------------------t---TT-----------tt-----TT-----------------
-------||||||||-||g-----####--|#------gg--k-k-------gt-------ggg-----kgy-----g-g---ggg----k-----k------k------gg---k--------------ggggg---k----------t---TT---T-------tt----kkT----k--------k---
XXXXXXXXXXXXXXXXXXXXXXXXXXXX--|XXXXXXXXXXXXXXXXXXXXXXXXXXXXXXXXXXXXXXXXXXXXXXXXXXXXXXXXXXXXXXXXXXXXXXXXXXXXXXXXXXXXXXXXXXXXXXXXXXXXXXXXXXXXXXXXXXXXXXXXXXXXXXXXXXXXXXXXXXXXXXXXXXXXXXXXXXXXXXXXX
XXXXXXXXXXXXXXXXXXXXXXXXXXXX--|-XXXXXXXXXXXXXXXXXXXXXXXXXXXXXXXXXXXXXXXXXXXXXXXXXXXXXXXXXXXXXXXXXXXXXXXXXXXXXXXXXXXXXXXXXXXXXXXXXXXXXXXXXXXXXXXXXXXXXXXXXXXXXXXXXXXXXXXXXXXXXXXXXXXXXXXXXXXXXXXX
