------------------------------------------------------------------------------------------------------------------------------------------------------------------------------------------------
------------------------------------------------------------------------------------------------------------------------------------------------------------------------------------------------
------------------------------------------------------------------------------------------------------------------------------------------------------------------------------------------------
----------------SSSSSSSSS-------------------------------------------------------SSSSSSSSSSSSSSS-SSSSSSSS-------------------------S--------------SSSSSSSSSS----------------------S---------------
-------------------------------------------------------------------------------#----------------------------------------------------------------------------------------------------------------
------------------------------------------------------------------------------------------------------------------------------------------------------------------------------------------------
--------%%%%%%%%--------SS-----------------------oo---SSSS----o------------------oo-----------------------------SSSSSSSSSS---SSS----------------oooo---------SoS-----------------oo----ooo-----o
---------||||||-----%%--------------------------------------------------------------------------------------------------------------------------------------------------------------------------
---------||||||-----||--------------------------------------------------------------------------------------------------------------------------S-----------------------------------------------
---------||||||-----||--------------------------o------------S------------------oo------------------------------g-g----g-------o----------------oo-------------o----------------ooo-------------
------%%%%%%%%%%----||--------------------------S------------S------------------S-------------------------------SSQQQ--SS----USS----------------S--------#--------------------------------------
-------||||||||-----|tt------------------------------------------------------------------#---------------TT---------------------------------------------##---------------TT---------------------
-------||||||||-----|tt------------------------------------------------------------------#---------------TT---TT--------------------------------------####---K-----------TT---------------------
-------||||||||-----|tt------ggg----gg------k-------okk----k------------------oo-----k--####--#---k--g---TT---TT------y------------------k---g-------#####-#-#----kgggg--TT---ko-----g----------
XXXXXXXXXXXXXXXXXXXXXXXXXXXXXXXXXXXXXXXXXXXXXXXXXXXXXXXXXXXXXXXX---XXXXXXXXXX%%%XXXXXXXXXXXXXXXXXXXXXXXXXXXXXXXXXXXXXXXXXXXXXXXX-XXXXXXXXXXXXXXXXXXXXXXXXXXXXXXXXXXXXXXXXXXXXXXXXXXXXXXXXXXXXXXX
XXXXXXXXXXXXXXXXXXXXXXXXXXXXXXXXXXXXXXXXXXXXXXXXXXXXXXXXXXXXXXXX---XXXXXXXXXXXXXXXXXXXXXXXXXXXXXXXXXXXXXXXXXXXXXXXXXXXXXXXXXXXXX-XXXXXXXXXXXXXXXXXXXXXXXXXXXXXXXXXXXXXXXXXXXXXXXXXXXXXXXXXXXXXXX
