------------------------------------------------------------------------------------------------------------------------------------------------------------------------------------------------
------------------------------------------------------------------------------------------------------------------------------------------------------------------------------------------------
------------------------------------------------------------------------------------------------------------------------------------------------------------------------------------------------
------------------------------------------------------------------------------------------------------------------------------------------------------------------------------------------------
------------------------------------------------------------------------------------------------------------------------------------------------------------------------------------------------
--------------------------%%--------------------------------------------------------------------------------------------------------------------------------------------------------------------
--------%%%%%%%%----------||-------------------------Q--QQQ--Q-U----------------------S-----------------------------------------SS--------------------------------------------------------------
---------||||||-----------||---------------------------------------------------------------------------------------------------------o-----------------------------------ooo--------------o-----
---------||||||--%%%%%%%%-||--------------------------------------------------------------------------------------------------------------------------------------------------------------------
---------||||||---||||||--||--------------------------------------------------------------------------------------------------------------------------------------------------------------------
------%%%%%%%%%%--||||||--%%-----------------##---Q--QQQQQQQQ----------------------------TT----------------------------------------------------------------QQQQ-------------TT------------------
-------||||||||---||||||--||----------------###------------------------------------------TT---------tt---------------------------TTT-----TT---------------------------------TT---------TT-------
-------||||||||---||||||--||---------------####------------------------------------------TT---------tt-TT------------------------TTT--tt-TT---------------------------------TT------tt-TT-------
-------||||||||---||||||--||---g--------y-#####--g------Kg----g----ggg------kk-----------TT---------tt-TT------------------------TTT--tt-TT---gg--------------gg----------k-TT------tt-TT-------
XXXXXXXXXXXXXXXXXXXXXX||--||--%%XXXXXXXXXXXXXXXXXXXXXXXXXXXXXXXXXXXXXXXXXXXXXXXXXXXXXXXXXXXXXXXXXXXXXXXXXXXXXXXXXXXXXXXXXXXXXXXXXXXXXXXXXXXXXXXXXXXXXXXXXXXXXXXXXXXXXXXXXXXXXXXXXXXXXXXXXXXXXXXX
XXXXXXXXXXXXXXXX-XXXXX||--||--||XXXXXXXXXXXXXXXXXXXXXXXXXXXXXXXXXXXXXXXXXXXXXXXXXXXXXXXXXXXXXXXXXXXXXXXXXXXXXXXXXXXXXXXXXXXXXXXXXXXXXXXXXXXXXXXXXXXXXXXXXXXXXXXXXXXXXXXXXXXXXXXXXXXXXXXXXXXXXXXX
