------------------------------------------------------------------------------------------------------------------------------------------------------------------------------------------------
------------------------------------------------------------------------------------------------------------------------------------------------------------------------------------------------
------------------------------------------------------------------------------------------------------------------------------------------------------------------------------------------------
----------------SSSS-----------S----------------------------------------------------------------SSSSSS----------------------------------------------------------SSS-----------------------------
-----------------------------------------------2------------------------------------------------------------------------------------------------------------------------------------------------
----------------------------------------------------------------------------------------------------------------------------------------o-------------------------------------------------------
--------%%%%%%%%%%%---------------------------------Q-QQQ-----o------Qo----------ooo--oooo-----o-----------------------S------------------------------oo-------------------------oo-------------
---------||||||--|----------------------------------------------------------------S%%-----------------------------------------------------------------------------------------------------------
---------||||||--|---------%-------------------------------------------------oo----||--------SSS#-----------------------------------------------------------------------------------------------
---------||||||--|---------|-------------------------------------------------------||-----------------------------------------------------------------------------------------------------------
------%%%%%%%%%%-|---------#---------------------#Q##------------------------US----||#------------------------------S--------U-------2---TT----------------------------------------------TT-----
-------||||||||-o|---------#---------------------------------#---------------------||#--------------------------------------------TT-----TT-----------tt---------------------------------TT-----
-------||||||||-%%-------###------TT----K--------------------#---------------------||#------------------------TT------------------TT-----TT-----------tt---------------tt----------------TT-----
-------||||||||-%|-------###------TT----g----g-----k---------#----gy-ggg--k-k---#--k|#------------#-----------TT-------k----------TT-----TT-----------tt---y------g----tt-----g----k-k---TT-----
XXXXXXXXXXXXXXXX||---XXXXXXXX--XXXXXXXXXXXXXXXXXXXXXXXXXXXXXXXXXXXXXXXXXXXXXXXXXXXXXXXXXXXXXXXXXXXXXXXXXXXXXXXXXXXXXXXXXXXXXXXXXXXXXXXXXXXXXXXXXXXXXXXXXXXXXXXXXXXXXXXXXXXXXXXXXXXXXXXXXXXXXXXXX
XXXXXXXXXXXXXXXX||---XXXXXXXX-XXXXXXXXXXXXXXXXXXXXXXXXXXXXXXXXXXXXXXXXXXXXXXXXXXXXXXXXXXXXXXXXXXXXXXXXXXXXXXXXXXXXXXXXXXXXXXXXXXXXXXXXXXXXXXXXXXXXXXXXXXXXXXXXXXXXXXXXXXXXXXXXXXXXXXXXXXXXXXXXXX
