------------------------------------------------------------------------------------------------------------------------------------------------------------------------------------------------
------------------------------------------------------------------------------------------------------------------------------------------------------------------------------------------------
------------------------------------------------------------------------------------------------------------------------------------------------------------------------------------------------
------------------------------------------------SSSSSSSSSSS------SSS-SS-----------------------------------------SSSSSSSSSSS--SSS------------------SSSSS--SS----------------------S--------------
------------------------------------------------------------------------------------------------------------------------------------------------------------------------------------------------
------------------------------------------------------------------------------------------------------------------------------------------------------------------------------------------------
--------%%%%%%%%-----QQooo----oo-----------------------------------------------S-----------------o----S--------o--------------------QQQQQS---SSS----------------------SSS-----------------------
---------||||||----------------------------------------------------------------------------------------------------------------------------------#----------------------------------------------
---------||||||---------------------------------------------------------------------------------------------------------------------------------------------------------------------------------
---------||||||---------------------------------------#-----------------------------------------------------------------------------------------------------------------------------------------
------%%%%%%%%%%####QQQ-Q------------2----------------#--------------------------------------##----------##----------------------------------o----------TT--------------------------------------
-------||||||||--------------------------TT-----------t---------------------------------TT---##----------##-----------------#-##------------------TT----TT---TT---------------------------------
-------||||||||--------------------------TT----------tt--------------tt-----------------TT---###--------###---------------###-##------------------TT----TT---TT------tt-----------------TT---##-
-------||||||||-##-k--------k-----ggg----TT-----k----tt-------gg-----tt----ggggg--g--k--TT---###------g####-----%%k----k-####-##--ggggg--------g--TT----TT---TT------tt-------k---------TT---###
XXXXXXXXXXXXXXXXXXXXXXXXXXXXXXXXXXXXXXXXXXXXXXXXXXXXXXXXXXXXXXXXXXXXXXXXXXXXXXXXXXXXXXXXXXXXXXXXXXXXXXXXXXXXXXXXXXXXXXXXXXXXXXXXXXXXXXXXXXXXXXXXXXXXXXXXXXXXXXXXXXXXXXXXXXXXXXXXXXXXXXXXXXXXXXXX
XXXXXXXXXXXXXXXXXXXXXXXXXXXXXXXXXXXXXXXXXXXXXXXXXXXXXXXXXXXXXXXXXXXXXXXXXXXXXXXXXXXXXXXXXXXXXXXXXXXXXXXXXXXXXXXXXXXXXXXXXXXXXXXXXXXXXXXXXXXXXXXXXXXXXXXXXXXXXXXXXXXXXXXXXXXXXXXXXXXXXXXXXXXXXXXX
