------------------------------------------------------------------------------------------------------------------------------------------------------------------------------------------------
------------------------------------------------------------------------------------------------------------------------------------------------------------------------------------------------
------------------------------------------------------------------------------------------------------------------------------------------------------------------------------------------------
--------------------------------SSSS----------------------------S----------------------------------------------------------------S--------------------------------------------------------------
------------------------------------------------------------------------------------------------------------------------------------------------------------------------------------------------
---------------------------------------------------------------------------------------------------------o---------------------------------------------------------------------o----------------
--------%%%%%%%%--------------------------------------------------------------------------------------------------------------------------------------------------------------------------------
---------||||||--------o------------------------------------------------------So-----------------------------------------------#----------------------------------------------oo----------------
---------||||||-------------------------------------------------------------------------------------o------------------------###----------------------------------------------------------------
---------||||||--------------------------------------------------------------------------------------2---------------------#####----------------------------------------------------------------
------%%%%%%%%%%---------S%----------#-------------------------------------##------------------------2--------------------######-------------------------##----------------------------------o--
-------||||||||-----------|------------------------------TT----o-----------##--------------------T------TT---------------TT#####-------------------------TT------------TT----------------T------
-------||||||||-----------|-------------------TT---------TT--------------####-------------------TTt-----TT---------------TT####T-----B-t------U----------T#---TT-------TT----TT----------T---TT-
-------||||||||-----------|-------------------TT--k------TT-------g----######-----------------k#TTt----kTt----#g--kk----########-----k-t------#---k-----###---TT--g----TT---gggg--g--k-ttT---TT-
XXXXXXXXXXXXXXXX%%%%XXXXXXXX-%%%XXXXXXXXXXXXXXXXXXXXXXXXXXXX----XXXXXXXXXXXXX--XXXXXXXXXXXXXXXXXXXXXXXXXXXXXXXXXXXXXXXXXXXXXXXXXXXXXXXXXXXXXXXXXXXXXXXXXXXXXXXXXXXXXXXXXXXXXXXXXXXXXXXXXXXXXXXXX
XXXXXXXXXXXXXXXXXXXXXXXXXXXX--|XXXXXXXXXXXXXXXXXXXXXXXXXXXXX----XXXXXXXXXXXXX-XXXXXXXXXXXXXXXXXXXXX-XXXXXXXXXXXXXXXXXXXXXXXXXXXXXXXXXXXXXXXXXXXXXXXXXXXXXXXXXXXXXXXXXXXXXXXXXXXXXXXXXXXXXXXXXXXX
