----------------------------------------------------------------------------------------------------2-------------%-2---------------------------------------------------------------------------
---------------------------------------------------------------------------------------------------Q--------------|-----------------------------------------------------------------------------
------------------------------------------------------------------------------------------------------------------#-----------------------------------------------------------------------------
-----------------------------------------------------------------------------------------------------------------##--#--------------------------------------------------------------------------
------------------------------------------------------------------------------------------------------------------#g##-------------------------------------------------------------g#-----------
----------------%%%%%%%%%-%-----%%%-------U----U------------------------------------------------%%%%------------%###-------------------------------------------------------------###------------
--------%%%%%%%%-|||||||--|------|---------------------SSSS-----------SSSSS---%%-----------------||---U---------|---------------------------------------------------------------------U---------
---------||||||--|||||||r-|------|--------------------------------------------||----------------%%%%%-----------|#-###---ooo----------------------------------------------------%---%%%---------
---------||||||--|||%%%%%%|%-%---|--------------------------------------------||-----------------|||------------|---------------------------------------------------------------|----|----------
---------||||||--|||-||||-||-|---|--------------------------------------------||-----------------|||------------|-----------------------------------------------S---------------|----|----------
------%%%%%%%%%%-|||-||||-||-|%%-|%%%-%SS------------USSS---------SQ-USSo-----||-----------------|TT------------|-S---------TT-------Q------TT----TT--------------TT--------TT--|SS--|------TT--
-------||||||||--|||-||||-||-|||-|-|--|------#--------------------------------||-----------------|TT--------TT--|-----------TT--------------TT----TT-----TT-TT----TT--------TT--|----|------TT--
-------||||||||--|||-||||-||-|||-|-|--|-----##--------------------------------||-----------------|TT--------TT--|-----------TT-----------TT-TT----TT-----TT-TT----TT--------TT--|----|------TT--
-------||||||||--|||-||||-gg-|||-|-|--|-g-k###---------ggg-------ggg---ggg----|k----y--k---------|TT---kgy--TT--|---------k-TT-------y-k-TT-TT-k--TT---k-TT-TT-k--TT---kg---TT--ggg--|--g---TT--
XXXXXXXXXXXXXXXX-|||-||||-%|-|||-|-|--|XXXXXXXX-XXXXXXXXXXXXXXXXXXXXXXXXXXXXXXXXXXXXXXXXXXXXXXXXXXXXXXXXXXXXXXXXXXXXXXXXXXXXXXXXXXXXXXXXXXXXXXXXXXXXXXXXXXXXXXXXXXXXXXXXXXXXXXXXXXXXXXXXXXXXXXXX
XXXXXXXXXXXXXXXX-|||-||||-||-|||-|-|--|XXXXXXXB-XXXXXXXXXXXXXXXXXXXXXXXXXXXXXXXXXXXXXXXXXXXXXXXXXXXXXXXXXXXXXXXXXXXXXXXXXXXXXXXXXXXXXXXXXXXXXXXXXXXXXXXXXXXXXXXXXXXXXXXXXXXXXXXXXXXXXXXXXXXXXXXX
