------------------------------------------------------------------------------------------------------------------------------------------------------------------------------------------------
------------------------------------------------------------------------------------------------------------------------------------------------------------------------------------------------
------------------------------------------------------------------------------------------------------------------------------------------------------------------------------------------------
------------------------------------------------S---------------SSS---------------------------------------------------------------------------------------------SSSSSSSS------------------------
------------------------------------------------------------------------------------------------------------------------------------------------------------------------------------------------
------------------------------------------------------------------------------------------------------------------------------------------------------------------------------------------------
--------%%%%%%%%-SoS-----------S-----------------------oS------S----------------S---Q---oS----oo----------------------SSSS-----S---------------S------------------------S--------------S-----SSS
---------||||||------------------------------------%%%%-----------------------------------------------------------------------------------------------------------------------------------------
---------||||||-------------------------------------||----------------------------------------S-------------------------------------------------------------------------------------------------
---------||||||-------------------------------------||------------------------------------------------------------------------------------------------------------------------------------------
------%%%%%%%%%%------S@-----SS---------------------||--------------------------##Q-Q--------US------------------------------o------S-##-----------------TT-------------------------------------
-------||||||||-------------------------------------|S---------------tt---------------------------------TT-----------tt---------------------------TT-----TT----------ttt------------------------
-------||||||||-------------------------------------|S---------------tt---------------------------B-----TT---g-------tt---------------------------TT-----TT----------ttt------y-----------------
-------||||||||-------------------gg---k----kkk-----|------#----#----tt----#------gggg----k-k-----b-----TT--####-----tt--------g------------------TT-----TT----------ttt----ggg-------------k---
XXXXXXXXXXXXXXXXXXXXXXXXXXXXXXXXXXXXXXXXXXXXXXXXXXXXXXXXXXXXXXXXXXXXXXXXXXXXXXXXXXXXXXXXXXXXXXXXXXXXXXXXXXXXXXXXXXXXXXXXXXXXXXXXXXXXXXXXXXXXXXXXXXXXXXXXXXXXXXXXXXXXXXXXXXXXXXXXXXXXXXXXXXXXXXXX
XXXXXXXXXXXXXXXXXXXXXXXXXXXXXXXXXXXXXXXXXXXXXXXXXXXXXXXXXXXXXXXXXXXXXXXXXXXXXXXXXXXXXXXXXXXXXXXXXXXXXXXXXXXXXXXXXXXXXXXXXXXXXXXXXXXXXXXXXXXXXXXXXXXXXXXXXXXXXXXXXXXXXXXXXXXXXXXXXXXXXXXXXXXXXXXX
