------------------------------------------------------------------------------------------------------------------------------------------------------------------------------------------------
------------------------------------------------------------------------------------------------------------------------------------------------------------------------------------------------
------------------------------------------------------------------------------------------------------------------------------------------------------------------------------------------------
------------------------------------------------------------------------------------------------------------------------------------------------------------------------------------------------
------------------------------------------------------------------------------------------------------------------------------------------------------------------------------------------------
--------------------------------------------------------------------------------------------------------------------------------------------------##--------------------------------------------
--------%%%%%%%%---------------o--------------------SS----------------------------------------------------------SSoSo----------------------------------------S------------------S--------------S
---------||||||------------------------------------------------------------------------------------------------------------------------------------------oo-------------------------------------
---------||||||-----------------------------------------------------------------------------------------------------------------------------------------SS--------------------------------------
---------||||||---------------------------S------------------------------SS---------------S-------------------------------------------------------------SSS-------------------------------------
------%%%%%%%%%%QQ------QQQQ-----------------------#------T---------------------------------------TT-------SQ------@------------------------------------------------------------------------Q---
-------||||||||------------------K-----------##----#-----TT----#-------TT--------------TT---------TT---------------------TT-------------------------------------------------------TT------------
-------||||||||-----------------------------###--#-#-----TT----#----tt-TT-----------tt-TT---------TT---------------------TT-------------------------tt-TT-------------------------TT------------
-------||||||||------------g------K---------###--#-#-----TT----#----tt-TT---kk------tt-TT---------TT---------ggg------g-kTT----g--------------------tt-TT-k--k------gy------------TT---------ggg
XXXXXXXXXXXXXXXXXXXXXXXXXXXXXXXXXXXXXXXXXXXXXXXXXXXXXXXXXXXXXXXXXXXXXXXXXXXXXXXXXXXXXXXXXXXXXXXXXXXXXXXXXXXXXXXXXXXXXXXXXXXXXXXXXXXXXXXXXXXXXXXXXXXXXXXXXXXXXXXXXXXXXXXXXXXXXXXXXXXXXXXXXXXXXXXX
XXXXXXXXXXXXXXXXXXXXXXXXXXXXXXXXXXXXXXXXXXXXXXXXXXXXXXXXXXXXXXXXXXXXXXXXXXXXXXXXXXXXXXXXXXXXXXXXXXXXXXXXXXXXXXXXXXXXXXXXXXXXXXXXXXXXXXXXXXXXXXXXXXXXXXXXXXXXXXXXXXXXXXXXXXXXXXXXXXXXXXXXXXXXXXXX
