------------------------------------------------------------------------------------------------------------------------------------------------------------------------------------------------
------------------------------------------------------------------------------------------------------------------------------------------------------------------------------------------------
----------------------------------------------------------------------------------------------------------------------------------------------------------------t-------------------------------
-----------------------------------------------------#----------------------------------------------------------------------------------------------------------t-------------------------------
--------------------------------------------------#g##---------------------------------------------g--------------------------------------------------------------------------------------------
-------------------------------------------------###--------------##------------------------------##------------------------------##----------------------------------------------##------------
--------%%%%%%%%-----------------------------------------------------------------SS---------S--------------------------------o----------------------------------SS------------------------------
---------||||||------------------------------------------ooo--------------------------------------------------------------o-------------oo--------------SSSS-------ooo-------------------SS-----
---------||||||-----------------------------------------------------------------------------------------------------------------------------------------SS------------------------------SS------
---------||||||--------------1---------------------------SS--------------SS-------------------------------S---------------------------------------------SSSS----------------------------SSSS----
------%%%%%%%%%%-----------Q----------------------S-------------------------------------------------------------QSS---------------------------------------------TT----------------------------#-
-------||||||||-----------------------------------------------------------------TT-------TT---------tt-------------------------T----tt-----tt----------TT-------TT----tt-TT---------tt-TT-----#-
-------||||||||-------------------------------------tt-TT-----------tt-TT-------TT----B--TT----T----tt-TT--tt------------------T----tt-----tt----------TT-------TT----tt-TT---------tt-TT-----#-
-------||||||||-------g----------------------k------tt-TT-----------tt-TT-------TT----b-kTT----TK---tt-TT--tt----------k--T----Tg---tt-----tt----------TT-------TT----ttkTT----T----tt-TT-----#-
XXXXXXXXXXXXXXXXX----XXXXXXXXXXXXXXXXXXXXXXXXXXXXXXXXXXXXXXXXXXXXXXXXXXXXXXXXXXXXXXXXXXXXXXXXXXXXXXXXXXXXXXXXXXXXXXXXXXXXXXXXXXXXXXXXXXXXXXXXXXXXXXXXXXXXXXXXXXXTXXXXXXXXXXXXXXXXXXXXXXXXXXXXXXX
XXXXXXXXXXXXXXXXX----XXXXXXXXXXXXXXXXXXXXXXXXXXXXXXXXXXXXXXXXXXXXXXXXXXXXXXXXXXXXXXXXXXXXXXXXXXXXXXXXXXXXXXXXXXXXXXXXXXXXXXXXXXXXXXXXXXXXXXXXXXXXXXXXXXXXXXXXXXXXXXXXXXXXXXXXXXXXXXXXXXXXXXXXXXX
