------------------------------------------------------------------------------------------------------------------------------------------------------------------------------------------------
------------------------------------------------------------------------------------------------------------------------------------------------------------------------------------------------
------------------------------------------------------------------------------------------------------------------------------------------------------------------------------------------------
---------------------------------SS-SSS---------------------------------------------------------SSSSSSSS-----------------------------------------SSSSSS-----------------------------------------
------------------------------------------------------------------------------------------------------------------------------------------------------------------------------------------------
------------------------------------------------------------------------------------------------------------------------------------------------------------------------------------------------
--------%%%%%%%%S-----S-----------------------------------------------------------------oo-----o----------------------QQSS-----------------------ooo----o----------------------------QQQSS----So
---------||||||---------------------------------------------------------------------------------------------------------------------------------------------------------------------------------
---------||||||-------------------------------------------------------------------------------------------------------------------SSS-----------------------------------------------------------
---------||||||---------------------------------------------------------------------------------------------------------------------------------------------------------------------------------
------%%%%%%%%%%---------SSSS@So--------------------------------------------#---#-#-------------------------------------Q-------------------------------------------------------------------SSS-
-------||||||||-------------------------------------------------------------##--#-##-------------------------TT--------------------------TT-----------------------------------------------------
-------||||||||----------------@-------TT----TT------------------------tt---##--#-##------------------tttt---TT--------------------------TT---------------------------tt-----#------------------
-------||||||||---gggg----------g------TT----TT---gg---------k----g----tt---##g-####----g##-------#---tttt---TT---gy----------------g----TT----g--------------k-------tt----g###--gggggg--k-----
XXXXXXXXXXXXXXXXXXXXXXXXXXXXXXXXXXXXXXXXXXXXXXXXXXXXXXXXXXXXXXXXXXXXXXXXXXXXXXXXXXXXXXXXXXXXXXXXXXXXXXXXXXXXXXXXXXXXXXXXXXXXXXXXXXXXXXXXXXXXXXXXXXXXXXXXXXXXXXXXXXXXXXXXXXXXXXXXXXXXXXXXXXXXXXXX
XXXXXXXXXXXXXXXXXXXXXXXXXXXXXXXXXXXXXXXXXXXXXXXXXXXXXXXXXXXXXXXXXXXXXXXXXXXXXXXXXXXXXXXXXXXXXXXXXXXXXXXXXXXXXXXXXXXXXXXXXXXXXXXXXXXXXXXXXXXXXXXXXXXXXXXXXXXXXXXXXXXXXXXXXXXXXXXXXXXXXXXXXXXXXXXX
