------------------------------------------------------------------------------------------------------------------------------------------------------------------------------------------------
------------------------------------------------------------------------------------------------------------------------------------------------------------------------------------------------
------------------------------------------------------------------------------------------------------------------------------------------------------------------------------------------------
---------------------------------SSS----------------------------------------------------------------------------------------------------------------------------SSSSSSS-------------------------
-----------------------------------------------------------------------------------------------------------------------------------------------#----------------------------------------------o-
------------------------------------------------------------------------------------------------------------------------------------------------------------------------------------------------
--------%%%%%%%%----------------------------------oo----o-----oo---------------------QSQQ-------------------------------------------------------------------------------------------QQQQQS----SS
---------||||||--o--------##--------------------------------------------------------------------------------------------------------------------------------------------------------------------
---------||||||----------###-------------------------------#------------------------------------------------------------------------------------------------------------------------------------
---------||||||----------###-------------------------------#------------------------------------------------------------------------------------------------------------------------------------
------%%%%%%%%%%---------###------------------------------###--------------------------------------------------------------------------tt----------------TT----------------------------QQ----o--
-------||||||||---TT----###--------------B---------------####----------tt------------------------------------#-------------------------tt----------------TT-------------------------------------
-------||||||||---TT--######------B------b----TT--------#####----------tt----##------------------------------#-------------------------tt----TT----------TT-------B------TT---#-----------------
-------||||||||---TT--######------b------b----TT---k-k-######----------tt----##g------k-----kk---------g-----#--------g---#---g-g------tt----TT---kk---g-TT---kok-b------TT---g----k-g------k---
XXXXXXXXXXXXXXXXXXXXXXXXXXX-XXXXXXXXXXXXXXXXXXXXXXXXXXXXXXXXXXXXXXXXXXXXXXXXXXXXXXXXXXXXXXXXXXXXXXXXXXXXXXXXXXXXXXXXXXXXXXXXXXXXXXXXXXXXXXXXXXXXXXXXXXXXXXXXXXXXXXXXXXXXXXXXXXXXXXXXXXXXXXXXXXXX
XXXXXXXXXXXXXXXXXXXXXXXXXXX--XXXXXXXXXXXXXXXXXXXXXXXXXXXXXXXXXXXXXXXXXXXXXXXXXXXXXXXXXXXXXXXXXXXXXXXXXXXXXXXXXXXXXXXXXXXXXXXXXXXXXXXXXXXXXXXXXXXXXXXXXXXXXXXXXXXXXXXXXXXXXXXXXXXXXXXXXXXXXXXXXXX
