------------------------------------------------------------------------------------------------------------------------------------------------------------------------------------------------
------------------------------------------------------------------------------------------------------------------------------------------------------------------------------------------------
----------------#-------------------------------------------------------------------------------------------------------------------------------------------------------------------------------
----------------#--------------#-----------------------------------------------------------------S--------------------------------------------------------------SSSSSSSSSSSSSSSS----------------
------------------------------------------------------------------------------------------------------------------------------o-----------------------------------------------------------------
------------------------------------------------------------------------------------------------------------------------------------------------------------------------------------------------
--------%%%%%%%%--------------------------------S--S@SSSS----SSS----------------------S-------------------------So-QQQQQQS---S-S-----------------oo---SSSS----SS---------------S----------------
---------||||||----------------%----------------------------------------------------------------------------------------------------------------------------------------------------------------
---------||||||------------##--|----------------------------------------------------------------------------------------------------------------------------------------------------------------
---------||||||------------##--|---------------------------------------------------------------------------------------------------------o------------------------------------------------------
------%%%%%%%%%%-----------#---|--------------------S---SS---USS-------------------------------------------------------S----SUS---------------------QQS------oS---------------------------------
-------||||||||------------#---|--TT----TT-----------------------------TT---------------------------------#------------------------------B------------------------------------------------------
-------||||||||--------###-#%%%%--TT----TT-----------------------------TT---------------------------------#------------------------------b----U-------------------------------------------------
-------||||||||--------####--||-k-TT----TT---------ggg------k---g-gg---TT-----g--------------k----k-------#---#----kgg----k-k-----g------b---ggg------------------------------gg----o-----------
XXXXXXXXXXXXXXXX-%%%--XXXXX--||-XXXXXXXXXXXXXXXXXXXXXXXXXXXXXXXXXXXXXXXXXXXXXXXXXXXXXXXXXXXXXXXXXXXXXXXXXXXXXXXXXXXXXXXXXXXXXXXXXXXXXXXXXXXXXXXXXXXXXXXXXXXXXXXXXXXXXXXXXXXXXXXXXXXXXXXXXXXXXXXX
XXXXXXXXXXXXXXXXX-|---XXXXX--||-XXXXXXXXXXXXXXXXXXXXXXXXXXXXXXXXXXXXXXXXXXXXXXXXXXXXXXXXXXXXXXXXXXXXXXXXXXXXXXXXXXXXXXXXXXXXXXXXXXXXXXXXXXXXXXXXXXXXXXXXXXXXXXXXXXXXXXXXXXXXXXXXXXXXXXXXXXXXXXXX
