------------------------------------------------------------------------------------------------------------------------------------------------------------------------------------------------
------------------------------------------------------------------------------------------------------------------------------------------------------------------------------------------------
------------------------------------------------------------------------------------------------------------------------------------------------------------------------------------------------
-----------------------------------------SSSSSSS-------SS-----------------SSSS--------SSS-----------------SS---------------SSS-----------------------------S-S----------------------------------
---------------------------------------------------------------------------SS-------------------------------------------S--SS--------------------------SSoo-------------------------------------
-------------------------------------------------------------ooo------SSS----S---------------ooo------------------------SS-SSS-------------------------SSSS--S----------------------------------
--------%%%%%%%%--------------------SSooS----------SSSSS---------SSSSSSSSSSSSSSS--SSSSSS---------SSSSSSSSSSSUS------SSSSSSSSSSSSSSSSSSSSSSS-SS---------SSS--SS---SS------S--SS--------------SS--
---------||||||----------o-------------S--------------------------------------------------------------------------------------------------------------------------------------------------------
---------||||||-----------K------------------------SS------------------------------SS-----------------------------------------------------------------------------------------------------------
---------||||||----------S------------------------------------------------------------o----------------------------o--ooo---------------------------------oo------------------------------o-----
------%%%%%%%%%%--S--------------SS---SS----SS----SSSU--------------------SSSSS----SSS------##----SS-UR-----SS----SSSSSSSS--SSSS----------------------------------------------------------------
-------||||||||-----------------------------TT-----------TT---------------------------------------------------------------------T--------TT-----TT------------TTTT-------TT---------------------
-------||||||||-----tt-----B----------------TT-----------TT------------------------------TT-------------------------------------T-----B--TT-----TT------------TTTT----B--TT----T----------------
-------||||||||-----tt-----b------k-----kg--TT-----k---k-TT----------y-------------------TT-------ggggR--------k---k----kkk-----T-----b--TT-----TT----g-------TTTT----b--TT----T------U---------
XXXXXXXXXXXXXXXXXXXXXXXXXXXXXXXXXXXXXXXXXXXXXXXXXXXXXXXXXXXXXXXXXXXXXXXXXXXXXXXXXXXXXXXXXXXXXX-XXXXXXXXXXXXXXXXXXXXXXXXXXXXXXXXXXXXXXXXXXXXXXXXXXXXXXXX-XXXXXXXXXXXXXXXXXXXXXXXXXXXXXXX-XXXXXXXX
XXXXXXXXXXXXXXXXXXXXXXXXXXXXXXXXXXXXXXXXXXXXXXXXXXXXXXXXXXXXXXXXXXXXXXXXXXXXXXXXXXXXXXXXXXXXXXXXXXXXXXXXXXXXXXXXXXXXXXXXXXXXXXXXXXXXXXXXXXXXXXXXXXXXXXX-XXXXXXXXXXXXXXXXXXXXXXXXXXXXXXX-XXXXXXXX
