------------------------------------------------------------------------------------------------------------------------------------------------------------------------------------------------
------------------------------------------------------------------------------------------------------------------------------------------------------------------------------------------------
------------------------------------------------------------------------------------------------------------------------------------------------------------------------------------------------
------------------------------------------------------------------------------------------------------------------------------------------------------------------------------------------------
--------------------------------------------------------------------------------S---------------------------------------------------------------------------------------------------------------
------------------------------------------------------------------------------------------------------------------------------------------------------------------------------------------------
--------%%%%%%%%----------------------------------------------------------------SS------------------------------SS----------QQ-o--------------------------------SS%-----------------------------
---------||||||-----S-------------------------------------------------------------------------------------------------------------------------------------------S-|-oo------------------oo------
---------||||||---SSS-#---------------------------------------------------------------------------------SS--------------------------------------------------------|-----------------------------
---------||||||------###--------------------------o------SSS---------------------------------------------SSS---------------------------------------------SS-------|----------------------S------
------%%%%%%%%%%----####-------#------------------------------#--------------#--------------------------------#-----------QQQQ------------------------------------|------TT---------------------
-------||||||||----#####-------#-------------#---------TT-----#-----K-------##--------tt---------K-----TT-----#-----------------------------TT------tt------------|------TT---------tt----------
-------||||||||---######-------#------------###--------TT-----#------------###----TT--tt---------------TT-----#-----------------------------TT------tt-TT--------TTT-----TT---------tt----------
-------||||||||--#######-------#---g-g------###---K----TT---kk#---k-------####----TT--tt-------g--K----TT---kk#-----y--------ggg------------TT------tt-TT--------TTT--g-kTT----gg---tt----------
XXXXXXXXXXXXXXXXXXXXXXXXXXXXXXXXXXXXXXXXXXXXXXXXXXXXXX-XXXXXXXXXXXXXXXXXXXXXXXXXXXXXXXXXXXXXXXXXXXXXXXXXXXXXXXXXXXXXXXXXXXXXXXXXXXXXXXXXXXXXXXXXXXXXXXXXXXXXXXXXXXXXXXXXXXXXXXXXXXXXXXXXXXXXXXXX
XXXXXXXXXXXXXXXXXXXXXXXXXXXXXXXXXXXXXXXXXXXXXXXXXXXXXXXXXXXXXXXXXXXXXXXXXXXXXXXXXXXXXXXXXXXXXXXXXXXXXXXXXXXXXXXXXXXXXXXXXXXXXXXXXXXXXXXXXXXXXXXXXXXXXXXXXXXXXXXXXXXXXXXXXXXXXXXXXXXXXXXXXXXXXXXX
