------------------------------------------------------------------------------------------------------------------------------------------------------------------------------------------------
------------------------------------------------------------------------------------------------------------------------------------------------------------------------------------------------
------------------------------------------------------------------------------------------------------------------------------------------------------------------------------------------------
-------------------------------------------------------------------------------------------------------------------------------------------------------------------------------------#----------
-------------------------------------------------------------------------------------------------------------------k---------------------------------------------------------------g------------
--------------------------------------------------------------------------------------------------##--------------##--------------------------------------------------------------##------------
--------%%%%%%%%----------------------------------------S-----------------------SS-----------------------------------------------------SSSS---------------------------S-------------------------
---------||||||----------------y----------o-----------------------------------------------------------------------------ooo------------------------------ooo------------------------------------
---------||||||---------------##----------------------------------------------------------------------------------------------------------------------------------------------------------------
---------||||||--------------2##-------------------------------------------------------------------------SS-------------------------------------------------------------------------------------
------%%%%%%%%%%------------####----------------------------------------------------------------------------------S-----------TT---@---------Q----------------T---------------------------------
-------||||||||------------#####--------------TT------------------------------TT---------TT-----------------------------------TT-----------------------TT-----TT--------------------tt-TT--tt---
-------||||||||-----------######--------------TT------------TT----------------TT---------TT------------TT---------------------TT------B----------------TT-----TT--------------------tt-TT--tt---
-------||||||||----------#######----y---------TT-------ggg--TT---------gg-----TT------g--TT----g-------TT---------------------TT---gg-b--------g--k----TT-----TT---ggg-g--------g---tt-TT--tt---
XXXXXXXXXXXXXXXXXXXXXXXXXXXXXXXXXXXXXXXXXXXXXXXXXXXXXXXXXXXXXXXXXXXXXXXXXXXXXXXXXXXXXXXXXXXXXXXXXXXXXXXXXXXXXXXXXXXXXXXXXXXXXXXXXXXXXXXXXXXXXXXXXXXXXXXXXXXXXXXXXXXXXXXXXXXXXXXXXXXXXXXXXXXXXXXX
XXXXXXXXXXXXXXXXXXXXXXXXXXXXXXXXXXXXXXXXXXXXXXXXXXXXXXXXXXXXXXXXXXXXXXXXXXXXXXXXXXXXXXXXXXXXXXXXXXXXXXXXXXXXXXXXXXXXXXXXXXXXXXXXXXXXXXXXXXXXXXXXXXXXXXXXXXXXXXXXXXXXXXXXXXXXXXXXXXXXXXXXXXXXXXXX
