------------------------------------------------------------------------------------------------------------------------------------------------------------------------------------------------
------------------------------------------------------------------------------------------------------------------------------------------------------------------------------------------------
------------------------------------------------------------------------------------------------------------------------------------------------------------------------------------------------
----------------SSSSS-----------SSSSSSSSSS----------------------SSSS------------SSSSSSSS-----------------------------------------SSS------------SSSSSSSSSSSSSSSS--------------------------------
------------------------------------------------------------------------------------------------------------------------------------------------SS---S------------------------------------------
------------------------------------------------------------------------------------------------------------------------------------------------------------------------------------------------
--------%%%%%%%%-----------------------------------------------S--------------------------------oooo--SSoo---SoS----Q----------S-------------------------------SSooo----------oo----------------
---------||||||------------------------------------------------------------------------------------------------------------------------------------------------------------------#--------------
---------||||||--------------------------------------------------------------------------------------------------------------oo-----------------S-----------------------------------------------
---------||||||---------------------------S-----------------------------------------------------------------------------------------------------S---------------o-------------------------------
------%%%%%%%%%%---------------------------------------------U----------------------------------S---QS--------S---Q--------SS@S---------------------------------#---Q---------------------------
-------||||||||-----------------------tt-------------------------------TT----------------------------------------------------------------TT-----------------------------------------------------
-------||||||||-----------------------tt-----TT------------------------tt-----TT--------------TT---------#-------------------------------TT----------------------------------------------TT-----
-------||||||||--------k-----k--------tt-----TT---gggg------k-----y----tt-----TT-%-----k------TT-----kg-##--------ggggg---k-k--------k-k-TT---##--------------g----k--gggok-------ggggg--TT-----
XXXXXXXXXXXXXXXXXXXXXXXXXXXXXXXXXXXXXXXXXXXXXXXXXXXXXXXXXXXXXXXXXXXXXXXXXXXXXXXXXXXXXXXXXXXXXXXXXXXXXXXXXXXXXXXXXXXXXXXXXXXXXXXXXXXXXXXXXXXXX-XXXXXXXXXXXXXXXXXXXXXXXXXXXXXXXXXXXXXXXXXXXXXXXXXX
XXXXXXXXXXXXXXXXXXXXXXXXXXXXXXXXXXXXXXXXXXXXXXXXXXXXXXXXXXXXXXXXXXXXXXXXXXXXXXXXXXXXXXXXXXXXXXXXXXXXXXXXXXXXXXXXXXXXXXXXXXXXXXXXXXXXXXXXXXXXXXXXXXXXXXXXXXXXXXXXXXXXXXXXXXXXXXXXXXXXXXXXXXXXXXXX
