--------------------------------------------------------------------------------------------------------------------------------------------------------------------------------
--------------------------------------------------------------------------------------------------------------------------------------------------------------------------------
--------------------------------------------------------------------------------------------------------------------------------------------------------------------------------
--------------------------------------------------------------------------------------------------------------------------------------------------------------------------------
---------------------------------------------------------------------------------------------------------------------------------------------------k----------------------------
--##--------------------------------------o----U--------------------------------------------------------------------------------------------------##----------------------------
----------------------o------------SSSS--S------%%--------S---SS------o------------------S-------------SS-----------------------------------------------------------------------
---------ooo------------------------------------||--------------%-%-%%%-----------------------------------------------------------------------------------oo------%%%-----------
------------------------------------------------||--------------|-|--|----U----------------------------------------------------------------------------------------|------------
-----------------------------------oooo------#--||--------------|-|--|----------------------y----------------------------------------------------------------------|------------
-------TT-------Q-SS---SU---------SSSSSo----##--||---------Q----|-|--|----------------------##------------------------SSU----------------------Q-------------------|--------TT--
-------TT-------------------TT-------------###--||TT------------|-|--|------TT--------------##--------------##--------------##----TT------------------------------TT--------TT--
-------TT-------------------T-------------####--||TT------------|-|--|------TT--------B---####--------------##--------------##---TTT-------------------TT---------TT--------TT--
-------TT---------------y---T-----kg-----#####--||TT-----------g|-|--g--y---TT--------b---#-##---ggg----y-####---------gg-####---TTT--g-------gg-gg----TT---------TT----gg--TT--
XXXXXXXXXXXXXXXXXXXXXXXXXXXXXXXXXXXXXXXXXXXXXXXXXXXXXXXXXXXXXXXXXXXXXXXXXXXXXXXXXXXXXXXXXXXXXXXXXXXXXXXXXXXXXXXX-XXXXXXXXXXXXXXXXXXXXXXXXXXXXXXXXXXXXXXXXXXXXXXXXXXXXXXXXXXXXXXX
XXXXXXXXXXXXXXXXXXXXXXXXXXXXXXXXXXXXXXXXXXXXXXXXXXXXXXXXXXXXXXXXXXXXXXXXXXXXXXXXXXXXXXXXXXXXXXXXXXXXXXXXXXXXXXXXXXXXXXXXXXXXXXXXXXXXXXXXXXXXXXXXXXXXXXXXXXXXXXXXXXXXXXXXXXXXXXXX
