------------------------------------------------------------------------------------------------------------------------------------------------------------------------------------------------
------------------------------------------------------------------------------------------------------------------------------------------------------------------------------------------------
------------------------------------------------------------------------------------------------------------------------------------------------------------------------------------------------
------------------------------------------------SSSSSSSS--------SSSSSSSS--S----S-----------------------------------S---S--------SSSSSSSSSSSS---------------------------------------SSSSS--------
------------------------------------------------S-----------------------------------------------------------------------------------------------------------------------------------------------
------------------------------------------------------------------------------------------------------------------------------------------------------------------------------------------------
--------%%%%%%%%---------------o-------So------o-------------------------------------QQQQSSSSSS------------------o-------------o-oo------------S------------------------------------------------
---------||||||--------------------------------------------------#------------------------------------------------------------------------------------------------------------------------------
---------||||||------------------------------ooo----------------------------------------------------------------------------#-------------------------------------------------------------------
---------||||||--o--------------------------------------------------------#####--------g-----------------------------------##---o-----------------------------#--------------#------------------
------%%%%%%%%%%-SQ----------U--------------SSS-------------------------TT#####-Q----SSQQQ---o----------------------------####-----------------------2--------#-------------###-----------------
-------||||||||--------------#---------------------------------------U--TT####-------------------------------------------####---------------------------------##------------###-----------------
-------||||||||--------------#------tt----------------tt-----TT---------TT#####------------------------------#----------#####---------------------B-----TT---###-----------####------tt---K-----
-------||||||||---gy---k---###------tt---------g------tt-----TT--------########---oy-----------#g------k-----##------k-######-#------g----k-k-----b-----TT---###-----k----####-------tt-------y-
XXXXXXXXXXXXXXXXXXXXXXXXXXXXXXXXXXXXXXXXXXXXXXXXXXXXXXXXXXXXXXXXXXXXXXXXXXXXXXX-XXXXXXXXXXXXXXXXXXXXXXXXXXXXXXXXXXXXXXXXXXXXXXXXXXXXXXXXXXXXXXXXXXXXXXXXXXXXXXXXXXXXXXXXXXXXXXXXXXXXXXXXXXXXXXXX
XXXXXXXXXXXXXXXXXXXXXXXXXXXXXXXXXXXXXXXXXXXXXXXXXXXXXXXXXXXXXXXXXXXXXXXXXXXXXXX-XXXXXXXXXXXXXXXXXXXXXXXXXXXXXXXXXXXXXXXXXXXXXXXXXXXXXXXXXXXXXXXXXXXXXXXXXXXXXXXXXXXXXXXXXXXXXXXXXXXXXXXXXXXXXXXX
