------------------------------------------------------------------------------------------------------------------------------------------------------------------------------------------------
------------------------------------------------------------------------------------------------------------------------------------------------------------------------------------------------
------------------------------------------------------------------------------------------------------------------------------------------------------------------------------------------------
-----------------------------------------------------------------------------------SSSSS--------SSSSSSS-------------------------SSSSSSSSSSSSSSSSSSSSSSS-----------------------------------------
------------------------------------------------------------------------------------------------------------------------------------------------------------------------------------------------
---------------------------------------------ooo------------------------------------------------------------------------------------------------------------------------------------------------
--------%%%%%%%%-----------------------------------------------------------------oo------o--------------------------QQQQQ-----SS------------------------------------------------------SQo------S
---------||||||---------------------------------------------------------------------------------------------------------------------------------------------------------------------------------
---------||||||---------------------------------------------------------------------------------S-------------------------------------------------------------------o---------------------------
---------||||||--------k-------------------------------------------------------------------------------------------------------------------##---------------------------------------------------
------%%%%%%%%%%-------#------------------------------------###----------TT---------------#---------------------###----#Q----#------------###------------------------2--------------------------
-------||||||||----------------------------------------t---####----------TT--------------##-----------tt--------#------------#-----------####--------t------------------------------------------
-------||||||||---------------------------------------tt---####----------TT----------t--###-----------tt---------------------#-------B---####-------tt---##-------------TT----T-----------------
-------||||||||---#g------------------------k---------tt---####---k--k---TT---##----tt--###-----------tt-----ggg#-----------k#-------b--#####-#-----tt---##---k-g-g----kTT---##----k-k------k#--
XXXXXXXXXXXXXXXXXXXXXXXXXXXXXXXXXXXXXXXXXXXXXXXXXXXXXXXXXXXXXXXXXXXXXXXXXXXXXXXXXXXXXXXXXXXXXXXXXXXXXXXXXXXXXXXXXXXXXXXXXXXXXXXXXXXXXXXXXXXXXXXXXXXXXXXXXXXXXXXXXXXXXXXXXXXXXXXXXXXXXXXXXXXXXXXX
XXXXXXXXXXXXXXXXXXXXXXXXXXXXXXXXXXXXXXXXXXXXXXXXXXXXXXXXXXXXXXXXXXXXXXXXXXXXXXXXXXXXXXXXXXXXXXXXXXXXXXXXXXXXXXXXXXXXXXXXXXXXXXXXXXXXXXXXXXXXXXXXXXXXXXXXXXXXXXXXXXXXXXXXXXXXXXXXXXXXXXXXXXXXXXXX
