-------------------------S----------------------------------------------------------------------------------------------------------------------------------------------------------------------
-------------------------S----------------------------------------------------------------------------------------------------------------------------------------------------------------------
------------------------------------------------------------------------------------------------------------------------------------------------------------------------------------------------
---------------------------------------------------------------------------------------------------------------------------------SSSSS-------------------------------------------SSSSSS---------
------------------------------------------------------------------------------------------------------------------------------------------------------------------------------------------------
------------------------------------------------------------------------------------------------------------------------------------------------------------------------------------------------
--------%%%%%%%%-----SSS-----S-----------------o------------------o------------o--------S------------QQQQ----------------------------------------------SS----------------------S----------------
---------||||||--------------------------------------%%-----------------------------------------------------------------------------------------S-----------------------------------------------
---------||||||--------------------------------------||--------------------------------------------------------------------#--------------------------------------------------------------------
---------||||||-----------SS---S---------------------||--------------------------------------------------------------------#--------------------------------------------------------------------
------%%%%%%%%%%-SSoS----------S---------#-----------||------------------TT-----------tt---------------------o------------###-------------#-#-------------------------------##k--------------o--
-------||||||||---------#---------------##-----------|tt-----------------TT-----------tt---------------------------------####-------------#------------2------------------#-#-------------------
-------||||||||--------##-------------####---#-------|tt-----------------TT-----------tt-----#--------------------------#####------------##------------------#------------#---#------B--TT---TT-
-------||||||||-------###------------#####---##------|tt-----kgg--kk-k--###-----g-----tt-----yg---g----k----k-----k----#####k------------##------------k-----g-#--ggggg---#---#---b--b--TT---TT-
XXXXXXXXXXXXXXXXXXXXXXXXXX--XXXXXXXXXXXXXXXXXXXXXXXXXXXXXXXXXXXXXXXXXXXXXXXXXXXXXXXXXXXXXXXXXXXXXXXXXXXXXXXXXXXXXXXXXXXXXXXXXXXXXXXXXXXXXXXXXXXXXXXXXXXXXXXXXXXXXXXXXXXXXXXXXXXXXXXXXXXXXXXXXXXX
XXXXXXXXXXXXXXXXXXXXXXXXXX--XXXXXXXXXXXXXXXXXXXXXXXXXXXXXXXXXXXXXXXXXXXXXXXXXXXXXXXXXXXXXXXXXXXXXXXXXXXXXXXXXXXXXXXXXXXXXXXXXXXXXXXXXXXXXXXXXXXXXXXXXXXXXXXXXXXXXXXXXXXXXXXXXXX-XXXXXXXXXXXXXXXX
