------------------------------------------------------------------------------------------------------------------------------------------------------------------------------------------------
------------------------------------------------------------------------------------------------------------------------------------------------------------------------------------------------
------------------------------------------------------------------------------------------------------------------------------------------------------------------------------------------------
------------------------------------------------------------------------------------------------------------------------------------------------SSSSSSSSSSSSSS-S--------------------------------
------------------------------------------------------------------------------------------------------------------------------------------------------------------------------------------------
-----------------------------------------------------------------------------------------------------------------------------------------------------------------------------------------------o
--------%%%%%%%%-------------------------------------QQQQ-----------QSQSSSSSSSSS--o--------------------SS--------------------------------------U----------------------SSSS----o-----------------
---------||||||------------------------------------------------------------------------------------%%%----------S-----------------------------------------------------%---------S---------------
---------||||||------TT--------------------------------------------------------------------#--------|-----------S----------------------------oo-----------------------|---------S---------------
---------||||||------TT-------------------------------------------------------------------##--------|-----------------------------------------------------------------|-------------------------
------%%%%%%%%%%-----##--------------------------##----#-------------QQQQS--SUSS---------TT---------|---------------------------------------SSS-----------------------|QQ----Q------------------
-------||||||||-TT------------------------------###--------------------------------------TT---------|ttt---------------------------------TT---------------------------|------------------TT-----
-------||||||||-TT-------TT----------S----------####-------------------------------------##---------|ttt---------------------------------TT---------tt---B---------#--|------------------TT-----
-------||||||||-TT-------TT---------------------####--------k------k--------k-------ggg-###-----#---|ttt---k-g-gg------g----gggg--gggg---TT---------tt---b----g---##--|-----------gy-----TT----g
XXXXXXXXXXXXXXXXXXX-XXXXXXXXXXXXXXXXXXXXXXXXXXXXXXXXXXXXXXXXXXXXXXXXXXXXXXXXXXXXXXXXXXXXXXXXXXXXXXXXXXXXXXXXXXXXXXXXXXXXXXXXXXXXXXXXXXXXXXXXXXXXXXXXXXXXXXXXXXXXXXXXXXXXXXXXXXXXXXXXXXXXXXXXXXXX
XXXXXXXXXXXXXXXXXXX-XXXXXXXXXXXXXXXXXXXXXXXXXXXXXXXXXXXXXXXXXXXXXXXXXXXXXXXXXXXXXXXXXXXXXXXXXXXXXXXXXXXXXXXXXXXXXXXXXXXXXXXXXXXXXXXXXXXXXXXXXXXXXXXXXXXXXXXXXXXXXXXXXXXXXXXXXXXXXXXXXXXXXXXXXXXX
