------------------------------------------------------------------------------------------------------------------------------------------------------------------------------------------------
------------------------------------------------------------------------------------------------------------------------------------------------------------------------------------------------
------------------------------------------------------------------------------------------------------------------------------------------------------------------------------------------------
--------------------------------------------------------------------------------SSSSSSSSS------------------------S--------------------------------------------------------------SSSSSSSSSSS----S
------------------------------------------------------------------------------------------------------------------------------------------------------------------------------------------------
-----------------------S------------------ooooo----------------------------------------------------------------o--------------------------------------------------------------------------------
--------%%%%%%%%------------------------------------------------------------------------------------S-S--------S----------------------Qoo------S------------------oo-----------o----------------
---------||||||------------oo----#----------Kooo------------------------------------------------------------------------------------------------S-----------------------------------------------
---------||||||------------------#--------------------------------------------------------------------------------------------------------------SS--TT------------------------------------------
---------||||||----------ooo----TT------------o-----------------------------------------------------------------------------------------------------TT------------------------------------------
------%%%%%%%%%%-Uoo------------TT---2--------t--#-----------------------------------------------------------US-------------------------------------##--------------#---------------------------
-------||||||||---------------ooTT---U-TT----TT--#-----tt------------------------------------------------------------------------------------#----------------------------------o-----tt--------
-------||||||||-----------------TT-----TT----TT--#-----tt-------------------------------------------------------------tt--------------tt-----#---------B-----------------TT-----------tt--------
-------||||||||-----------------TT-----TT----TT--#-----tt----k----gk---------kgg------------ggg---gggg----k-------g---tt------g-------tt-----#--g-g----b----g###---kgggg-TT-----%-----tt-y----gg
XXXXXXXXXXXXXXXX--XXXXXXX-------XXXXXXXXXXXXXXXXXXXXXXXXXXXXXXXXXXXXXXXXXXXXXXXXXXXXXXXXXXXXXXXXXXXXXXXXXXXXXXXXXXXXXXXXXXXXXXXXXXXXXXXXXXXXXXXXXXXXXXXXXXXXXXXXXXXXXXXXXXXXXXXXXXXXXXXXXXXXXXXX
XXXXXXXXXXXXXXXX--XXXXXXX-------XXXXXXXXXXXXXXXXXXXXXXXXXXXXXXXXXXXXXXXXXXXXXXXXXXXXXXXXXXXXXXXXXXXXXXXXXXXXXXXXXXXXXXXXXXXXXXXXXXXXXXXXXXXXXXXXXXXXXXXXXXXXXXXXXXXXXXXXXXXXXXXXXXXXXXXXXXXXXXXX
