------------------------------------------------------------------------------------------------------------------------------------------------------------------------------------------------
------------------------------------------------------------------------------------------------------------------------------------------------------------------------------------------------
------------------------------------------------------------------------------------------------------------------------------------------------------------------------------------------------
------------------------------------------------------------------------------------------------------------------------------------------------------------------------------------------------
----------------------------------------------------------------S-------------------------------------------------------------------------------------------------------------------------------
------------------------------------------------------------------------------------------------------------------------------------------------------------------------------------------------
--------%%%%%%%%---SSSS---SSS-@--------------------------------oS------------------------------oSS----------------------------------------------------------------------------------------------
---------||||||---------------------------o---------------------------------------------------------o---------------------o---------oo-----------------------------SS---------------------------
---------||||||---------------------------------------------------------------------------------------------------------------------------------------------------------------------------------
---------||||||---------------------------------------------------------------------------------------------------------------------------------------------------------------------------------
------%%%%%%%%%%---SSS---------S---------------------------------TTT---------Q----------------QQ----------------------------------------------------------------------------------TT------------
-------||||||||------------------------TT--------------TT--------TTT------------------------------------------------------------------------------TT---------------------TT----T--TT------------
-------||||||||------------------------TT--B-----------TT--------TTTT------------------------------------TT------------TT--------TT---------------TT------------#---#----TT----T--TT-------B----
-------||||||||----k---k---------------TT--b-----------TT--------TTTT--------gg-----y---------g---T------TT---gg--gg---TT--------TT---g--T----gg--T--------gggg-#---#-#--TT----T--TT-------b--g-
XXXXXXXXXXXXXXXXX--XXXXXXXXXXX-XXXXXXXXXXXXXXXXXXXXXXXXXXXXXXXXXXXXXXXXXXXXXXXXXXXXXXXXXXXXXXXXXXXXXXXXXXXXXXXXXXXXXXXXXXXXXXXXXXXXXXXXXXXXXXXXXXXXXXXXXXXXXXXXXXXXXXXXXXXXXXXXXXXXXXXXXXXXXXXXX
XXXXXXXXXXXXXXXXX--XXXXXXXXXXX-XXXXXXXXXXXXXXXXXXXXXXXXXXXXXXXXXXXXXXXXXXXXXXXXXXXXXXXXXXXXXXXXXXXXXXXXXXXXXXXXXXXXXXXXXXXXXXXXXXXXXXXXXXXXXXXXXXXXXXXXXXXXXXXXXXXXXXXXXXXXXXXXXXXXXXXXXXXXXXXXX
