------------------------------------------------------------------------------------------------------------------------------------------------------------------------------------------------
------------------------------------------------------------------------------------------------------------------------------------------------------------------------------------------------
------------------------------------------------------------------------------------------------------------------------------------------------------------------------------------------------
---------------------------------------------------S-SS-------------------------SSSSSSSS-----------SSS----------SSSSSSSSSSS----------------------SSSSS--------------------------SSSSSSSSSS------
-------------------------------------------------------------------------------------------------------------------------------------------------------------------------------o----------------
------------------------------------------------------------------------------------------------------------------------------------------------------------------------------------------------
--------%%%%%%%%-------SS-------------SSSS-----o-oo---------------------------------------------ooo----SSo-----S-------------------------------------------------o----SSoS-----S--------------So
---------||||||---------------------------------------------------------------------------------------------------------------------------------------------------------------------------------
---------||||||---------------------------------------------------------------------------------------------------------------------------------------------------------------------------------
---------||||||-----------------oo--------------------------------------------------------------------------------------------------------------------------------------------------------------
------%%%%%%%%%%-------------S----------------------------#----------#-------o--------tt----------------------------------#--------------------------------------------------o-----SSo----------
-------||||||||-------------------------------------------#---------------------------tt-------------tt------------------##---------------#---------------#-------------------------------#-----
-------||||||||------------------------------------------##---------------------------tt-------------tt---------------K-###--------------##--------------##------------------------------##-----
-------||||||||----gggk-----------gggg---------g-----g--###-------g-----------k-------tt-----gg------tt-----k---------g####---##--kg-----##----------g---##---------g-------kk--------gg###-----
XXXXXXXXXXXXXXXXXXXXXXXXXXXXXXXXXXXXXXXXXXXXXXXXXXXXXXXXXXXXXXXXXXXXXXXXXXXXXXXXXXXXXXXXXXXXXXXXXXXXXXXXXXXXXXXXXXXXXXXXXXXXXXXXXXXXXXXXXXXXXXXXXXXXXXXXXXXXXXXXXXXXXXXXXXXXXXXXXXXXXXXXXXXXXXXX
XXXXXXXXXXXXXXXXXXXXXXXXXXXXXXXXXXXXXXXXXXXXXXXXXXXXXXXXXXXXXXXXXXXXXXXXXXXXXXXXXXXXXXXXXXXXXXXXXXXXXXXXXXXXXXXXXXXXXXXXXXXXXXXXXXXXXXXXXXXXXXXXXXXXXXXXXXXXXXXXXXXXXXXXXXXXXXXXXXXXXXXXXXXXXXXX
