-------------------------------------------------%-----------------------%%--------------------------------------%%----%%%%----------------------%---------------%--------------
-------------------------------------------------|-----------------------||--------------------------------------||-----||-----------------------|---------------|--------------
-------------------------------------------------|-----------------------||--------------------------------------||-----||-----------------------|---------------|--------------
-------------------------------------------------|-----------------------||--------------------------------------||-----||-----------------------|---------------|--------------
-------------------------------------------------|-----------------------||--------------------------------------||-----||-----------------------|---------------|--------------
------------------------------o------------------|-----------------------||--------------------------------------||-----||-----------------------|---------------|--------------
-------------------------------------------------|----r------------------||-----------r--------o------U--------o-||-----||------------r----------|----r----------|-------------o
-------------------%----------------------------%|%%%%%%%-------%%%%%%%--||-----%%%%%%%%-----------%%%%----------||%%%%%%|------%%%%%%%%%-------%%%%%%%%%--------|--------oo----
-------S-----------|----------------------------||-|||||---------|||||---||------||||||-------------||-----------||-||||-|-------|||||||---------|||||||---------|--------------
ooo---SSSooo---#---|------------S---------------||-|||||---------|||||---||------||||||-------------||-----------||-||||-|-------|||||||---------|||||||---------|--------------
%%%%%%%%------#----|--------------TT--Q---------QQ-|||||U--------|||||---||------|||||QQQQQQ--------||-----------||-||Q|-|-------|||||||---------|||||||---------|--------------
-||||||------##---T|--------TT---TTT---------------|||||---------|TT||---TT------|TT||--------------||-----------||-||-|-|-------|TT||||----TT---|TT||||----TT---|--------------
-||||||-----###---TT--------TT---TTT---------------|||||----TT---|TT||---TT------|TT||--------------||-----------||-||-|-|-------|TT||||----TT---|TT||||----TT---|--------------
-||||||----####---TT---g----TT-k-TTTT----------k---||||ggg--TT-k-|TT||g--TT----g-|TT||---gg---g-----||---------g-||-||-|-|-------|TT|||g----TT-k-|TT|||g----TT-k-|--y-----k-----
%|%%%%|---XXXXXX-XXXXXXXXXXXXXXXXXXXXXXXXXXXXXXXXXXXXXXXXXXXXXXXXXXXXXXXXXXXXXXXXXXXXXXXXXXXXXXXXXXXXXXXXXXXXXXXXXXXXXXXXXXXXXXXXXXXXXXXXXXXXXXXXXXXXXXXXXXXXXXXXXXXXXXXXXXXXXXX
g|-||-|---XXXXUXXXXXXXXXXXXXXXXXXXXXXXXXXXXXXXXXXXXXXXXXXXXXXXXXXXXXXXXXXXXXXXXXXXXXXXXXXXXXXXXXXXXXXXXXXXXXXXXXXXXXXXXXXXXXXXXXXXXXXXXXXXXXXXXXXXXXXXXXXXXXXXXXXXXXXXXXXXXXXXXX
