------------------------------------------------------------------------------------------------------------------------------------------------------------------------------------------------
------------------------------------------------------------------------------------------------------------------------------------------------------------------------------------------------
------------------------------------------------------------------------------------------------------------------------------------------------------------------------------------------------
----------------------------------------------------------------------------------------------------------------SSSSSSSSSSS-----------------------S-------------SSSSSSSSS-------SSSSSSSSSSS-----
------------------------------------------------------------------------------------------------------------------------------------------------------------------------------------------------
------------------------------------------------------------------------------------------------------------------------------------------------------------------------------------------------
--------%%%%%%%%-------------------------------o----------------------SSS--------ooo--Sooo----SS---------------------------------oooQQQQoS---SSS---------------------------------o--------------
---------||||||-----------------------------------------------------%%%-------------------------------------------------------------------------------------------------------------------------
---------||||||------------------------------------------------------|--------------------------------------------------------------------------------------------------------------------------
---------||||||------------------------------------------------------|----------------------------------------------------------o---------------------------------------------------------------
------%%%%%%%%%%---------TT------------------S-----------------------|-----#-------------------------2----------------------------Q-QQ--------S-----------##----------------#--------tt---------
-------||||||||----------TT--------------TT--------------------------|---###-----------------------------TT-----------------------------------------------###-------------#-#--------tt---------
-------||||||||----------TT--------------TT-------------TT-----------|--####-----------------------------TT----------tt---------------------------------#-###-------------##---------tt---------
-------||||||||----ggg---TT--------k-k---TT-------y-----TT---g-g-----|######----------###---k-----ggg----TT----------tt--------------kkg--k-k---g-------#-###-----kk-g-g-###k--------tt--k----g-
XXXXXXXXXXXXXXXXXXXXXXXXXXXXXXXXXXXXXXXXXXXXXXXXXXXXXXXXXXXXXXXXXXXXXXXXXXXXXXXXXXXXXXXXXXXXXXXXXXXXXXXXXXXXXXXXXXXXXXXXXXXXXXXXXXXXXXXXXXXXXXXXXXXXXXXXXXXXXXXXXXXXXXXXXXXXXXXXXXXXXXXXXXXXXXXX
XXXXXXXXXXXXXXXXXXXXXXXXXXXXXXXXXXXXXXXXXXXXXXXXXXXXXXXXXXXXXXXXXXXXXXXXXXXXXXXXXXXXXXXXXXXXXXXXXXXXXXXXXXXXXXXXXXXXXXXXXXXXXXXXXXXXXXXXXXXXXXXXXXXXXXXXXXXXXXXXXXXXXXXXXXXXXXXXXXXXXXXXXXXXXXXX
