------------------------------------------------------------------------------------------------------------------------------------------------------------------------------------------------
------------------------------------------------------------------------------------------------------------------------------------------------------------------------------------------------
------------------------------------------------------------------------------------------------------------------------------------------------------------------------------------------------
----------------SSSSSSSSSSSS--------------------SSSSS-----------SSSSSSSSSSSS-SSS--------------------------------SSSSSSSSSSS--SS-SSSSSSSS-SSS----------------------------------------------------
------------------------------------------------------------------------------------------------------------------------------------------------------------------------------------------------
------------------------------------------------------------------------------------------------------------------------------------------------------------------------------------------------
--------%%%%%%%%-----SS-----------o------------o---------------------------------oo--S----------------------------------------------------------------------------------------------------------
---------||||||------------------------------------------------------------------------------------------------o---------------------------------#-------------#--------------------------------
---------||||||-----------#-------------------S-------------------------------------------------------------------------------------------------------------------------------------------------
---------||||||-----------------------------------------------------------------------------------------------------------------------------------------------#---------------------------------
------%%%%%%%%%%---------#-------------------o--------tt------------------------Q-QQS--S-----o----------------##---------------------------------------------##---------------------------------
-------||||||||---------##----------------B-----------tt-----TT---------TTT----------------------------------##----------------------tt------------------TT--###-------tt----#-----------TT-----
-------||||||||-------####----------------b-----------tt-----TT---B-----TTT----------------------------2----###------B---------------tt------------------TT--###-------tt----#-----------TT-----
-------||||||||------#####--------kkgg--------k-------tt-----TT---b-----TTT-------gggg------------g---------####--------------##-----tt---#-------kk----###--###g------tt---g##----k-k--###-----
XXXXXXXXXXXXXXXXXXXXXXXXXXXXXXXXXXXXXXXXXXXXXXXXXXXXXXXXXXXXXXXXXXXXXXXXXXXXXXXXXXXXXXXXXXXXXXXXXXXXXXXXXXXXXXXXXXXXXXXXXXXXXXXXXXXXXXXXXXXXXXXXXXXXXXXXXXXXXXXXXXXXXXXXXXXXXXXXXXXXXXXXXXXXXXXX
XXXXXXXXXXXXXXXXXXXXXXXXXXXXXXXXXXXXXXXXXXXXXXXXXXXXXXXXXXXXXXXXXXXXXXXXXXXXXXXXXXXXXXXXXXXXXXXXXXXXXXXXXXXXXXXXXXXXXXXXXXXXXXXXXXXXXXXXXXXXXXXXXXXXXXXXXXXXXXXXXXXXXXXXXXXXXXXXXXXXXXXXXXXXXXXX
