--------------------------------------------------------------------------------------------------------------------------------------------------------------------------------
--------------------------------------------------------------------------------------------------------------------------------------------------------------------------------
----------------------------------------------------------------------------------------------------------------------------------------------------------------t---------------
----------------------------------------------------------------------------------------------------------------------------------------------------------------t---------------
-------------------------------------------------------------------k--------------------------------------------------------------------------------------------t---------------
------------------------------------------------------------------##--------------##---------------------------------------------------------------#------------t---------------
------------------------------------------------------SSSSS-------------------------------------SSSS------------SS----------SS----------------------------------S--------------o
-----%-------------------------------------------------------------------ooo-------------------------------------------------------------SS-------------ooo---------------------
-----|----------------------------------------------------------------------------------------------------------------------------------SS--------------------------------------
-----|-------------------------------------------------------------------SS--------------------------------------------------------------SS-------------------------------------
-----|------------SS-------------------------------------------------------------SS----------------------TT---------------------------------------------------------------------
-----|---TT-----------------------------------TT-----------------------TT--------------------------------TT----TTT-------TT----T----tt--------------------------TT--------------
-----|---TT------------TT---------------------TT------B-------------tt-TT--------------T-----------------TT----TTT----tt-TT----T----tt-TT--tt-------tt----------TT----tt--------
-----|---TT------------TT-k-------------------TT----gyb-------------tt-TT--------------TT-k----------y---TT----TTT----ttkTT----T----tt-TT--tt-------tt----k-----TT----tt--------
X--XXXXX-XX----XXXXXXXXXXXXXXXXXXXXXXXXXXXXXXXXXXXXXXXXXXXXXXXXXXXXXXXXXXXXXXXXXXXXXXXXXXXXXXXXXXXXXXXXXXXXXXXXXXXXXXXXXXXXXXXXXXXXXXXXXXXXXXXXXXXXXXXXXXXXXXXXXXXXXXXXXXXXXXXXX
X---XXXXXXX-----XXXXXXXXXXXXXXXXXXXXXXXXXXXXXXXXXXXXXXXXXXXXXXXXXXXXXXXXXXXXXXXXXXXXXXXXXXXXXXXXXXXXXXXXXXXXXXXXXXXXXXXXXXXXXXXXXXXXXXXXXXXXXXXXXXXXXXXXXXXXXXXXXXXXXXXXXXXXXXXX
