------------------------------------------------------------------------------------------------------------------------------------------------------------------------------------------------
------------------------------------------------------------------------------------------------------------------------------------------------------------------------------------------------
------------------------------------------------------------------------------------------------------------------------------------------------------------------------------------------------
----------------SSSSSSSSSS-----SSSSSSSSSSSSSS-----------------------------------SSSSSSSSSSSS----------------------------------------------------SSSSSSSSSSSSSSSS--------------------------------
----------------SS------------------------------------------------------------------------------------------------------------------------------------------------------------------------------
-----------------S------------------------------------------------------------------------------------------------------------------------------------------------------------------------------
--------%%%%%%%%---------------S----------------SoooSSSSSSS-SSSS-----SS-------------------------ooo----ooo----oS---S@SSS------S---------------------------------SSoSSSSSS----SSS----------------
---------||||||---------------------------------------------------------------------------------------------------------------------------------------------------------------------------------
---------||||||------------SS-------------------------------------------------------------------------------------------------------------------------------------------------------------------
---------||||||-----------------------------------------------------------------------------------------------------------------------------------------SS--------------------------------------
------%%%%%%%%%%--------------------------------S---QQ-------SSS-------------------------------------------------------------@S---------------------------------S--SSS-------USS-------------U--
-------||||||||------tt-----------------------------------------------------------------------TT-----------------------------------------TT-----------------------------------------------------
-------||||||||------tt-----------------------TT----------------------------------------------TT-----------------------------------------TT---TT-----#---------------------------------TT-------
-------||||||||------tt------ggg------------k-TT-----y-------------ggg-------------------g----TT-----y--k----------kgggg--k-k-k---kg-g---TT---TT-----#--------g-----gg----k-------ggg--TT---k---
XXXXXXXXXXXXXXXXXXXXXXXXXXXXXXXXXXXXXXXXXXXXXXXXXXXXXXXXXXXXXXXXXXXXXXXXXXXXXXXXXXXXXXXXXXXXXXXXXXXXXXXXXXXXXXXXXXXXXXXXXXXXXXXXXXXXXXXXXXXXXXXXXXXXXXXXXXXXXXXXXXXXXXXXXXXXXXXXXXXXXXXXXXXXXXXX
XXXXXXXXXXXXXXXXXXXXXXXXXXXXXXXXXXXXXXXXXXXXXXXXXXXXXXXXXXXXXXXXXXXXXXXXXXXXXXXXXXXXXXXXXXXXXXXXXXXXXXXXXXXXXXXXXXXXXXXXXXXXXXXXXXXXXXXXXXXXXXXXXXXXXXXXXXXXXXXXXXXXXXXXXXXXXXXXXXXXXXXXXXXXXXXX
