------------------------------------------------------------------------------------------------------------------------------------------------------------------------------------------------
------------------------------------------------------------------------------------------------------------------------------------------------------------------------------------------------
------------------------------------------------------------------------------------------------------------------------------------------------------------------------------------------------
----------------SSSS-SSS--------------------------------------------------------SS--------------------------------------------------------------------------------------------------------------
------------------------------------------------------------------------------------------------------------------------------------------------------------------------------------------------
---------------------------------------------------------------------------------------------------------------o--------------oo------------------------oo--------------------------------------
--------%%%%%%%%-------------S----------------------------------------------------SSS--------SSS%%%%S------------------------------------------S---------------------SSS------------------------
---------||||||----------------------------------------------------------------------------------||---------------------------------------------------------------------------------------------
---------||||||---SS-----------------------------------------------------------------------------||---------------------------------------------------------------------------------------------
---------||||||------gg----------------------------------------------------------ooo-------------||--------------------------------------------------------------o------------------------------
------%%%%%%%%%%#--S###------------------------------------------------%%%%%----SSSSS----SSSSSSS-||--2---%%%%%%o--------------o----------------------------------------------o------------------
-------||||||||-#-------------K-----------------------------------------|||----------------------||-------||||----------TT----------------#--------------B--------------------------------------
-------||||||||-#-------------------------##----------------------------|||----------------------||-------||||-T--------TT----------------#-------T-----TT----------------------------t---------
-------||||||||-T---------kkk-----kk-g----#g---g------------------------|||--------g-g------k----ggggg-gT-||||-o-gg----kTT---ggg---gggg--##----k-Tb-----TT-----g--gggg---------g--gg--t--------g
XXXXXXXXXXXXXXXXXXXXXXXXXXXXXXXXXXXXXXXXXXXXXXXX-XXXXXXX-XXXXXXXXXXXXXXXXXXX----XXXXXXXXXXXXXXXXXXXXXXXXXXXXXXXXXXXXXXXXXXXXXXXXXXXXXXXXXXXXXXXXXXXXXXXXXXXXXXXXXXXXXXXXXXXXXXXXXXXXXXXXXXXXXXXX
XXXXXXXXXXXXXXXXXXXXXXXXXXXXXXXXXXXXXXXXXXXXXXXX-XXXXXXX-X-XXXXXXXXXXXXXXXXX----XXXXXXXXXXXXXXXXXXXXXXXXXXXXX-X-XXXXXXXXXXXXXXXXXXXXXXXXXXXXXXXXXXXXXXXXXXXXXXXXXXXXXXXXXXXXXXXXXXXXXXXXXXXXXXXX
