------------------------------------------------------------------------------------------------------------------------------------------------------------------------------------------------
------------------------------------------------------------------------------------------------------------------------------------------------------------------------------------------------
------------------------------------------------------------------------------------------------------------------------------------------------------------------------------------------------
--------------------------------SSS---------------------------------------------SSSSSSSSS---------------------------------------------S----------SSSS---------------------------SSSSSSSSSS------
-------------------------------------------------------------------------------o----------------------------------------------------------------------------------------------------------------
------------------------------------------------------------------------------------------------------------------------------------------------------------------------------------------------
--------%%%%%%%%---------o---------------------------------------oo---S-------------------------ooooSS-oo----SSS-------SS-------ooo------------------------------oo---SSSoS---------------------
---------||||||----------------------------------------------------------------------------------------------------------------------------------o----------------------------------------------
---------||||||---------------------------------------------------------------------------------------------------------------------------------------------------------------------------------
---------||||||--------------------------------------------------o-------------------#----------o--o-----------------------------o-------------------------------oo-----------------------------
------%%%%%%%%%%-----------------------tt------------2-------------------------------2-------------SS--------SS--------------o------------#----------------------------------oS-----------------
-------||||||||------------------------tt----------------TT---------------#--------------------------------------------------------------##-----------------------------------------------------
-------||||||||------tt----------------tt----------------TT--------------##-------------TT----TT-----------------------------------------##--------------TT---TT------------------------------TT
-------||||||||----k-tt-----k-ko-------tt--kkk----kk-k-k-TT---k-----gggg###-----g-g-----TT----TT-----ogg--k---------g-k-----k-k-----gg--###--------------TT---TT---kgy------k-k---g----k------TT
XXXXXXXXXXXXXXXXXXXXXXXXXXXXXXXXXXXXXXXXXXXXXXXXXXXXXXXXXXXXXXXXXXXXXXXXXXXXXXXXXXXXXXXXXXXXXXXXXXXXXXXXXXXXXXXXXXXXXXXXXXXXXXXXXXXXXXXXXXXXXXXXXXXXXXXXXXXXXXXXXXXXXXXXXXXXXXXXXXXXXXXXXXXXXXXX
XXXXXXXXXXXXXXXXXXXXXXXXXXXXXXXXXXXXXXXXXXXXXXXXXXXXXXXXXXXXXXXXXXXXXXXXXXXXXXXXXXXXXXXXXXXXXXXXXXXXXXXXXXXXXXXXXXXXXXXXXXXXXXXXXXXXXXXXXXXXXXXXXXXXXXXXXXXXXXXXXXXXXXXXXXXXXXXXXXXXXXXXXXXXXXXX
