------------------------------------------------------------------------------------------------------------------------------------------------------------------------------------------------
------------------------------------------------------------------------------------------------------------------------------------------------------------------------------------------------
------------------------------------------------------------------------------------------------------------------------------------------------------------------------------------------------
------------------------------------------------SSSSSSSSSS-----S----------------SSSSSSSS------------------------SSSSSSS------SSS------------------------------------------------SSSSSSSSS-------
-----------------------------------------------S------------------------------------------------------------------------------------------------------------------------------------------------
------------------------------------------------------------------------------------------------------------------------------------------------------------------------------------------------
--------%%%%%%%%----------------------------------------------S--------------------------------o---------------S--------------------------------------oSSS---------------------#----------------
---------||||||----------------------------------------------------------------------------------S-------------o---------------------------------------------------------------#----------------
---------||||||------o-------------------------------------------------------------------------------------------------------------------------------------------------------###----------------
---------||||||-------------------------------------------------------------------------------------------------------------------------------------------------------------####----------------
------%%%%%%%%%%-----2---TT------------------o--------t--------------------------------------------------------------2----------------------------------------------------######----------------
-------||||||||----------TT---------------------------tt-----##--------o--------------t---------------------------------TT-----------------------------------------------T######---------B------
-------||||||||-o--------TT--------------------------ttt-#-#-##-------TT-----TT------tt---------------------------B-----TT----TT-----B----------------t-----------------TT######--------TT----T-
-------||||||||-T--------TT-------gggg----k-----------t#-#-#-##---g---Tt-----kT------tt-----k-----g-------------k-b----kTT----TT-----t-k------k-------t-----ggg#--gg----TT######--b-----Tt----TT
XXXXXXXXXXXXXXXXXXXXXXXXXXXXXXXXXXXXXXXXXXXXXXXXXXXXXXXXXXXXXXXXXXXXXXXXXXXXXXXXXXXXXXXXXXXXXXXXXXXXXXXXXXXXXXXXXXXXXXXXXXXXXXXXXXXXXXXXXXXXXXXXXXXXXXXXXXXXXXXXXXXXXXXXXXXXXXX-XXXXXXXXXXXXXXXX
XXXXXXXXXXXXXXXXXXXXXXXXXXXXXXXXXXXXXXXXXXXXXXXXXXXXXXXXXXXXXXXXXXXXXXXXXXXXXXXXXXXXXXXXXXXXXXXXXXXXXXXXXXXXXXXXXXXXXXXXXXXXXXXXXXXXXXXXXXXXXXXXXXXXXXXXXXXXXXXXXXXXXXXXXXXXXXX-XXXXXXXXXXXXXXXX
