------------------------------------------------------------------------------------------------------------------------------------------------------------------------------------------------
------------------------------------------------------------------------------------------------------------------------------------------------------------------------------------------------
------------------------------------------------------------------------------------------------------------------------------------------------------------------------------------------------
----------------SSSSSSS--SSSSSSSSSSS-SSS-SSS--SS------------------------------------------------SSSSSSSSS-----------------------SSSSSSSSSSSSSSSS----------------SSS-----------------------------
--------------------------------------------------------------o-----------------------------------------------------------------S---------------------------------------------------------------
--------------------------------------------------------------------------------------------------------------------------------S---------------------------------------------------------------
--------%%%%%%%%---------------o----------------SSS@SSSSoSS--S@S-----------------------------------------o--------------------------------SS--SS------S--------o-------------------QSS@SSSSSSSSS
---------||||||------------#--##----------------------------------------------------------------------------------------------------------------------------------------------------------------
---------||||||-----------######-----------------------------oo---------------------------------------------------------------------------------------------------------------------------------
---------||||||---------########----------------------------------------------------------------------------------------------------------------------------------------------------------------
------%%%%%%%%%%--------#######-----------------Q-QQQQ------S@S--------------------------------------------------------------o------------------------------------------------------SSQQQ---SSSS
-------||||||||-------#########--------TT------------------------------------------------#---------------------------------------------------------------##-------------------------------------
-------||||||||------##########--------TT------------------------------TT----------------#--------------------------------------------tt-----------------##-----------ttt-----------------------
-------||||||||------##########--------TT--##------k-ggg----k----------TT-------------g-###---#------k---#----g---ggg----------g------tt-----ggg---k-ggg###-------b---ttt----ggg---k--------k---
XXXXXXXXXXXXXXXXXXXXXXXXXXXXXXX-XXXXXXXXXXXXXXXXXXXXXXXXXXXXXXXXXXXXXXXXXXXXXXXXXXXXXXXXXXXXXXXXXXXXXXXXXXXXXXXXXXXXXXXXXXXXXXXXXXXXXXXXXXXXXXXXXXXXXXXXXXXXXXXXXXXXXXXXXXXXXXXXXXXXXXXXXXXXXXXX
XXXXXXXXXXXXXXXXXXXXXXXXXXXRXXX-XXXXXXXXXXXXX-XXXXXXXXXXXXXXXXXXXXXXXXXXXXXXXXXXXXXXXXXXXXXXXXXXXXXXXXXXXXXXXXXXXXXXXXXXXXXXXXXXXXXXXXXXXXXXXXXXXXXXXXXXXXXXXXXXXXXXXXXXXXXXXXXXXXXXXXXXXXXXXXXX
