-------------------------------------------------------K-K--------------------------------------------------------------------------------------------------------------------------------------
------------------------------------------------------------------------------------------------------------------------------------------------------------------------------------------------
--------------------------------------------------------%---------------------------------------------------------------------------------------------------------------------------------------
--------------------------------------------------------|---------------------------------------------------------------------------------------------------------------------------------------
--------------------------------------------------------|---------------------------------------------------------------------------------------------------------------------oo----------------
------------------ooo-----------------------------------|------------------------------------ooo------------oo-o----------------------------------------oo--------------------------------------
--------%%%%%%%%%%%%%%----------------------------------|----------S@S@S-----------------------------------%--------------------------------------------------------QQQQSSS---So----------------
---------||||||--||||-----------------------------------|--------------------------------------------------|-----#------------------------------------------------------------------------------
---------||||||--||||-----------------------------------|--------------------------------------------------|------------------------------------------------------------------o-----------------
---------||||||--||||------------o----------------------|--------------------------------------------------|------o----------------------------o---------o----------------------------------#---
------%%%%%%%%%%%||||----%%------SS------%%%------------|-------QSQQ---SSSSS-US-SSS----%%%%%%%%%-SS----S%SSSSooo-----2------------------------------------------Q------------oS-----------####--
-------||||||||-|||||----||---------------|-------------|-------------------------------|||||||---------|----------------TT--------------------------------------------------------------####---
-------||||||||-|||||----||------------TT-|-------------|-------------------------------|||||||---------|---------B------TT---B-------------------B-----tt-------------------------------####---
-------||||||||-|||||----||-------gg-g-TT-|-k----------g|-----oo------------------or----|||||||---oy-k--|---k-ko-ob----k-TT---bg---k----k-#-------b-----tt---g----ggggg-----------kk----#####---
XXXXXXXXXXXXXXXX|||||--X-XXX%%--XXXXXXXXXXXXXXXX%%%XXXXXXXXX%%%%-XXXXXXXXXXXXXXX%%%%%XXXXXXXX||X%%%XXXXXXXXXXXX-XXXXXXXXXXXXXXXXXXXXXXXXXXXXXXXXXXXXXXXXXXXXXXXXXXXXXXXXXXXXXXXXXXXXXXXXXXXXXXX-
XXXXXXXXXXXXXXXX|||||--X-XXX||--XXXXXXXXXXXXXXXX-|--XXXXXXXX-||--XXXXXXXXXXXXXXXXXX|-XXXXXXXX|X--XXXXXXXXXXXX-X-XXXXXXXXXXXXXXXXXXXXXXXXXXXXXXXXXXXXXXXXXXXXXXXXXXXXXXXXXXXXXXXXXXXXXXXXXXXXXXX-
