------------------------------------------------------------------------------------------------------------------------------------------------------------------------------------------------
------------------------------------------------------------------------------------------------------------------------------------------------------------------------------------------------
------------------------------------------------------------------------------------------------------------------------------------------------------------------------------------------------
------------------------------------------------------------------------------------------------------------------------------------------------------------------------------------------------
------------------------------------------------------------------------------------------------------------------------------------------------------------------------------------------------
----------------------------------------------------------------------------------------------------------------------------------##------------------------------------------------------------
--------%%%%%%%%----------------------------------------------------------------SSS------S-----S--------Q------S--------------------------------------------------------------------------------
---------||||||-----------o--------------------------------------------------------------------------------------------------------------oo-------------------------------------------%---------
---------||||||-----------------------------------------------------------------------------------------------------------------------------------------------------------------------|---------
---------||||||-----------------------------------------------------------------------------------------------------------------------------------------------------------------------|---------
------%%%%%%%%%%----------------------------------------------------------------------------Q-------------QQ------------------------------------------------------TT--------------TT--|---------
-------||||||||--------T-------------------------------TT----------------------------------------------------------------------------t-TT-------------------------TT--------------TT--|--TT-----
-------||||||||--------TT---------------------------tt-TT--B--------------------------B---------------tt----------------------------tt-TT-------------------------TT-------------TTT--|--TT-----
-------||||||||--k-----TT-----------------ggg-g-K---tt-TT--b--------------------------b--------g------tt------gg-------------gggg---tt-TT-------------------T-----TT---------ggg-TTT--|k-TT----k
XXXXXXXXXXXXXXXXXXXXXX-XXXXXXXXXXXXXXXXXXXXXXXXXXXXXXXXXXXXXXXXXXXXXXXXXXXXXXXXXXXXXXXXXXXXXXXXXXXXXXXXXXXXXXXXXXXXXXXXXXXXXXXXXXXXXXXXXXXXXXXXXXXXXXXXXXXXXXXXXXXXXXXXXXXXXXXXXXXXXXXXXXXXXXXXX
XXXXXXXXXXXXXXXXXXXXXX-XXXXXXXXXXXXXXXXXXXXXXXXXXXXXXXXXXXXXXXXXXXXXXXXXXXXXXXXXXXXXXXXXXXXXXXXXXXXXXXXXXXXXXXXXXXXXXXXXXXXXXXXXXXXXXXXXXXXXXXXXXXXXXXXXXXXXXXXXXXXXXXXXXXXXXXXXXXXXXXXXXXXXXXXX
