------------------------------------------------------------------------------------------------------------------------------------------------------------------------------------------------
------------------------------------------------------------------------------------------------------------------------------------------------------------------------------------------------
------------------------------------------------------------------------------------------------------------------------------------------------------------------------------------------------
------------------------------------------------S--------------------------------S--------------------------------------------------------------SSSSSSSS----------------------------------------
------------------------------------------------------------------------------------------------------------------------------------------------------------------------------------------------
----------------------------------------------------------------------------------------------------------------------------------------------------------o-------------------------------------
--------%%%%%%%%%------------------------------o--------S----------------------S--------------------------------------------------oo-----------o--------------------QQQQQS----------------------
---------||||||-|--------------#---------------------%-------------------------------------------------------------------------#----------------------------------------------------------------
---------||||||-|-------------##---------------------|------------------------------------------------------------------------------------------------------------------------------------------
---------||||||-|------------###---------------------|------------------------------------------------------------------------------------------------------------------------------------------
------%%%%%%%%%%|------------###---------------------|tt-------------------------------------##-------oo-----------------------#---------TT-----------tt----------------------------------------
-------||||||||-|------------###---------------------Rtt-----------------------------------####------------------------------------------TT-----------tt-----TT-------------------------TT------
-------||||||||-|----------#####---------TT----------ttt-----------------TT----------------####------------------------------##----------TT-----------tt-----TT-------------------B-----TT----@-
-------||||||||-|-------g--#####---------TT----------ttt----------ggg----TT----------------####------kk-----k---k-----------###g---k-----TT-----------tt-----TT-------------------g-----TT---ggg
XXXXXXXXXXXXXXXX%%%XXXXXXXXXXXXXXXXXXXXXXXXXXXXXXXXXXXXXXXXXXXXXXXXXXXXXXXXXXXXXXXXXXXXXXXXXXXXXXXXXXXXXXXXXXXXXXXXXXXXXXXXXXXXXXXXXXXXXXXXXXXXXXXXXXXXXXXXXXXXXXXXXXXXXXXXXXXXXXXXXXXXXXXXXXXXX
XXXXXXXXXXXXXXXXX|--XXXXXXXXXXXoXXXXXXXXXXXXXXXXXXXXXXXXXXXXXXXXXXXXXXXXXXXXXXXXXXXXXXXXXXXXXXXXXXXXXXXXXXXXXXXXXXXXXXXXXXXXXXX-XXXXXXXXXXXXXXXXXXXXXXXXXXXXXXXXXXXXXXXXXXXXXXXXXXXXXXXXXXXXXXXX
