------------------------------------------------------------------------------------------------------------------------------------------------------------------------------------------------
------------------------------------------------------------------------------------------------------------------------------------------------------------------------------------------------
------------------------------------------------------------------------------------------------------------------------------------------------------------------------------------------------
--------------------------------SS----------------------------------------------SSSSSSSSSSSSSSSS--------------------------------SSSSSSSSSS-----------------------------------------------SS-----
------------------------------------------------------------------------------------------------------------------------------------------------------------------------------------------------
-------------------------------------------------------------------------------------------------------------------------------------------------------------------------------o----------------
--------%%%%%%%%------------------------S------------QQSSSS-SS--oooo----oo-----o---------------------QQSQS---SSSS---QS---------U--------------------QQQQQS---SSSS------------SSS--o-------------
---------||||||--------------------%%%%-------------------------------------------------------------------------------------------------------------------------S-------------------------------
---------||||||---------------------||----------------------------------------------------------------------------------------o---------------------------------S-------------------------------
---------||||||---------------------||--------------------------o------------------------S----------------------------------------------------------------------So------------------------------
------%%%%%%%%%%--------------------||tt--------------QQQ---SQ----------------------------------------Qt---------------------US-----------------#-#-QQQQQ----Q--SSSSSS-------------------TT--#--
-------||||||||----------T----T-----||tt---------------------------------------------------------------t---------------------------------B-----------------------------------------------TT-----
-------||||||||----------TT---------||tt----------------------------------B--------------T------------tt-----------------------------B---b-----------------------------------------------TT--k--
-------||||||||------ggg-TT-kkkT----|ttt---k-gg---------------------gygg--b-----%%-------TT---gT------tt-----g----gggggg--k-------b--t---b----g----k--------k------gg-------####---k-----TT--##-
XXXXXXXXXXXXXXXXXXXXXXXXXXXXXXXXXXXXXXXXXXXXXXXXXXXXXXXXXXXXXXXXXXXXXXXXXXXXXXXXXXXXXXXXXXXXXXXXXXXXXXXXXXXXXXXXXXXXXXXXXXXXXXXXXXXXXXXXXXXXXXXXXXXXXXXXXXXXXXXXXXXXXXXXXXXXXXXXXXXXXXXXXXXXXXXX
XXXXXXXXXXXXXXXXXXXXXXXXXXXXXXXXXXXXXXXXXXXXXXXXXXXXXXXXXXXXXXXXXXXXXXXXXXXXXXXXXXXXXXXXXXXXXXXXXXXXXXXXXXXXXXXXXXXXXXXXXXXXXXXXXXXXXXXXXXXXXXXXXXXXXXXXXXXXXXXXXXXXXXXXXXXXXXXXXXXXXXXXXXXXXXXX
