------------------------------------------------------------------------------------------------------------------------------------------------------------------------------------------------
------------------------------------------------------------------------------------------------------------------------------------------------------------------------------------------------
------------------------------------------------------------------------------------------------------------------------------------------------------------------------------------------------
----------------------------------------------------------------------------------------------------------------SSSSSSSS--------------------------------------------------------SSS-------------
------------------------------------------------------------------------------------------------------------------------------------------------------------------------------------------------
-----------------o-------oooo-------------------------------------------------------------------------------------------------------------------------------------------------------------------
--------%%%%%%%%-----------%%---------------------------oo-----o--------------------------------------SSSSS----o----------------------oo-------o-------------------------------o----------------
---------||||||------------||-------------------------------------------------------------------------------------------------------------------------------------------------------------------
---------||||||------------||--------------------------------------------------------------------------------oo---------------------------------------------------------------------------------
---------||||||------------||-----------------------------------------------###--T-------------------------------------------------------------------------------------------#------------------
------%%%%%%%%%%-T-----t---||---%------------------------------------------####--TT-------------------------S@S-----------------##-----------#-------------------------------#---------t--------
-------||||||||-T------t---||---|-----------------------------------------#####--TT----TT------------------------------t---------------------#-----------TT------------tt---##---------tt-------
-------||||||||-TT-----tt--||#--|------------------------------------t----#####-TTT----TT----------------------------ttt-----TT--------------------------TT---#--------##--###---------tt----TT-
-------||||||||-Tt-----tt--||2--|------------g-gg----k------k--------tty-######-TTT---kTT----k--g-ggg-----------------tt-----kg-#--k-k-k----k#-----------TT---#T------#t#--###--g------tt----gT-
XXXXXXXXXXXXXXXXXXX---XXXXXXXX--X%%XXXXXXXXXXXXXXXXXXXXXXXXXXXXXXXXXXXXXXXXXXXX-XXXXXXXXXXXXXXXXXXXXXXXXXXXXXXXXXXXXXXXXXXXXXXXXXXXXXXXXXXXXXXXXXXXXXXXXXXXXXXXXXXXXXXXXXXXXXXXXXXXXXXXXXXXXXXXX
XXXXXXXXXXXXXXXXXXX---XXXXXXXX--XXXXXXXXXXXXXXXXXXXXXXXXXXXXXXXXXXXXXXXXXXXXXXX-XXXXXXXXXXXXXXXXXXXXXXXXXXXXXXXXXXXXXXXXXXXXXXXXXXXXXXXXXXXXXXXXXXXXXXXXXXXXXXXXXXXXXXXXXXXXXXXXXXXXXXXXXXXXXXXX
