------------------------------------------------------------------------------------------------------------------------------------------------------------------------------------------------
------------------------------------------------------------------------------------------------------------------------------------------------------------------------------------------------
------------------------------------------------------------------------------------------------------------------------------------------------------------------------------------------------
------------------------------------------------SSSSSSSS----------------------------------------SSSSSSSSSSSSSSSSSS------------------------------SSSSSSSS--------SSSSSSSSSSS---------------------
------------------------------------------------------------------------------------------------S-----------------------------------------------------------------------------------------------
------------------------------------------------------------------------------------------------------------------------------------------------------------------------------------------------
--------%%%%%%%%-----------------ooo-----------o---------------------QQSQS-----S-oo-----------oo-------------SSS--------------------QQQSSSS--SSS------------------------o-----------------------
---------||||||-S-------------oo----------------------------------------------------------------------------------------------------------------------------------------------------------------
---------||||||-----#-----------------------------------------------------------------------------------------------#---------------------------------------------------------------TT----------
---------||||||-----#------------------------------------o-----------------------o----------------------------------#---------------------------------------------------------------TT----------
------%%%%%%%%%%---------------#------------------------------------------------------------------------------------------------Q-------SS--SSS-------------#-----------------------##----------
-------||||||||---------------##---------#---------------#-------------------##----------------------tt-------------------------------------------------TT-----------tt----------------------##-
-------||||||||---------------##---------##----------#---B---TT--------------##----------##----------tt--#-------------tt----------------------------B--TT-----------tt----------------TT----###
-------||||||||--------#--g-####----g---###-------#----k-b---TT-------------####---ggg---##----------tt--##---#--------tt---g###---gg----------g--k--b--TT---###-----tt-------y-g------TT---####
XXXXXXXXXXXXXXXXXXXXXXXXXXXXXXXXXXXXXXXXXXXXXXXXXXXXXXXXXXXXXXXXXXXXXXXXXXXXXXXXXXXXXXXXXXXXXXXXXXXXXXXXXXXXXXXXXXXXXXXXXXXXXXXXXXXXXXXXXXXXXXXXXXXXXXXXXXXXXXXXXXXXXXXXXXXXXXXXXXXXXXXXXXXXXXXX
XXXXXXXXXXXXXXXXXXXXXXXXXXXXXXXXXXXXXXXXXXXXXXXXXXXXXXXXXXXXXXXXXXXXXXXXXXXXXXXXXXXXXXXXXXXXXXXXXXXXXXXXXXXXXXXXXXXXXXXXXXXXXXXXXXXXXXXXXXXXXXXXXXXXXXXXXXXXXXXXXXXXXXXXXXXXXXXXXXXXXXXXXXXXXXXX
