------------------------------------------------------------------------------------------------------------------------------------------------------------------------------------------------
------------------------------------------------------------------------------------------------------------------------------------------------------------------------------------------------
------------------------------------------------------------------------------------------------------------------------------------------------------------------------------------------------
----------------SSSSSSSSSSSSSSSS--------------------------------SSSSSSSS--------------------------------------------------------SSSSSSSSSSS-----------------------------------------------------
----------------------SS------------------------------------------------------------------------------------------------------------------------------------------------------------------------
---------------------SS-------SS----------------------------------------------------------------------------------------------------------------------------------------------o-----------------
--------%%%%%%%%SSSSSSSS-----SSS-------SS---------------------So----------------------SSSSSSSS----------------------QQ---------o----------------------SSSS-----------------------ooo-----------o
---------||||||-------------------------------------------------------------------------------------------------------------------------------------------------S--------------o----------------
---------||||||-S-------------SS------------------------------------#-------------------------------------------------------------------------------------------S----#--------------------------
---------||||||-Sogggooo---S-SSS---------------------------------------------------------------------------------------------------------o---------------------------#--------------------------
------%%%%%%%%%%SSSS#SSS-----SSS-------------o-----------------------------------------------S-----------------------------------------------------------------------2---------#----------------
-------||||||||--------K-------------tt----------------------------------------------------------------TT--------------------------------#------------------------------------##----------------
-------||||||||----------------------tt----------------------------------#----TT-----tt----------------TT----TT-----------#----------B---B----U------tt----------------TT----###---------##-----
-------||||||||--------------#-------tt------------kggg---------------g--#----TT-----tt-----------g----TT----TT---gggggg--#-------k--b-k-b----gg-----tt----------------TT---####---k-g-####-----
XXXXXXXXXXXXXXXXXXXXXXXXXXXXXXXXXXXXXXXXXXXXXXXXXXXXXXXXXXXXXXXXXXXXXXXXXXXXXXXXXXXXXXXXXXXXXXXXXXXXXXXXXXXXXXXXXXXXXXXXXXXXXXXXXXXXXXXXXXXXXXXXXXXXXXXXXXXXXXXXXXXXXXXXXXXXXXXXXXXXXXXXXXXXXXXX
XXXXXXXXXXXXXXXXXXXXXXXXXXXXXXXXXXXXXXXXXXXXXXXXXXXXXXXXXXXXXXXXXXXXXXXXXXXXXXXXXXXXXXXXXXXXXXXXXXXXXXXXXXXXXXXXXXXXXXXXXXXXXXXXXXXXXXXXXXXXXXXXXXXXXXXXXXXXXXXXXXXXXXXXXXXXXXXXXXXXXXXXXXXXXXXX
