------------------------------------------------------------------------------------------------------------------------------------------------------------------------------------------------
------------------------------------------------------------------------------------------------------------------------------------------------------------------------------------------------
------------------------------------------------------------------------------------------------------------------------------------------------------------------------------------------------
------------------------------------------------SSSSSS-------------------------------------------S------------------------------SSSSSSSS--------SSSSSSSS----------------------------------------
------------------------------------------------------------------------------------------------------------------------------------------------------------------------------------------------
---------------------------------------------------------------------------------------------------------oo-------------------------------------------------------------------------------------
--------%%%%%%%%---------------oooo----Soo----SS----------------------------------------o-------------------------oo---------SSS--------------------------SS---------QQSSSSSSSSS----------------
---------||||||----------------------------------------------------------------------------------#-------------o--------------------------------------------------------------------------------
---------||||||---------------------------------------------------------------------------------------------------------------------------------------------------------------------------------
---------||||||-----------------oo---------------------------------------------------------------------------------------------o----------------------------------------------------------------
------%%%%%%%%%%######----------S------------o--------------------------------------------------------------#-------S-------SSSS----------------------tt------------Q---Q----S----------TTT-----
-------||||||||---#-----------------------------------ttt----------------TT---------------------------------#-----------------------------------------tt--------------------------------TTT-----
-------||||||||---------------------------------------ttt----TT----------TT---U------tt---------------ttt--##---------------------------TT----TT------tt--------------------------B-----TTT---TT
-------||||||||----k-----------g-----kk---------------ttt----TT---kgg----TT---b------tt------ggg------ttt--####----kgg----k-k-----y-----TT----TT------tt------g---gk--------k-----b-----TTT---TT
XXXXXXXXXXXXXXXXXXXXXXXXXXXXXXXXXXXXXXXXXXXXXXXXXXXXXXXXXXXXXXXXXXXXXXXXXXXXXXXXXXXXXXXXXXXXXXXXXXXXXXXXXXXXXXXXXXXXXXXXXXXXXXXXXXXXXXXXXXXXXXXXXXXXXXXXXXXXXXXXXXXXXXXXXXXXXXXXXXXXXXXXXXXXXXXX
XXXXXXXXXXXXXXXXXXXXXXXXXXXXXXXXXXXXXXXXXXXXXXXXXXXXXXXXXXXXXXXXXXXXXXXXXXXXXXXXXXXXXXXXXXXXXXXXXXXXXXXXXXXXXXXXXXXXXXXXXXXXXXXXXXXXXXXXXXXXXXXXXXXXXXXXXXXXXXXXXXXXXXXXXXXXXXXXXXXXXXXXXXXXXXXX
