------------------------------------------------------------------------------------------------------------------------------------------------------------------------------------------------
------------------------------------------------------------------------------------------------------------------------------------------------------------------------------------------------
------------------------------------------------------------------------------------------------------------------------------------------------------------------------------------------------
--------------------------------SSSSSSSSSSS-----------------------------------------------------SSSSSSS-------------------------------------------SSSSSSSSS-------------------------------------
-------------------------------2----------------------------------------------------------------------------------------------------------------------------------------------------------------
------------------o-----------------------------------------------------------------------------------------------------------------------------------------------------------------------------
--------%%%%%%%%--------------------------------------S--------o---------------S------------------------S-----------QQQQQSS-SSSS-----------------oo-----oo---o-o--------------------QQQQQSS--SSS
---------||||||---------------------------------------------------------------------------------------------------------------------------------------------------------------------------------
---------||||||-----------------------------------------------------B---------------------------------------------------------------o-----------------------------------------------------------
---------||||||-----------------------------------------------------#----------------------##---------------------------------------#-----------------------------------------------------------
------%%%%%%%%%%--T-----T----------------------------------------------------##-----------###---------tt--------Q---@SQQQS---Q---------------------------------------------------#-----QS----SS-
-------||||||||---TT---TT----------------------------t----------------------###----------###---------ttt---------------------------------------------t----------------t-------------------------
-------||||||||---TT---TT----TT------t---K-----------t---##------------TT---###----------##----------ttt--------------------------------TT----@-----tt---------------tt-------U-----------------
-------||||||||---TT---TT----kTg-----t---#----g-----ttt-###-k---g------TT--####---k-----###---#------ttt-----gk-------------k-----g-----TT---##-----tt---------------tt-------k----k-----------g
XXXXXXXXXXXXXXXXXXXXXXXXXXXXXXXXXXXXXXXXXXXXXXXXXXXXXXXXXXXXXXXXXXXXXXXXXXXXXXXXXXXXXXXXXXXXXXXXXXXXXX%XXXXXXXXXXXXXXXXXXXXXXXXXXXXXXXXXXXXXXXXXXXXXXXXXXXXXXXXXXXXXXXXXXXXXXXXXXXXXXXXXXXXXXXXX
XXXXXXXXXXXXXXXXXXXXXXXXXXXXXXXXXXXXXXXXXXXXXXXXXXXXXXXXXXXXXXXXXXXXXXXXXXXXXXXXXXXXXXXXXXXXXXXXXXXXXXXXXXXXXXXXXXXXXXXXXXXXXXXXXXXXXXXXXXXXXXXXXXXXXXXXXXXXXXXXXXXXXXXXXXXXXXXXXXXXXXXXXXXXXXXX
