------------------------------------------------------------------------------------------------------------------------------------------------------------------------------------------------
------------------------------------------------------------------------------------------------------------------------------------------------------------------------------------------------
------------------------------------------------------------------------------------------------------------------------------------------------------------------------------------------------
------------------S------SSSSSS-----------------SSSSSSSSSSS--SSS----------------SS------------------------------SSSSSSSSSSSSSSSS----------------------------------------------------------------
------------------------------------------------------------------------------------------------------------------------------------------------------------------------------------------------
-----------------------------------------------------------------------------------------o------------------------------------------------------------------------------------------------------
--------%%%%%%%%-------------------------------o----------S------oooSSSSoS---SoS-----------------SQQQQQQQSS--S@S-----------------oo---SSSS-----S------------------------------------------------
---------||||||---------------------------------------------------------------------------------------------------------------------------------------------------------------------------------
---------||||||---------------------------------------------------------------oo-----------------------------oo---------------------------------------------------------------------------------
---------||||||-oooo--------------------------------------------g----------------------------------------------------------------------------------------------------------#--------------------
------%%%%%%%%%%---------TT-------------------------------------#---QQ-------USS----------------##QQQQ-Q----S@S--------------------------------------2--------------------##-----------------o--
-------||||||||----------TT--------------##--------------B------------------------------TT--------------------------------------------------------------TT---------------##------------S--------
-------||||||||----------TT-------------###--------------B----TT------------------B-----TT---TTT------------------B-----tt----TT------------------------TT---TT----------##------------S-----@--
-------||||||||------k---TT----#--kkgggg###--------------b----TT---k-k----k-------b-----TT---TTT---kgg------k-----b-----tt----TT----------------g-g-----TT---TT------k--###----#g-g----------gg-
XXXXXXXXXXXXXXXXXXXXXXXXXXXXXXXXXXXXXXXXXXXXXXXXXXXXXXXXXXXXXXXXXXXXXXXXXXXXXXXXXXXXXXXXXXXXXXTTXXXXXXXXXXXXXXXXXXXXXXXXXXXXXXXXXXXXXXXXXXXXXXXXXXXXXXXXXXXXXXXX-XXXXXXXXXXXXXXXXXXXXXXXXXXXXXXX
XXXXXXXXXXXXXXXXXXXXXXXXXXXXXXXXXXXXXXXXXXXXXXXXXXXXXXXXXXXXXXXXXXXXXXXXXXXXXXXXXXXXXXXXXXXXXXXXXXXXXXXXXXXXXXXXXXXXXXXXXXXXXXXXXXXXXXXXXXXXXXXXXXXXXXXXXXXXXXXX--XXXXXXXXXXXXXXXXXXXXXXXXXXXXXX
