------------------------------------------------------------------------------------------------------------------------------------------------------------------------------------------------
------------------------------------------------------------------------------------------------------------------------------------------------------------------------------------------------
------------------------------------------------------------------------------------------------------------------------------------------------------------------------------------------------
------------------------------------------------SSSSSSSSSS--------------------------------------SSSSSSSSSSS----S--------------------------------------------------------------------------------
------------------------------------------------------------------------------------------------S-----------------------------------------------------------------------------------------------
------------------------------------------------------------------------------------------------------------------------------------------------------------------------------------------------
--------%%%%%%%%-----------------------------------------------------SSS------------------------------------------------------SS---QQS---------o-------------------------------o---------------S
---------||||||--------o------------------------S------------------------------o--------------------------------S------------------------------------------------------------------------------#
---------||||||-------------------------------SSS------------------------------#----------------------------------------------------------------------------------------------------------------
---------||||||-------------------------------oo-------------------------------#-------------------------------------------------------------------------------------------------o--------------
------%%%%%%%%%%---------------S------U------SSS--------------------------------------------------------------------------------#------------#----------------------------------------------####
-------||||||||---------------------------------------------------------------#---K------TT----------#------------------------------------#-#-----------------------------------------------###-
-------||||||||---------------------------B------------------TT--------------###--B------TT----------#--------TT-----tt------------------##-###---B-----tt----@-------------------------TT######
-------||||||||-----------------------k---b-----%%k----------TT-------------####--b------TT-------#--#--------TT-----tt-----gggg---kggg--##-###---b-----tt---gg---kk-g------kkk---g-----TT######
XXXXXXXXXXXXXXXX-XXXXXXX-----X--XXXXXXXXXXXXXXXXXXXXXXXXXXXXXXXXXXXXXXXXXXX-XXXXXXXXXXXXXXXXXXXXXXXXXXXXXXXXXXXXXXXXXXXXXXXXXXXXXXXXXXXXXXXXXXXXXXXXXXXXXXXXXXXXXXXXXXXXXXXXXXXXXXXXXXXXXXXXXXXX
XXXXXXXXXXXXXXXX-XXXXXXX-----X--XXXXXXXXXXXXXXXXXXXXXXXXXXXXXXXXXXXXXXXXXXXXXXXXXXXXXXXXXXXXXXXXXXXXXXXXXXXXXXXXXXXXXXXXXXXXXXXXXXXXXXXXXXXXXXXXXXXXXXXXXXXXXXXXXXXXXXXXXXXXXXXXXXXXXXXXXXXXXXXX
