------------------------------------------------------------------------------------------------------------------------------------------------------------------------------------------------
------------------------------------------------------------------------------------------------------------------------------------------------------------------------------------------------
------------------------------------------------------------------------------------------------------------------------------------------------------------------------------------------------
--------------------------------SSSSSSSS----------------------------------------SSSSSSSS------------------------SSSSSSSSSS----------------------SSSSSSSS-------------SSS--------SSSSSSSSSS------
------------------------------------------------------------------------------------------------------------------------------------------------------------------------------------------------
------------------------------------------------------------------------------------------------------------------------------------------------------------------------------------------------
--------%%%%%%%%S-------------SS----------------------------------o----Soo----SS-----------------oo------------o----------------SSooSSSSoSS--SSS----------------oooo---ooo---SSoooo---SS--S--SS-
---------||||||---------------------------------------------------------------------------------------------------------------------------------------------------------------------------------
---------||||||-------------------------------S-------------------------------------------------------------------------------------------------------------------------------------------------
---------||||||-S---------------------tt-------------------------oo-------------------------------------------------------------oo------------------------------ooo-------------o---------------
------%%%%%%%%%%---------------o------tt-----o---------------------------#--------------------------------#-##------------------SS----------S@SS---------------------o-------o------------------
-------||||||||-----------------------tt------------------K--------------#---#--------tt------------------#-#-----------------------------------------------------------------------------#-----
-------||||||||--------TT-------------tt--------------------------------##-###--------tt------------------#----------tt---------------------------------------TT---------------------#---##-----
-------||||||||---ggg--TT-----#-#-----tt----###----gg----------g-----y#-######--------tt-----kgg---k-k---##-#-#---k--tt-------k----k-kgg--k-k-----g------g----TT------k-----k--------#---##-----
XXXXXXXXXXXXXXXXXXXXXXXXXXXXXXXXXXXXXXXXXXXXXXXXXXXXXXXXXXXXXXXXXXXXXXXXXXXXXXXXXXXXXXXXXXXXXXXXXXXXXXXXXXX-XXXXXXXXXXXXXXXXXXXXXXXXXXXXXXXXXXXXXXXXXXXXXXXXXXXXXXXXXXXXXXXXXXXXXXXXXXXXXXXXX-XX
XXXXXXXXXXXXXXXXXXXXXXXXXXXXXXXXXXXXXXXXXXXXXXXXXXXXXXXXXXXXXXXXXXXXXXXXXXXXXXXXXXXXXXXXXXXXXXXXXXXXXXXXXXXXXXXXXXXXXXXXXXXXXXXXXXXXXXXXXXXXXXXXXXXXXXXXXXXXXXXXXXXXXXXXXXXXXXXXXXXXXXXXXXXXX-XX
