------------------------------------------------------------------------------------------------------------------------------------------------------------------------------------------------
------------------------------------------------------------------------------------------------------------------------------------------------------------------------------------------------
------------------------------------------------------------------------------------------------------------------------------------------------t-----------------------------------------------
----------------o-----------------------------------------------------------------------------------------------------------------#--#----------t-----------------------------------------------
----------------------------------------------------------------------------------------------------------------------------------#g#-----------t-----------------------------------------------
---------------------%%%------------------------------------------------------------------------------------------##--------------##------------t-----------------------------------------------
--------%%%%%%%%------|---------------------------------------------SSSSSS-----------------------SSSSSS-----------------------------------------SSS-----------------------------SSS---------Sooo
---------||||||-------|--------------------------------------------------------------------------------------------------oo--------###--oooo---------ooo--------------------------SS------------
---------||||||--%%%%%%-----------------------------------------------------------------SS-------------------------------------------------------------------------------S----------------------
---------||||||---||||-------------g-------------------------------o------o-------------SSS------------------------------S-----------------------------------------------SSS--------------------
------%%%%%%%%%%--||||%%-----------SS------------------------------S----------------------------------------------------------------------------------------------------------#-----------------
-------||||||||---||||||---------------------------------------------------------------------------------TT----------------------------T--------TT-------TT----------t-TT-----#-T--------TT----T
-------||||||||---||||||---B----------------------------------------------------------------##-----------TT----T----tt-TT--------------TT-------TT----tt-TT---------tt-TT-----#-T--------TT----T
-------||||||||---||||||---b---------y---k------------------##-----k------------------------##-------y---TT----T----tt-TT-k----------t-TT-------TT----ttkTT----g----tt-TT--y--#-T--------TT----T
XXXXXXXXXXXXXXXX--||||||-----%%-XXXXXXXXXXXXXXXXXXXXXXXXXXXXXXXXXXXXXXXXXXXXXXXXXXXXXXXXXXXXXXXXXXXXXXXXXXXXXXXXXXXXXXXXXXXXXXXXXXXXXXXXXXXXXXXXXXXXXXXXXXXXXXXXXXXXXXXXXXXXXXXXXXXXXXXXXXXXXXXX
XXXXXXXXXXXXXXXX--||||||-----||-XXXXXXXXXXXXXXXXXXXXXXXXXXXXXXXXXXXXXXXXXXXXXXXXXXXXXXXXXXXXXXXXXXXXXXXXXXXXXXXXXXXXXXXXXXXXXXXXXXXXXXXXXXXXXXXXXXXXXXXXXXXXXXXXXXXXXXXXXXXXXXXXXXXXXXXXXXXXXXXX
