--------------------------------------------------------------------------------------------------------------------------------------------------------------------------------
--------------------------------------------------------------------------------------------------------------------------------------------------------------------------------
--------------------------------------------------------------------------------------------------------------------------------------------------------------------------------
--------------------------------------------------------------------------------------------------------------------------------------------------------------------------------
--------------------------------------------------------------------------------------------------------------------------------------------------------------------------------
---------------U----------------------------------------------------------------------------------------------------------------------------------------------------------------
-SS-------SS---S-----------------------------------------------------------------------------------------------o---------------oSS---------SSQ-----------------o---------------o
----------------------------------------------------------o------------------------%%%------------------------------------------------------------------------------------------
------------------------------------------------------------------------------------|-----------%-------------------------------------------------------------------------------
-----------------------------g------------------------------------------------------|-----------|-------------------------------------------------------------------------------
-----------------------------QQ--------@--------------------------------------------|-----------|-TT----------------------------------------------S---------------TT--Q---------
------B-------------------------------------------TT--------------------------------|----TT-----|-TT-------------------------------------TT---------tt------------TT------------
------b-------------------------------------------TT--------------------------------|----TT----T|-TT-----------------------------T----B--TT---------tt------------TT------------
------b--------------------------g--y---y-gg--g---TT---------------ggg--------------|-g--TT----T|-TT----------g-------------y-g--T-------TT---ggg---tt------g-g---TT-------ggggg
X---XXXXXXXXXXXXXXXXXXXXXXXXXXXXXXXXXXXXXXXXXXXXXXXXXXXXXXXXXXXXXXXXXXXXXXXXXXXXXXXXXXXXXXXXXXXXXXXXXXXXXXXXXXXXXXXXXXXXXXXXXXXXXXXXXXXXXXXXXXXXXXXXXXXXXXXXXXXXXXXXXXXXXXXXXXXX
X---XXXXXXXXXXXXXXXXXXXXXXXXXXXXXXXXXXXXXXXXXXXXXXXXXXXXXXXXXXXXXXXXXXXXXXXXXXXXXXXXXXXXXXXXXXXXXXXXXXXXXXXXXXXXXXXXXXXXXXXXXXXXXXXXXXXXXXXXXXXXXXXXXXXXXXXXXXXXXXXXXXXXXXXXXXXX
