------------------------------------------------------------------------------------------------------------------------------------------------------------------------------------------------
------------------------------------------------------------------------------------------------------------------------------------------------------------------------------------------------
------------------------------------------------------------------------------------------------------------------------------------------------------------------------------------------------
----------------SSSSSSSS----------------------------------------SSSSSSSS----------------------------------------SSSSSSSSSSS-----SSSSSSSSSSS-------------------------------------SSSSSSSSSSSS-SS-
------------------------------------------------------------------------------------------------------------------------------------------------------------------------------------------------
---------------------------------------------------------------------------------------------------------------------------------------------------------oo-------------------------------------
--------%%%%%%%%-------S-------------SSSSS---SSS---------------------------------------------------------------U-o------oo----SS-----------------------------------------------S----------------
---------||||||-S----------------------------------------------------------------------------------------------------------------------------------------------o--------------------------------
---------||||||-S---T-----------------------------------------##-----------------------------------------------------------------------------------------------#--------------------------------
---------||||||-S---T----------------------------------------###----------------------------------------------------------------------------------------------##--------------#-----------------
------%%%%%%%%%%S--S#------------------------o--------------####------tt-------------#-#-----#------------------------t---------------t----------------TT----###-------------##-------t---------
-------||||||||-------------------------------------------#-####------tt---------------TT---###-----------T----------tt--------------tt----------------TT---####------------###------ttt--------
-------||||||||----------#---#----------------------------######------tt---#-#--T#-----TT---###----------TT----------tt--------------tt----------------TT---##TT------------###------ttt------b-
-------||||||||-------#--#---##----k-k------k-----gggg----######-----ttt---#-#g-TT-----TT---###---ggg-----T----g-----ttt-------------tt-------k---gg---TT---####---kgggg----####-----ttt------g-
XXXXXXXXXXXXXXXXXXXXXXXXXXXXXXXXXXXXXXXXXXXXXXXXXXXXXXXXXXXXXXXXXXXXXXXXXXXXXXXXXXXXXXXXXXXXXXXXXXXXXXXXXXXXXXXXXXXXXXXXXXXXXXXXXXXXXXXXXXXXXXXXXXXXXXXXXXXXXXXXXXXXXXXXXXXXXXXXXXXXXXXXXXXXXXXX
XXXXXXXXXXXXXXXXXXXXXXXXXXXXXXXXXXXXXXXXXXXXXXXXXXXXXXXXXXXXXXXXXXXXXXXXXXXXXXXXXXXXXXXXXXXXXXXXXXXXXXXXXXXXXXXXXXXXXXXXXXXXXXXXXXXXXXXXXXXXXXXXXXXXXXXXXXXXXXXXXXXXXXXXXXXXXXXXXXXXXXXXXXXXXXXX
