------------------------------------------------------------------------------------------------------------------------------------------------------------------------------------------------
------------------------------------------------------------------------------------------------------------------------------------------------------------------------------------------------
------------------------------------------------------------------------------------------------------------------------------------------------------------------------------------------------
---------------------------------SSS--------------------------------------------SSSSSS----------------------------------------------------------SSSSSSSSSSS-------------------------------------
------------------------------------------------------------------------------------------------------------------------------------------------------------------------------------------------
------------------------------------------------------------------------------------------------------------------------------------------------------------------------------------------------
--------%%%%%%%%-------------------------------------------------------------------------------------------------oo----Soo-----S---------------------------------------oo-----------------------
---------||||||-----------------------------------------------------------------------------------------------------------------------------------------------------------------SS--------------
---------||||||-----------------------------------------------------------------------------------------------------------------------------------------------------------------S---------------
---------||||||---------------------------------------------------------------------------------------------#-----------------------------------------------------------------------#-----------
------%%%%%%%%%%---------TT-------------------------------------------------------------------------------#####---------------------------------------------------------------------------------
-------||||||||----------TT--------------TT------------------------------TT-----------tt-----------------######-----tt----------------tt-----TT-----------#-------------------------------------
-------||||||||-ooo------TT--------------TT---TT---------------------#---TT-----------tt-----------------######-----tt----------------tt-----TT-----------#----------------------------#--------
-------||||||||----------TT----o--k------TT---TT------------k-----kggg---TT-----------tt-----k----------#####-##----tt----------g-----tt-----TT---#-----###---g-------k---#-k-----#---##------g#
XXXXXXXXXXXXXXXX-%%%-----XX-----XXXXXXXXXXXXXXXXXXXXXXXXXXXXXXXXXXXXXXXXXXXXXXXXXXXXXXXXXXXXXXXXXXXXXXXXXXXXXXXXXXXXXXXXXXXXXXXXXXXXXXXXXXXXXXXXXXXXXXXXXXXXXXXXXXXXXXXXXXXXXXXXXXXXXXXXXXXXXXXX
XXXXXXXXXXXXXXXX--|-------------XXXXXXXXXXXXXXXXXXXXXXXXXXXXXXXXXXXXXXXXXXXXXXXXXXXXXXXXXXXXXXXXXXXXXXXXXXXXXXXXXXXXXXXXXXXXXXXXXXXXXXXXXXXXXXXXXXXXXXXXXXXXXXXXXXXXXXXXXXXXXXXXXXXXXXXXXXXXXXXX
