------------------------------------------------------------------------------------------------------------------------------------------------------------------------------------------------
------------------------------------------------------------------------------------------------------------------------------------------------------------------------------------------------
------------------------------------------------------------------------------------------------------------------------------------------------------------------------------------------------
--------------------------------SSSSSSSSS----------SSS------------------------------------------SSSSSSSSSSS--SSS---------------------------------SSSS-----------SSSSSSSSS-----------------------
-------------------------------------------------------------------------------o----------------------------------------------------------------------------------------------------------------
------------------------------------------------------------------------------------------------------------------------------------------------------------------------------------------------
--------%%%%%%%%----QSQSSSS---@-oo-----SS------S-oo----SSo-----S----------------------SSSSS---------------------oooo-SSSS----SSS---------------------------------------SSo------SSSSQSSS--------
---------||||||---------------------------------------------------------------------------------------------------------------------------------------------------------------------------------
---------||||||----------------------------y#-------------------------------------------------------------------------------------------------------------------------------------------------o-
---------||||||----------------------------##-------------------------------------------------------------------oo--------------------------------------------------------------g---------------
------%%%%%%%%%%SS----------S@S-----------###-----------------------------------------------So------------------S-------------S-------------------------------------------------#S--Q--------SS-
-------||||||||--------------------------####----------------------------TT--------------------------------------------------------------TT--------------TT----------tt-------------------------
-------||||||||---------------------tt--#####-------tt---##--------------TT-----------SS-------------------------------------------------TT----------#---TT---TT-----tt-------------------------
-------||||||||----k----------------tt-######--#----tt---##-------gggg---TT---k---g------------g--g------k-----------yg-----------gggg---TT---k----k-#--###---TT-----tt-----kkkg---kgggg--k-k---
XXXXXXXXXXXXXXXXXXXXXXXXXXXXXXXXXXXXXXXXXXXXX-XXXXXXXXXXXXXXXXXXXXXXXXXXXXXXXXXXXXXXXXXXXXXXXXXXXXXXXXXXXXXXX-XXXXXXXXXXXXXXXXXXXXXXXXXXXXXXXXXXXXXXXXXXXXXXXXXXXXXXXXXXXXXXXXXXXXXXXXXXXXXXXXXX
XXXXXXXXXXXXXXXXXXXXXXXXXXXXXXXXXXXXXXXXXXXXX-XXXXXXXXXXXXXXXXXXXXXXXXXXXXXXXXXXXXXXXXXXXXXXXXXXXXXXXXXXXXXXX-XXXXXXXXXXXXXXXXXXXXXXXXXXXXXXXXXXXXXXXXXXXXXXXXXXXXXXXXXXXXXXXXXXXXXXXXXXXXXXXXXX
