------------------------------------------------------------------------------------------------------------------------------------------------------------------------------------------------
------------------------------------------------------------------------------------------------------------------------------------------------------------------------------------------------
------------------------------------------------------------------------------------------------------------------------------------------------------------------------------------------------
--------------------------------------------------------------------------------SSS---------------------------------------------------------------------------------------------SSSSSSS---------
------------------------------------------------------------------------------------------------------------------------------------------------------------------------------------------------
------------------------------------------------------------------------------------------------------------------------------------------------------------------------------------------------
--------%%%%%%%%S------------------------------o--------So---------------------------------------------------------------o---------------------------Q-Q-----SSS---------------o-------SS-------
---------||||||---------------------------------------------------------------------------------------------------------------------------------------------------------------------------------
---------||||||----------------------------U----------------------------------------------------------------------------------------------------------------------------------------------------
---------||||||---------------------------------------------------------------------------------------k-----------------------------------------------------------------------------------------
------%%%%%%%%%%-SSoSSSS-S-------SS------------------------------------------------------------------S@------o----------------------------------------------------------------------------------
-------||||||||---------------K------------------------------------------TT------------------------------------------------------------------#---------------#-----------TT----------ttt--------
-------||||||||----------------------------------------------------------TT----------------------------------------------------------tt------#---------------##----------TT----------ttt--------
-------||||||||----k-k----U-k-------------g-------kk---------k-g---------TT-------g---k------grg---------------g---kg-------kkk------tt------#---------g----###---kk---g-TT----------ttt----kgk-
XXXXXXXXXXXXXXXXXXXXXXXXXXXXXXXXXXXXXXXXXXXXXXXXXXXXXXXXXXXXXXXXXXXXXXXXXXXXXXXXXXXXXXXXXXXXXXXXXXXXXX--XXXXXXXXXXXXXXXXXXXXXXXXXXXXXXXXXXXXXXXXXXXXXXXXXXXXXXXXXXXXXXXXXXXXXXXXXXXXXXXXXXXXXXXX
XXXXXXXXXXXXXXXXXXXXXXXXXXXXXXXXXXXXXXXXXXXXXXXXXXXXXXXXXXXXXXXXXXXXXXXXXXXXXXXXXXXXXXXXXXXXXXXX-XXXXX--XXXXXXXXXXXXXXXXXXXXXXXXXXXXXXXXXXXXXXXXXXXXXXXXXXXXXXXXXXXXXXXXXXXXXXXXXXXXXXXXXXXXXXXX
