------------------------------------------------------------------------------------------------------------------------------------------------------------------------------------------------
------------------------------------------------------------------------------------------------------------------------------------------------------S-----------------------------------------
------------------------------------------------------------------------------------------------------------------------------------------------------------------------------------------------
------------------------------------------------------------------------------------------------SSSSSSSS----------------------------------------SSSSSS------------------------------------------
------------------------------------------------------------------------------------------------------------------------------------------------------------------------------------------------
------------------------------------------------------------------------------------------------------------------------------------------------------------------------------------------------
--------%%%%%%%%-------------------------------------ooSo-------------SSSS--------o-----------------------------S-----------------o------------o-------SS---------------------------------------
---------||||||--------------U-----------------------%%-----------------------------------------SS--------------S------------------------------------%----------S-------------------------------
---------||||||--------------------------------------||-----------------------------------------S---------------S---#--------------------------------|----------S-------------------------------
---------||||||--------------------------------------||------------------------------------------------------------------------------------#---------|------------------------------------------
------%%%%%%%%%%--TT---------------------------------|SS---------------------o-----------TT----------------------------------------------#####-------|------------------------------------------
-------||||||||---TT----TT---------------------------|tS---------------------#-----------TT----------------------------------------------#####-------tt----------------------------------TT---#-
-------||||||||---TT----TT----------------#----------tt----------------------------------TT----------------------------------#----------######-------tt------------------TT---U----------TT---#-
-------||||||||---TT--k-TT-----------g----#---##-----tt----k-g----gg---------k----k---y-###-----g----------kkkk--------------#-----k---#######-------tt-----ggg---gg-----TT---g---kggg---TT---#-
XXXXXXXXXXXXXXXXXXXXXXXXXXXXXXXXXXXXXXXXXXXXXXXXXXXXXXXXXXXXXXXXXXXXXXXXXXXXXXXXXXXXXXXXXXXXXXXXXXXXXXXXXXXXXXXXXXXXXXXXXXXXXXXXXXXXXXXXXXXXXXXXXXXXXXXXXXXXXXXXXXXXXXXXXXXXXXXXXXXXXXXXXXXXXXXX
XXXXXXXXXXXXXXXXXXXXXXXXXXXXXXXXXXXXXXXXXXXXXXXXXXXXXXXXXXXXXXXXXXXXXXXXXXXXXXXXXXXXXXXXXXXXXXXXXXXXXXXXXXXXXXXXXXXXXXXXXXXXXXXXXXXXXXXXXXXXXXXXXXXXXXXXXXXXXXXXXXXXXXXXXXXXXXXXXXXXXXXXXXXXXXXX
