-----------------------------------------------------------------%%--%--------------------------------------------------------------------------------------------------------------------------
-----------------------------------------------------------------||--|--------------------------------------------------------------------------------------------------------------------------
-----------------------------------------------------------------||--|--------------------------------------------------------------------------------------------------------------------------
---------------------------------#-------------------------------||--|--------------------------------------------------------------------------------------------------------------------------
-----------------SS----------------k#----------------------------||--|--------------------------------------------------------------------------------------------------------------------------
-----------------S----o------o--%--------------------------------||--|--------------------------------------------------------------------------------------------------------------------------
--------%%%%%%%%----------------|--------------------------------||--|----------S%-----------------------------o---------------o%%%------------------------------%%----------------------------o
---------||||||---S---------SS--|--------oo---------o------------||--|-----------|-oooo-------------------o--------------ooo-----|--------------o----------------||-----------------------------
---------||||||-----------------|--------------------------------||--|-----------|-----------------------------------------------|-------------------------------||-----------------------------
---------||||||--K-----------SoS|--------------------------------||--|-----------|-----------------------------------------------|-------------------------------||-----------------------------
------%%%%%%%%%%-------------%%%|--------------------------------||--|----------TT-----------------------------------------------TTT--------------TT-------------|TT----------------------------
-------||||||||---------------|-|------------T----T------TT------||--|----------TTT------TT-------TT---TT------------------------TTT-----TT-------TT-------------TTT-----TT-------TT------------
-------||||||||---------------|-|-----------TT---TTT-----TT------||--|----------TTTT-----TT-------TT---TT--tt--------------------TTTT----TT-------TT---TT--------TTT-----TT-------TT-------tt---
-------||||||||------------o--|-|-gg--------TT---TTT--g--TT----g-||--|----------TTTT--g-kTT----g--TT---TT--tt-g----gg------------TTTT-g--TT--ggg--TT---TT--------TTT-----TT----g--TT-------tt-g-
XXXXXXXXXXXXXXXXX---------%---|-XXXXXXXXXXXXXXXXXXXXXXXXXXXXXXXXXXXXXXXXXXXXXXXXXXXXXXXXXXXXXXXXXXXXXXXXXXXXXXXXXXXXXXXXXXXXXXXXXXXXXXXXXXXXXXXXXXXXXXXXXXXXXXXXXXXXXXXXXXXXXXXX-XXXXXXXXXXXXXXX
XXXXXXXXXXXXXXXXX---------|---|-XXXXXXXXXXXXXXXXXXXXXXXXXXXXXXXXXXXXXXXXXXXXXXXXXXXXXXXXXXXXXXXXXXXXXXXXXXXXXXXXXXXXXXXXXXXXXXXXXXXXXXXXXXXXXXXXXXXXXXXXXXXXXXXXXXXXXXXXXXXXXXXXXXXXXXXXXXXXXXXX
