-----------------------------------------------------------------%------------------------------------------------------------------------------------------------------------------------------
-----------------------------------------------------------------|------------------------------------------------------------------------------------------------------------------------------
-----------------------------------------------------------------|------------------------------------------------------------------------------------------------------------------------------
-----------------------------------------------------------------|------------------------------------------------------------------------------------------------------------------------------
-----------------------------------------------------------------|------------------------------------------------------------------------------------------------------------------------------
---------------------------------------------------------------U-|-----------------#------------------------------------------------------------------------------------------------------------
--------%%%%%%%%-------------------------------------------------|-----------Q-o----------------SSS---------------------Q------o---------------o%%%-----------------------------%%%-------------
---------||||||-%%%%%%%%%----------------------------------------|----------------------oo-------------------------------------------------------|--oo-------------------ooo-----|--------------
---------||||||--|||||||-----------------------------------------|-------------------------------------------------------------------------------|-------------------------------|--------------
---------||||||--|||||||---------------------------g-------------|-------------------------------------------------------------------------------|-------------------------------|--------------
------%%%%%%%%%%-|||||Q@SSSQQQQQ--TT---------------Q----------S--|---------Q-QQt------------------------------------------QQQQ----TT-------------TT------------------------------|TT------------
-------||||||||--|||||-----------TTT-----------------------------|-------------t----tt-------------------TT-------TT--------------TT-------------TTT-----TT------------TT--------|TT------------
-------||||||||--|||||-----------TTTT-----------%-%--------------|-------------t----tt-------------------TT-------TT--------------TT-------------TTT#----TT------------TT--------TTT------------
-------||||||||--||||g-----ggggg-TTT------------|-|gg-U------#K--|------------ktg---tt--------#-------g-kTT----y--TT----------g---TT-------------TTT#-g--TT---gg-kk----TT--------TTT----------gg
XXXXXXXXXXXXXXXXXXXXXXXXXXXXXXXXXXXXXXXXXXXXXXXXXXXXXXXXXXXXXXXXXXXXXXXXXXXXXXXXXXXXXXXXXXXXXXXXXXXXXXXXXXXXXXXXXXXXXXXXXXXXXXXXXXXXXXXXXXXXXXXXXXXXXXXXXXXXXXXXXXXXXXXXXXXXXXXXXXXXXXXXXXXXXXXX
XXXXXXXXXXXXXXXXXXXXXXXXXXXXXXXXXXXXXXXXXXXXXXXXXXXXXXXXXXXXXXXXXXXXXXXXXXXXXXXXXXXXXXXXXXXXXXXXXXXXXXXXXXXXXXXXXXXXXXXXXXXXXXXXXXXXXXXXXXXXXXXXXXXXXXXXXXXXXXXXXXXXXXXXXXXXXXXXXXXXXXXXXXXXXXXX
