------------------------------------------------------------------------------------------------------------------------------------------------------------------------------------------------
------------------------------------------------------------------------------------------------------------------------------------------------------------------------------------------------
------------------------------------------------------------------------------------------------------------------------------------------------------------------------------------------------
----------------SSSSSSSSSSSSSSSS-SSSSSSSSSS---------------------------------------------------------------------------------------------------------------------SSSSSSSS------------------------
------------------------------------------------------------------------------------------------------------------------------------------------------------------------------------------------
---------------------------------------------------------------------------------------------------------------------------------------------------------------------------o--------------------
--------%%%%%%%%--------------------------------------ooo------o-----------------------S--------------------------------S-----SS---------------S---------------S--------------------QQQSSSS-SSSS
---------||||||---------------------------------------------------------------------------------------------------------------------------------------------------------------oo----------------
---------||||||---------------------------------------------------------------------------------------------------------------------------------------------------------------------------------
---------||||||------------------------------------------------------------------------------#-----------------------------------o--------------------------------------------------------------
------%%%%%%%%%%-----------------------------------------------------------------------------##-------------------------------##------------##------------#-#--------------------------QQ---SQS-
-------||||||||------------#--------------#------@-----------------------------------------###---------tt--------------------###----------K-#-------------#-#-----------------------------------
-------||||||||--#---------#-------------##------##---------------------TT---TT-----------####---------tt------------tt------###----------#-#------------##-----------tt------------------------
-------||||||||--##--------#-g-g----g---###---g--##kkkk----kk-----------TT---TT------k---#####---------tt----ggg-----tt-----####--gggg----b-##-------y---##-----------tt----g-----gk--------k---
XXXXXXXXXXXXXXXXXXXXXXXXXXXXXXXXXXXXXXXXXXXXXXXXXXXXXXXXXXXXXXXXXXXXXXXXXXXXXXXXXXXXXXXXXXXXXXXXXXXXXXXXXXXXXXXXXXXXXXXXXXXXXXXXXXXXXXXXXXXXXXXXXXXXXXXXXXXXXXXXXXXXXXXXXXXXXXXXXXXXXXXXXXXXXXXX
XXXXXXXXXXXXXXXXXXXXXXXXXXXXXXXXXXXXXXXXXXXXXXXXXXXXXXXXXXXXXXXXXXXXXXXXXXXXXXXXXXXXXXXXXXXXXXXXXXXXXXXXXXXXXXXXXXXXXXXXXXXXXXXXXXXXXXXXXXXXXXXXXXXXXXXXXXXXXXXXXXXXXXXXXXXXXXXXXXXXXXXXXXXXXXXX
