------------------------------------------------------------------------------------------------------------------------------------------------------------------------------------------------
------------------------------------------------------------------------------------------------------------------------------------------------------------------------------------------------
------------------------------------------------------------------------------------------------------------------------------------------------------------------------------------------------
-------------------------------------------------SSSSSSS------------------------SSSSSSS--------------------------S------------------------------SSSSSSSSSS--------------------------------------
-------------------------------------------------------------------------------------------------------------------------------------------------------------------------------o----------------
------------------------------------------------------------------------------------------------------------------------------------------------------------------------------------------------
--------%%%%%%%%-o-----------------------------------------------------------------------------------oSSSS-----o-------------------S--------------------------------QQQQQS----------------------
---------||||||---------------------------------------------------------------------------------------------------------------------------------------------------------------------------------
---------||||||---------------------------------------------------------------------------------------------------------------------------------------------------------------------------------
---------||||||-----------------------------------------------------------------------------------------------------#---------------------------------------------------------------------------
------%%%%%%%%%%--SoS----------U----------------------------------------------------------------------------------------------------------------------------------------Q----Q-------2----------
-------||||||||--------------------------TT---------------#--------------TT-------------TTT---------------#------------tt----------------TT-------------tt------------------------------TT------
-------||||||||--------------------------TT--------------###-###---------TT-------------TTT---TT---------###-----------tt----TT----------TT-------------tt------------------------B-----TT---TT-
-------||||||||-------k--------S----ggg--TT----------b---###-###--g------TT---k---------TTT---TT---------##-----g------TT----TT----k-ggg-TT-------b-----tt---------g--------------g-----TT---TT-
XXXXXXXXXXXXXXXX-XXXXXXXXX----XXXXXXXXXXXXXXXXXXXXXXXXXXXXXXXXXXXXXXXXXXXXXXXXXXXXXXXXXXXXXXX-XXXXXXXXXXXXXXXXXXXXXXXXXXXXXXXXXXXXXXXXXXXXXXXXXXXXXXXXXXXXXXXXXXXXXXXXXXXXXXXXXXXXXXXXXXXXXXXXXX
XXXXXXXXXXXXXXXX-XXXXXXXXX---XXXXXXXXXXXXXXXXXXXXXXXXXXXXXXXXXX-XXXXXXXXXXXXXXXXX-XXXXXXXXXXX-XXXXXXXXXXXXXXXXXXXXXXXXXXXXXXXXXXXXXXXXXXXXXXXXXXXXXXXXXXXXXXXXXXXXXXXXXXXXXXXXXXXXXXXXXXXXXXXXXX
