------------------------------------------------------------------------------------------------------------------------------------------------------------------------------------------------
------------------------------------------------------------------------------------------------------------------------------------------------------------------------------------------------
------------------------------------------------------------------------------------------------------------------------------------------------------------------------------------------------
----------------------------------------------------------------------------------------------------------------SSSSSSSSSSSSSSS-SSSSSSSS------------------------SSSSSSS-------------------------
------------------------------------------------------------------------------------------------------------------------------------------------------------------------------------------------
----------------------------oo------------------------------------------------------------------------------------------------------------------------------------------------------------------
--------%%%%%%%%--------------------------------oooo---SSo----------------------------SSSS-----S------------------------------------------------SoQS@SQSSSS--SSS-----------------o--------------
---------||||||------------------------------------------------------------------------------------------------o--------------------------------------------------------------------------------
---------||||||---------------------------------------------------------------------------------------------------------------------------------------------------------------------------------
---------||||||------------o---------------------------------------------------------------------------------------------------------------------------k----------------------------------------
------%%%%%%%%%%------SS%%%S---------------------------------------------------------------------------------#----------------------------------Q-QQQ--US----USS--------------------------------
-------||||||||----------|---o---------U------#-------------------------TT--------------------#--------TT---##-----------TT---------------------------------------------TT----------------------
-------||||||||----------|---%---------------##-----tt------------B-----TT----TT-------------##--------TT--###-------B---TT-----------tt--------------------------B-----TT----------------------
-------||||||||----------|---|----gg--------###g----tt----------k-b-----TT----TT---ggg-------###g-g----TT--###----k--b---TT---k-------tt----gggg---ggg------------b-----TT----g-----------#-----
XXXXXXXXXXXXXXXX--%%%%---|---|--XXXXXXXXXXXXXXXXXXXXXXXXXXXXXXXXXXXXXXXXXXXXXXXXXXXXXXXXXXXXXXXXXXXXXXXXXXXXXXXXXXXXXXXXXXXXXXXXXXXXXXXXXXXXXXXXXXXXXXXXXXXXXXXXXXXXXXXXXXXXXXXXXXXXXXXXXXXXXXXX
XXXXXXXXXXXXXXXX---||----|---|--XXXXXXXXXXXXXXXXXXXXXXXXXXXXXXXXXXXXXXXXXXXXXXXXXXXXXXXXXXXXXXXXXXXXXXXXXXXXXXXXXXXXXXXXXXXXXXXXXXXXXXXXXXXXXXXXXXXXXXXXXXXXXXXXXXXXXXXXXXXXXXXXXXXXXXXXXXXXXXXX
