------------------------------------------------------------------------------------------------------------------------------------------------------------------------------------------------
------------------------------------------------------------------------------------------------------------------------------------------------------------------------------------------------
------------------------------------------------------------------------------------------------------------------------------------------------------------------------------------------------
------------------------------------------------------------------------------------------------------------------------------------------------------------------------------------------------
------------------------------------------------------------------------------------------------------------------------------------------------------------------------------------------------
---------------------------------------------------------------------k-----------------------------------------------------------------------S---------------o----------------------------------
--------%%%%%%%%---r--r--------------------------------------------SSSS------------------------------------SSS-------SSS-----------SSSSSSS--SSSS-SSoSSSSS---SS------------------------------SS--
---------||||||-%%%%%%%%%%-----------------------------------------------------------------------------------------------------------SS----------------------------------SS---------------o-----
---------||||||--||||||||-----------------K------------------------SS------------------SSS-----------------------------------------S------------------------------------SS----------------------
---------||||||--||||||||--------------------------------SS--------S------------------------------------oo-------------------------oo------------------------------------SS---------------------
------%%%%%%%%%%oR|||||||-------------------------------------#----SSS------------SSS--------#---------------------Q--------------SSSS-------------SSQ------------S-----------------------------
-------||||||||--||||||||--------------------##---------------#---------------------K-------###---------------TT-------------------------TT--------------TT------------TT---------------------TT
-------||||||||--||||||||---TT---------TT---###---------------#----------------------------####---------------TT-------------------------TT--------------TT------------TT---------------------TT
-------||||||||--|||y||k|y--TT-k-kkk---TT-k-###-------------kk#----kk----k--------------y-#####----------k----TT---ggg-g-k---------kk--k-TT----T-----y-k-TT------------TT-kkkk----------------TT
XXXXXXXXXXXXXXXXXXXXXXXXXXXXXXXXXXXXXXXXXXXXXXXXXXXXXXXXXXXXXXXXXXXXXXXXXXXXXXXXXXXXXXXXXXXXXXXXXXXXXXXXXXXXXXXXXXXXXXXXXXXXXXXXXXXXXXXXXXXXXXXXXXXXXXXXXXXXXXXXXXXXXXXXXXXXXXXXXXXXXXXXXXXXXXXX
XXXXXXXXXXXXXXXXXXXXXXXXXXXXXXXXXXXXXXXXXXXXXXXXXXXXXXXXXXXXXXXXXXXXXXXXXXXXXXXXXXXXXXXXXXXXXXXXXXXXXXXXXXXXXXXXXXXXXXXXXXXXXXXXXXXXXXXXXXXXXXXXXXXXXXXXXXXXXXXXXXXXXXXXXXXXXXXXXXXXXXXXXXXXXXXX
