------------------------------------------------------------------------------------------------------------------------------------------------------------------------------------------------
------------------------------------------------------------------------------------------------------------------------------------------------------------------------------------------------
------------------------------------------------------------------------------------------------------------------------------------------------------------------------------------------------
-----------------------------------------------------------------------------------------------------------------------------------------------------------------------------------S------------
------------------------------------------------------------------------------------------------------------------------------------------------------------------------------------------------
------------------o-----------o-----------------------------------------------------------------------------------------------------------o-----------------------------------------------------
--------%%%%%%%%-------------------------------------------------------------------------------o----------------------SSS------------------------------Q-------------------------oo-------------
---------||||||--------------oo---------------------------------------------------------------------------------------------------------------o-------------------------------------------------
---------||||||---------------------------------------------------------------------------------------------------------------------------------------------------------------------------------
---------||||||----------ooo--------------------------------------------------------------------------------------------------------------------------------------------------------------------
------%%%%%%%%%%---------%%%-----------------------------------------------------------------------------------------------------------------------------------------2------#-------------------
-------||||||||---TT------|-------------TT-------------------------------------------------------------tt-------------------------------------------------------------------#-------------------
-------||||||||---TT------|-------B-----TT----#--------------------------TT----------------------------tt----TT------tt---------------tt--------------------------------tt--#-@-----tt----#-----
-------||||||||---TT------|----o--b-----TT----#----------------g-----k---TT------------------kgg--b----tt----TT------tt---------------tt-----k----ggg--k-----g-g--------tt--###-----tt---##-----
XXXXXXXXXXXXXXXX--XXXXXXX%|--%%%XXXXXXXXXXXXXXXXXXXXXXXXXXXXXXXXXXXXXXXXXXXXXXXXXXXXXXXXXXXXXXXXXXXXXXXXXXXXXXXXXXXXXXXXXXXXXXXXXXXXXXXXXXXXXXXXXXXXXXXXXXXXXXXXXXXXXXXXXXXXXXXXXXXXXXXXXXXXXXXX
XXXXXXXXXXXXXXXX--XXXXXX-||---|-XXXXXXXXXXXXXXXXXXXXXXXXXXXXXXXXXXXXXXXXXXXXXXXXXXXXXXXXXXXXXXXXXXXXXXXXXXXXXXXXXXXXXXXXXXXXXXXXXXXXXXXXXXXXXXXXXXXXXXXXXXXXXXXXXXXXXXXXXXXXXXXXXXXXXXXXXXXXXXXX
