------------------------------------------------------------------------------------------------------------------------------------------------------------------------------------------------
------------------------------------------------------------------------------------------------------------------------------------------------------------------------------------------------
------------------------------------------------------------------------------------------------------------------------------------------------------------------------------------------------
--------------------------------SSSSSSSSSSSSSSSS----------------SS--------------SSSSSSSSS---------------------------------------SSSS--------------------------------------------SSSSSSSSSSSSSS--
---------------------------------S----------------------------------------------------------------------------o---------------------------------------------------------------------------------
------------------------------------------------------------------------------------------------------------------------------------------------------------------------------------------------
--------%%%%%%%%-------------------------------S----SSSSSS---SSS----------------oooo---Soo---SSo-oo-QQSSSS---S@S---------------U----------------oooSSSSSS----SSS--------------------------------
---------||||||---------------------------------------------------------------------------------------------------------------------------------------------------------------------------------
---------||||||----------------------------y----------------------------------------------------------------------------------------------------------------------------------------------------
---------||||||----------------------------#----------------------------------------------------------------------------------------------------o--------------o--------------------------------
------%%%%%%%%%%---------------------------#--------SSSSS---S@S---------------------tt----------#-QQQ--------US-------------S@S-------------------------------S----------------o----------------
-------||||||||--------------------------###----------------------------------------tt-----------------------------------TT-------------------------------------------------------------------TT
-------||||||||---------------------tt---###-----------------------------TT---TT----tt-----------------------------------TT-------------------TT----------------------------------------TT----TT
-------||||||||-----------k-k-------tt--####-------gggg-----------g----k-TT---TT----tt---##---------gg------------gggggg-TT------------k-k----TT-----gk---k-k------ggg---------k--g-----TT----TT
XXXXXXXXXXXXXXXXXXXXXXXXXXXXXXXXXXXXXXXXXXXXX-XXXXXXXXXXXXXXXXXXXXXXXXXXXXXXXXXXXXXXXXXXXXXXXXXXXXXXXXXXXXXXXXXXXXXXXXXXXXXXXXXXXXXXXXXXXXXXXXXXXXXXXXXXXXXXXXXXXXXXXXXXXXXXXXXXXXXXXXXXXXXXX-XX
XXXXXXXXXXXXXXXXXXXXXXXXXXXXXXXXXXXXXXXXXXXXX-XXXXXXXXXXXXXXXXXXXXXXXXXXXXXXXXXXXXXXXXXXXXXXXXXXXXXXXXXXXXXXXXXXXXXXXXXXXXXXXXXXXXXXXXXXXXXXXXXXXXXXXXXXXXXXXXXXXXXXXXXXXXXXXXXXXXXXXXXXXXXXX-XX
