-----------------------K------------------------------------------------------------------------------------------------------------------------------------------------------------------------
-----------------------o------------------------------------------------------------------------------------------------------------------------------------------------------------------------
----------------------%%%-----------------------------------------------------------------------------------------------------------------------------------------------------------------------
-----------------------|-----------------------------------------S-----------------------------------------------SSSSS----------------------------------------------SSS-------------------------
-----------------------|------------------------------------------------------------------------------------------------------------------------------------------------------------------------
-----------------------|-------o----------------------------------------------------------------------------------------------------------------------------------------------------------------
--------%%%%%%%%-------|-------%----------------oooo--SSoS---SSS--------------------QQQQQSS--S@S-----------------------SSo----------------------S-------oS---SSS----------------------SQo-------
---------||||||--------|-------|----------------------------------------------------------------------------------------------------------------------------------------------------------------
---------||||||--------|-------|-----------------------------------------------------------------------------------------------------------------------------o----------------------------------
---------||||||--------|-------|----------------o-----------------------------------------------------------------------------------------------------------------------------------------------
------%%%%%%%%%%-------|-%%%%--|--------------------o---------S-----------------------QQQ---SQ-----------TT---------------------------tt--------------------S@S------------------------------o--
-------||||||||--------|--||--oo---------TT--------------------------------------------------------------TT---------------------------tt--------------------------------TTT---------------------
-------||||||||--------|--||-%%%---------TT--------------#--------B-----TT-------------------------------TT---------tt----------------tt--------------------------B-----TTT--TT-###-------------
-------||||||||-----r--|--||--|---g------TT-------------###-------b-----TT---gg----k--------k-----bk-----TT---------tt----------------tt---kgggg---kgggg----------b-----TTT--TT-###--kk-----k---
XXXXXXXXXXXXXXXX%%%%%%%%%-||--|-XXXXXXXXXXXXXXXXXXXXXXXXXXXXXXXXXXXXXXXXXXXXXXXXXXXXXXXXXXXXXXXXXXXXXXXXXXXXXXXXXXXXXXXXXXXXXXXXXXXXXXXXXXXXXXXXXXXXXXXXXXXXXXXXXXXXXXXXXXXXXXXXXXXXXXXXXXXXXXXX
XXXXXXXXXXXXXXXX-|||||||--||--|-XXXXXXXXXXXXXXXXXXXXXXXXXXXXXXXXXXXXXXXXXXXXXXXXXXXXXXXXXXXXXXXXXXXXXXXXXXXXXXXXXXXXXXXXXXXXXXXXXXXXXXXXXXXXXXXXXXXXXXXXXXXXXXXXXXXXXXXXXXXXXXXXXXXXXXXXXXXXXXXX
