------------------------------------------------------------------------------------------------------------------------------------------------------------------------------------------------
------------------------------------------------------------------------------------------------------------------------------------------------------------------------------------------------
--------------------------------------------------------------------------------------------------------------------------------t---------------------------------------------------------------
--------------------------------------------------------------------------------------------------------------------------------t---------------------------------------------------------------
-------------------------------------------------------------------------------------------------------------------k------------t---------------------------------------------------------------
------------------------------------------------------------------------------------------------------------------##------------t---------------------------------------------------------------
--------%%%%%%%%---------------------------------SSS--------------------------------------------SS------------------------------SSS------------o---------------o-------------o--SS%-------------
---------||||||-------------------------------------------------------------------------oo------------------------------ooo----------oo----------------------------------oo-------|--o----------
---------||||||-------------------------------------------------------------------------------------------------------------------------------------------------------------------|-------------
---------||||||--------------------------SSS--------------------------------------------------------------------------------------------------------------------------------------|-------------
------%%%%%%%%%%--S-----oSSSQ-----------------#--------------------------------------------------------------------------------------------------------------------S--------------|-------------
-------||||||||------------------------TT-----#-T--------TT---------tt----------------------------------------------tt----------TT-------TT---------tt-----tt-----------------TT--TT------------
-------||||||||------------------------TT-----#-T-----B--TT---------tt-TT--tt-------------------------tt------------tt--T-------TT----tt-TT---------tt-----tt-----------------TT-TTT--tt--#-----
-------||||||||---------g-g-------K----TT---kk#-T-----b-kTT----yK---tt-TT--t--#-----------------------tt----ggggg---tt----------TT----ttkTT----Tg---tt-----tt-----ggy---------TT-TTT--tt-TT---gg
XXXXXXXXXXXXXXXXgXXXXXXXXXXXXXXXXXXXXXXXXXXXXXXXXXXXXXXXXXXXXXXXXXXXXXXXXXXXXXXXXXXXXXXXXXXXXXXXXXXXXXXXXXXXXXXXXXXXXXXXXXXXXXXXXXXXXXXXXXXXXXXXXXXXXXXXXXXXXXXXXXXXXXXXXXXXXXXXXXXXXXXXXXXXXXXX
XXXXXXXXXXXXXXXXXXXXXXXXXXXXXXXXXXXXXXXXXXXXXXXXXXXXXXXXXXXXXXXXXXXXXXXXXXXXXXXXXXXXXXXXXXXXXXXXXXXXXXXXXXXXXXXXXXXXXXXXXXXXXXXXXXXXXXXXXXXXXXXXXXXXXXXXXXXXXXXXXXXXXXXXXXXXXXXXXXXXXXXXXXXXXXXX
