----------------------------------------------------------------------------------%%------------------------------------------------------------------------------------------------------------
----------------------------------------------------------------------------------||------------------------------------------------------------------------------------------------------------
----------------------------------------------------------------------------------||------------------------------------------------------------t-----------------------------------------------
----------------------------------------------------------------------------------||------------------------------------------------------------------------------------------------------------
-----------------------------------g----------------------------------------------||-------------------------------k----------------------------------------------------------------------------
---------------------------------###-------------------------------------------o--##------------------------------##----------------------------------------------------------------------------
--------%%%%%%%%------ooooo----%--------------------------------S%SSS---------------------------SS----S-----------------------------------------SS-------------------------------------------Q-o
---------||||||---------------y|--------oooo---------------------|-----------------------ooo----------------------------oooo------------oooo--------ooo------------------SSS--------------------
---------||||||--------SSSSS-g-|--------------------------%------|------------------------------------------------------------------------------------------------------SS----------------------
---------||||||-------------y#-|--------------------------|------|-----------------------SS-------------------------------S---------------------------------------------SSSS--------------------
------%%%%%%%%%%o---SSSSS---##-|--------------------------|------|---------------------------------------TT--------------------------------------T------------------------------QS--------------
-------||||||||------------###-|-----------------------TT-|------|-------TT------------TT----------------TT------------TT-----------------------TT-------TT---------tt-TT----------------TT-----
-------||||||||-----------####-|-------TT--------------TT-|------|-------TT---------tt-TT----------------TT---------tt-TT-----------------------TT----tt-TT---------tt-TT----------------TT-----
-------||||||||----------#####-|--g----TT-k---------g--TT-|--k---|----g-kTT----y----tt-TT----k-------y---TT---------tt-TT-----------------k---T-TT----ttkTT----g----tt-TT---kk#----------TT-----
XXXXXXXXXXXXXXXXXX--XXXXXXXXXX-XXXXXXXXXXXXXXXXXXXXXXX-XXXXXXXXXXXXXXXXXXXXXXXXXXXXXXXXXXXXXXXXXXXXXXXXXXXXXXXXXXXXXXXXXXXXXXXXXXXXXXXXXXXXXXXXXXXXXXXXXXXXXXXXXXXXXXXXXXXXXXXXXXXXXXXXXXXXXXXXX
XXXXXXXXXXXXXXXXX---XXXXXXXXXX-XXXXXXXXXXXXXXXXXXXXXXX-XXXXXXXXXXXXXXXXXXXXXXXXXXXXXXXXXXXXXXXXXXXXXXXXXXXXXXXXXXXXXXXXXXXXXXXXXXXXXXXXXXXXXXXXXXXXXXXXXXXXXXXXXXXXXXXXXXXXXXXXXXXXXXXXXXXXXXXXX
