------------------------------------------------------------------------------------------------------------------------------------------------------------------------------------------------
------------------------------------------------------------------------------------------------------------------------------------------------------------------------------------------------
------------------------------------------------------------------------------------------------------------------------------------------------------------------------------------------------
---------------------------------------------------------------------#--------------------------------------------------------------------------------------------------------------------------
------------------------------------------------------------------#g##------------------------------------------------------------------------------------------##------------------------------
--------------------------------------------------%--------------###--------------------------------------------------------------------------------------------##------------------------------
--------%%%%%%%%----Q-------US-o------------------|---r-------------------------------@-----SS--SSS------S-------------@-------US-----------------------------------------------SS--------------
---------||||||---------------------------------%-%%%%%%%---------------------------------------------------------------------------------------------------------SSS----oo--------ooo----------
---------||||||---------------------------------|--|||||------------------------------------------------------------------------------------------------SS--------------------------------------
---------||||||---------------------------------|--|||||------------------S------------------------------------------------------------------------------SS-------------------------------------
------%%%%%%%%%%-Q-Q-----------------------S----|--|||||---------------------------Q------------TT----------------------------QQ--TT--------------S-----------------TT--------TTTT--------------
-------||||||||---------------------------------|--|||||-TT-TT---------TT----------------TT---TTTT-------TT-----------------------TT-----TT------K-----TT-----------TT--------TTTT-------TT-----
-------||||||||---------------------------------|--|||||-TT-TT---------TT----------------TT---TTTT----tt-TT----------------B------TT-----TT----T----tt-TT-----------TT---TT---TTTT----tt-TT-----
-------||||||||----g-----------T----------------|--||||k-TT-TT---------TT----------ggg-k-TT---TTTT----tt-TT----T-----------b--g---TT-----TT----T--K-tt-TT-----------TT---TT---TTTTT---tt-TT----g
XXXXXXXXXXXXXXXXXXXXXXXXXXXXXXXXXXXXXXXXXXXXXXXXXXXXXXXXXXXXXXXXXXXXXXXXXXXXXXXXXXXXXXXXXXXXXXXXXXXXXXXXXXXXXXXXXXXXXXXXXXXXXXXXXXXXXXXXXXXXXXXXXXXXXXXXXXXXXXXXXXXXXXXXXXXXXXXXXXXXXXXXXXXXXXXX
XXXXXXXXXXXXXXXXXXXXXXXXXXXXXXXXXXXXXXXXXXXXXXXXXXXXXXXXXXXXXXXXXXXXXXXXXXXXXXXXXXXXXXXXXXXXXXXXXXXXXXXXXXXXXXXXXXXXXXXXXXXXXXXXXXXXXXXXXXXXXXXXXXXXXXXXXXXXXXXXXXXXXXXXXXXXXXXXXXXXXXXXXXXXXXXX
