------------------------------------------------------------------------------------------------------------------------------------------------------------------------------------------------
------------------------------------------------------------------------------------------------------------------------------------------------------------------------------------------------
------------------------------------------------------------------------------------------------------------------------------------------------------------------------------------------------
---------------------------------SSSS-----------------------------------------------------------SSSSSSSSSSS--SSS---------------------------------SSSSSSS-S--------------------------------------
------------------------------------------------------------------------------------------------------------------------------------------------------------------------------------------------
------------------------------------------------------------------------------------------------------------------------------------------------------------------------------------------------
--------%%%%%%%%SSSSQSSSSSSSSSSS----------------------SSSS---------------------S-oo-----oo-----o--------------------QQQQQS----@-----------------------------------------------------QQQ-------SS
---------||||||---------------------------------------oo----------------------------------------------------------------------------------------------------------------------------------------
---------||||||-----------------------------------------------------B---------------------------------------------------------------------------------------------------------------------------
---------||||||----------------------------------------------------------------------------###-------------------------------S---------------------------------------------------o--------------
------%%%%%%%%%%#---QS-S-----SSS-----------------------------o--------------##-----------######-----------------Q-Q----QQ----Q--------------------------------------------------------------S@S-
-------||||||||---------------------------------------t---------------------#------------######-------t----------------------------------TT----------t----------------tt------------------------
-------||||||||--------------------------K----T------tt-------------------###-----------#######------t---B----TT---K---------------------TT---------tt---##-----------tt------------------------
-------||||||||----k--g-----k-----y--#ty------gT----ktt-----kkk---g----b--###-#-------g#########--b--ttk-b----gT---U--------------g------TT---------tt---##---g-------tt-----g-g--gggggg--k-----
XXXXXXXXXXXXXXXXXXXXXXXXXXXXXXXXXXXXXXXXXXXXXXXXXXXXXXXXXXXXXXXXXXXXXXXXXXXXXXXXXXXXXXXXXXXXXXXXXXXXXXXXXXXXXXXXXXXXXXXXXXXXXXXXXXXXXXXXXXXXXXXXXXXXXXXXXXXXXXXXXXXXXXXXXXXXXXXXXXXXXXXXXXXXXXXX
XXXXXXXXXXXXXXXXXXXXXXXXXXXXXXXXXXXXXXXXXXXXXXXXXXXXXXXXXXXXXXXXXXXXXXXXXXXXXXXXXXXXXXXXXXXXXXXXXXXXXXXXXXXXXXXXXXXXXXXXXXXXXXXXXXXXXXXXXXXXXXXXXXXXXXXXXXXXXXXXXXXXXXXXXXXXXXXXXXXXXXXXXXXXXXXX
