------------------------------------------------------------------------------------------------------------------------------------------------------------------------------------------------
------------------------------------------------------------------------------------------------------------------------------------------------------------------------------------------------
------------------------------------------------------------------------------------------------------------------------------------------------------------------------------------------------
----------------------------------------------------------------------------------------------------------------SSSSSS------------------------------------------SSSSSSSS--------SSS-------------
------------------------------------------------------------------------------------------------------------------------------------------------------------------------------------------------
------------------------------------------------------------------------------------------------------------------------------------------------------------------------------------------------
--------%%%%%%%%----------------Sooo----------------QQQ-------------------------------------------SQS----------o--------------------QQQQQSSSSS@------------------oo----ooo-----o----------------
---------||||||-------------------------------------------------SS------------------------------------------------------------------------------------------------------------------------------
---------||||||----------------------------------------------oo---------------------------------------------------------------------------------------------------------------------------------
---------||||||---------------------------------------------------------------------------------------------------------------------------------------------------------------------------------
------%%%%%%%%%%---------%-------S---------------#---------SS@S------------------------------o----Q------------------------------------QQQ--SQ-----------TT--#----------------------------------
-------||||||||----------|---------------------------------------------tt----#-------ttt-----------------------------------------------------------------TT-------------------------------------
-------||||||||----------|---------------------------------------------tt----#-------ttt-----------------##----------ttt---#-----------------------------TT---------tt---##-----------tt--------
-------||||||||---gggg---|---------g------k--------k-ggg----k----------tt---##g------ttt-----g-----k--gg###----------ttt---#--g----#--------k-----kk-----TT---#-----tt---##-----------tt-----ggg
XXXXXXXXXXXXXXXXXXXXXXXXXXXXXX--XXXXXXXXXXXXXXXXXXXXXXXXXXXXXXXXXXXXXXXXXXXXXXXXXXXXXXXXXXXXXXXXXXXXXXXXXXXXXXXXXXXXXXXXXXXXXXXXXXXXXXXXXXXXXXXXXXXXXXXXXXXXXXXXXXXXXXXXXXXXXXXXXXXXXXXXXXXXXXXX
XXXXXXXXXXXXXXXXXXXXXXXXXXXXX---XXXXXXXXXXXXXXXXXXXXXXXXXXXXXXXXXXXXXXXXXXXXXXXXXXXXXXXXXXXXXXXXXXXXXXXXXXXXXXXXXXXXXXXXXXXXXXXXXXXXXXXXXXXXXXXXXXXXXXXXXXXXXXXXXXXXXXXXXXXXXXXXXXXXXXXXXXXXXXXX
