--------------------------------------------------------------------------------------------------------------------------------------------------------------------------------
--------------------------------------------------------------------------------------------------------------------------------------------------------------------------------
--------------------------------t-------------------------------------------------------------------------------------------------------------------------------t---------------
--------------------------------t-------------------------------------------------------------------------------------------------------------------------------t---------------
--------------------------------t-------------------------------------------------------------------------------------------------------------------------------t---------------
--------------------------------t-----------------------------------------------------------o-------------------------------------------------------------------t---------------
--------------------------------SS----------------------------------------------------------------------------------------------%%--------------%%%-------------SS-------------o
--------oo----U---------------------oo------------------------------------------------------------------------------------ooo---||---------------|------------------------------
------%%%%%%--------------------------------------------------------------------------------------------------------------------||---------------|------------------------------
-------||Q|---rS----------------------------------------------------------------------------------------------------------------||---------------|------------------------------
--%%%--||-|---%%------------------T-------------------------------TT--------TT--------------------------------------------------||TT-------------|TT--------------TT--Q---------
---|---||-|---||------------TT----TT--------------TT--------------TT--------TT----TT--------------TT---TT--------------TT-------||TT-------------|TT--------TT----TT------------
---|---||-|---||------------TT---TTT--tt----------TT--------##----TT--------TT----TT--------------TT---TT---------T----TT-------||TT-------------|TT--------TT----TT------------
---|---||-|---||--------g---##---TTT--tt-------g--TT--------##----TT------k-TT----TT--------------TT---TT---------T----TT-------||TT-----------g-|TT-#------TT-k--TT----------g-
---|---||-|---||XXXXXXXXXXXXXXXXXXXXXXXXXXXXXXXXXXXXXXXXXXXXXXXXXXXXXXXXXXXXXXXX-XXXXXXXXXXXXXXXXXXXXXXXXXXXXXXXXXXXXX-XXXXXXXXXXXXXXXXXXXXXXXXXXXXXXXXXXXXXXXXXXXXXXXXXXXXXXXXX
---|---||-|---||XXXXXXXXXXXXXXXXXXXXXXXXXXXXXXXXXXXXXXXXXXXXXXXXXXXXXXXXXXXXXXXXXXXXXXXXXXXXXXXXXXXXXXXXXXXXXXXXXXXXXX-XXXXXXXXXXXXXXXXXXXXXXXXXXXXXXXXXXXXXXXXXXXXXXXXXXXXXXXXX
