------------------------------------------------------------------------------------------------------------------------------------------------------------------------------------------------
------------------------------------------------------------------------------------------------------------------------------------------------------------------------------------------------
------------------------------------------------------------------------------------------------------------------------------------------------------------------------------------------------
------------------------------------------------SSSSSSSS--------SSSSSSSS------------------------SSSSSSSSSS------SSSSSSSSSSSSSSSS--------------------------------SSSSSSSSSSS-----SSSSSSSSSSSS----
------------------------------------------------------------------------------------------------------------------------------------------------------------------------------------------------
------------------------------------------------------------------------------------------------------------------------------------------------------------------------------------------------
--------%%%%%%%%--------------------QQSSSS-----------------------------SS-S----------SSSSS--------------------------------------SooSSS-------SSS------SS------------------------oooo----oo---SSS
---------||||||-S--%%%%%------------------------------------------------------------------------------------------------------------------------------------------------------------------------
---------||||||-----|||-------------------------------------------------------------------------------------------------------------------------------------------------------------------------
---------||||||-----|||---------------------------------------------------------------------------------------------------------g---------------------------------------------------------------
------%%%%%%%%%%----|||----------------------US------------------------------------------------------------##-------------------S--SS--------SSS------------------------------------------------
-------||||||||-----||tt---------------------------------------------tt------------------------------SS---###-----------------------------------------------------------------------------------
-------||||||||-%---||tt-----#--------------------------------TT-----tt------------------------------SS---###-----------------------------#-----------------------------------TT-----r----------
-------||||||||-|---||tt-----#----gggg----------%%k----k-k----TT-----tt-------------ggg--------------tt---###-##---------k----------gggg-##---------g-k-----kkk---------------TT-----t----#-----
XXXXXXXXXXXXXXXXXXXXXXXXXXXXXXXXXXXXXXXXXXXXXXXXXXXXXXXXXXXXXXXXXXXXXXXXXXXXXXXXXXXXXXXXXXXXXXXXXXXXXXXXXXXXXXXXXXXXXXXXXXXXXXXXXXXXXXXXXXXXXXXXXXXXXXXXXXXXXXXXXXXXXXXXXXXXXXXXXXXXXXXXXXXXXXXX
XXXXXXXXXXXXXXXXXXXXXXXXXXXXXXXXXXXXXXXXXXXXXXXXXXXXXXXXXXXXXXXXXXXXXXXXXXXXXXXXXXXXXXXXXXXXXXXXXXXXXXXXXXXXXXXXXXXXXXXXXXXXXXXXXXXXXXXXXXXXXXXXXXXXXXXXXXXXXXXXXXXXXXXXXXXXXXXXXXXXXXXXXXXXXXXX
