------------------------------------------------------------------------------------------------------------------------------------------------------------------------------------------------
------------------------------------------------------------------------------------------------------------------------------------------------------------------------------------------------
------------------------------------------------------------------------------------------------------------------------------------------------------------------------------------------------
------------------------------------------------------------------------------------------------SSSSSSSS----------------------------------------------------------------------------------------
------------------------------------------------------------------------------------------------------------------------------------------------------------------------------------------------
------------------------------------------------------------------------------------------------------------------------------------------------------------------------------------------------
--------%%%%%%%%-------SSSS---S-------------------------------------QQQQQS-------oo----------ooo----------------S------S----SSSS-----------------oo----Soo---o-o----------------------QQQSS-----
---------||||||---oo--oo-------------------------------o--------------------------------------------------------S-------------------------------------------------------------------------------
---------||||||--------------------------------------------------------------o-----------------S------------------------------------------------------------------------------#-----------------
---------||||||---------------------------------------------------------------------------SS--------------------S------------------------------------------------------------##-----------------
------%%%%%%%%%%-----------S-------------------------------------##----------@S-S--------#----------------------------------------------------------------------------------###-----------------
-------||||||||--------------------------##------------S---------------------------------#-----------------------------------#-----------TT---------------------------------###-----------------
-------||||||||--------------------------##------------S-----K--------------------------##--------------------TT-------------##----------TT---------tt---#-----------------####-----------------
-------||||||||--------------------k---####------------------b-----k--gg----kkkk------####---------------k----TT-------k----###---ggg----TT---------tt---#------g-------g-#####----y--k-----kgkg
XXXXXXXXXXXXXXXX-%%%--XXXXX--XXXXXXXXXXXXXXXXXXXXXXXXXXXXXXXXXXXXXXXXXXXXXXXXXXXXXXXXXXXXXXXXXXXXXXXXXXXXXXXX-XXXXXXXXXXXXXXXXXXXXXXXXXXXXXXXXXXXXXXXXXXXXXXXXXXXXXXXXXXXXXXXXX-XXXXXXXXXXXXXXXX
XXXXXXXXXXXXXXXX--|X--XXXXX--XXXXXXXXXXXXXXXXXXXXXXXXXXXXXXXXXXXXXXXXXXXXXXXXXXXXXXXXXXXXXXXXXXXXXXXXXXXXXXXX-XXXXXXXXXXXXXXXXXXXXXXXXXXXXXXXXXXXXXXXXXXXXXXXXXXXXXXXXXXXXXXXXX-XXXXXXXXXXXXXXXX
