------------------------------------------------------------------------------------------------------------------------------------------------------------------------------------------------
------------------------------------------------------------------------------------------------------------------------------------------------------------------------------------------------
------------------------------------------------------------------------------------------------------------------------------------------------------------------------------------------------
------------------------------------------------SSSSSSS-----------------------------------------SSSSSSSSSSSS----SSSSSSSSSSSSSS--------------------------------------------------SSSSSSSS--------
------------------------------------------------------------------------------------------------------------------------------------------------------------------------------------------------
----------------------------------------------------------------------------------------o-------------------------------------------------------------------------------------------------------
--------%%%%%%%%-------QQSS----S----QQSQQS-----U-----------------------Q-------o------------------o-----------------------SS--SS-----QSS-------S----------------ooo---SSSo-----o----------------
---------||||||--------------------------------------------------------------------------------------------------------------------------------#---------------#--------------------------------
---------||||||------------------------------oo----------------------------------------------------------------------------------------------------------------#----------------#---------------
---------||||||---------------------------------------------------------------------------------o-------------------------------------------------------------##--------------------------------
------%%%%%%%%%%###--2QQ----S@S-QQQ----------@S-----------------#-------------S-----------------------------------------------------------------------------#-##--------------------------------
-------||||||||-------------------------------------------------#-----------------------TT----------------#-------------------------------------------------####----tt--------------------------
-------||||||||---------------------------------------tt--------#-----------------------TT---------------##----------tt----------------------#--------------####----tt---##-----------tt------TT
-------||||||||----k---k----------gggg----k-------#---tt-----ggg#---gk----k-k----gg-----TT---ggg-----k--###----------tt----g------ggg--------##--------k----####----tt--###-------#---tt------TT
XXXXXXXXXXXXXXXXXXXXXXXXXXXXXXXXXXXXXXXXXXXXXXXXXXXXXXXXXXXXXXXXXXXXXXXXXXXXXXXXXXXXXXXXXXXXXXXXXXXXXXXXXXXXXXXXXXXXXXXXXXXXXXXXXXXXXXXXXXXXXXXXXXXXXXXXXXXXXXXXXXXXXXXXXXXXXXXXXXXXXXXXXXXXXXXX
XXXXXXXXXXXXXXXXXXXXXXXXXXXXXXXXXXXXXXXXXXXXXXXXXXXXXXXXXXXXXXXXXXXXXXXXXXXXXXXXXXXXXXXXXXXXXXXXXXXXXXXXXXXXXXXXXXXXXXXXXXXXXXXXXXXXXXXXXXXXXXXXXXXXXXXXXXXXXXXXXXXXXXXXXXXXXXXXXXXXXXXXXXXXXXXX
