------------------------------------------------------------------------------------------------------------------------------------------------------------------------------------------------
------------------------------------------------------------------------------------------------------------------------------------------------------------------------------------------------
----------------------------------------------------------------------------------------------------------------t-------------------------------------------------------------------------------
----------------------------------------------------------------------------------------------------------------t-------------------------------------------------------------------------------
----------------------------------------------------------------------------------------------------------------t-------------------------------------------------------------------------------
----------------------------------------------------------------------------------------------------------------t---------------------------------##--------------------------------------------
--------%%%%%%%%-------------------------------------------------------------------------------------SSSS-------SS-------------------------------------------------------------oSSS---------o---
---------||||||------------------------------------------------------------------------------------------------------oo----------------------------------ooo-------------oo---------oo----------
---------||||||---------------------------------------------------------------------------------------------------------------------------------------------------------------------------------
---------||||||--------r------SS---g---------------------------------------------------------------o-------------------------------------SSS----------------------------------------------------
------%%%%%%%%%%---%%%%%%%---%%---SQQQ--------------------QQ--------------------------------------SQS-----------------------------------------#--------------------Q------------TT--------------
-------||||||||-----|||||----||-------------------TT--------------------------------tt-----------------------------------TT------------TT-----#-----tt-TT--tt-------------------TT----tt-TT-----
-------||||||||-----|||||%%%%%|-------------------TT--------------------------------tt----------------------##--------tt-TT------------TT-----#-----tt-TT--tt------------------TTT----tt-TT----T
-------||||||||-----|||||-|||-|--gggg--g-------k--TT---g-----------------------k----tt-------------gggggg---##--------tt-TT----g-------TT---kk#-----tt-TT--tt------------------TTT----ttkTT----T
XXXXXXXXXXXXXXXX%-%%%%|||%%%%%|--XXXXXXXXXXXXXXXXXXXXXXXXXXXXXXXXXXXXXXXXXXXXXXXXXXXXXXXXXXXXXXXXXXXXXXXXXXXXXXXXXXXXXXXXXXXXXXXXXXXXXXXXXXXXXXXXXXXXXXXXXXXXXXXXXXXXXXXXXXXXXXXXXXXXXXXXXXXXXXX
XXXXXXXXXXXXXXXXg-g|g-|||-g|g-|-XXXXXXXXXXXXXXXXXXXXXXXXXXXXXXXXXXXXXXXXXXXXXXXXXXXXXXXXXXXXXXXXXXXXXXXXXXXXXXXXXXXXXXXXXXXXXXXXXXXXXXXXXXXXXXXXXXXXXXXXXXXXXXXXXXXXXXXXXXXXXXXXXXXXXXXXXXXXXXXX
