------------------------------------------------------------------------------------------------------------------------------------------------------------------------------------------------
------------------------------------------------------------------------------------------------------------------------------------------------------------------------------------------------
------------------------------------------------------------------------------------------------------------------------------------------------------------------------------------------------
------------------------------------------------SSSSSSSSSSSSSSSSSSSSSSSSSSSSS---SSSSSSSS------------------------SSSSSSS-------------------------SSSSSSSS-----SSS----------------SSSSSSS---------
----------------------------------------------------------------------------------------------------------------------------------------------oo------------------------------------------------
------------------------------------------------------------------------------------------------------------------------------------------------------------------------------------------------
--------%%%%%%%%---------------------QQQQS----------------------oooo----oo---------------------------QQ--------------------------oo------o-------------------------------------o----------------
---------||||||---------------------------------------------------------------------------------------------------------------------------------------------------------------------------------
---------||||||---------------------------------S-------------------------------#--------------------------------------------------------------------------------------------##-----------------
---------||||||----------------o---------------------------------------------------------------------------------------------------------------------------------------------##-----------------
------%%%%%%%%%%---------------T-------------------------------------t--------------------------####-------------------------------------##----------------------------------##-----------###---
-------||||||||-T--------b----TT------------------------------T-----tt----------------tt------T------------------------------------------##---------------------------------####----------####--
-------||||||||-T-------TT----TT----------#----------t---b---TTT----tt---#------------tt-----TTT-----------------------ttt---K----------###-------B-----TT----TT---------#######-------tTT###T--
-------||||||||-T---ggk-TT--k-TT--gkoggg--#-k--------t---b---TTT----tt--###-----k-----tt-----TTT---k--gg----kk--------tttt---#g-----ggg####-----k-b-----TT----TT----gt---#######------tttT#####-
XXXXXXXXXXXXXXXXXXXXXXXXXXXXXXXXXXXXXXXXXXXXXXXXXXXXXXXXXXXXXXXXXXXXXXXXXXXXXXXXXXXXXXXXXXXXXXXXXXXXXXXXXXXXXXXXXXXXXXXX%XXXXXXXXXXXXXXXXXXXXXXXXXXXXXXXXXXXXXXXXXXXXXXXXXXXXXXXXXXXXXXXXXXXXXXX
XXXXXXXXXXXXXXXXXXXXXXXXXXXXXXXXXXXXXXXXXXXXXXXXXXXXXXXXXXXXXXXXXXXXXXXXXXXXXXXXXXXXXXXXXXXXXXXXXXXXXXXXXXXXXXXXXXXXXXXXXXXXXXXXXXXXXXXXXXXXXXXXXXXXXXXXXXXXXXXXXXXXXXXXXXXXXXXXXXXXXXXXXXXXXXXX
