--------------------------------------------------------------------------------------------------------------------------------------------------------------------------------
--------------------------------------------------------------------------------------------------------------------------------------------------------------------------------
--------------------------------------------------------------------------------------------------------------------------------------------------------------------------------
--------------------------------------------------------------------------------------------------------------------------------------------------------------------------------
--------------o-----------------------------------------------------------------------------------------------------------------------------------------------------------------
------------------------------------------------------------------------------------------------------------------------------o-------------------------------------------------
--S-SSSSSSSS--SSQ------S------------Q--SS------------SSSSSS------------------------SSSS----------------------------SSSS-----------------------------------------SSS-------------
-------------------------------------------------------------------------------------------------------------------------------------------------------------------oooo---------
-----S-SSSS---------------------------------------------------------------------------------------------------------------------------------------------------------------------
------------------------------------------oo------------------------------------------------------------SSSS-----------------------------SS-------------------------------------
----------SSSS-S---Q----@---------------------#----S-Q-------#----SS---------------S--------------------------#----SS-------------------------------------------TT-------TT-----
---------------------------------------------##-------------##--------------TT--------------------------------#----------TT---------tt--------------------------TT-------TT-----
---S----------------------------------------###-------------##--------------TT--------------------------------#----------TT---------tt-TT-----#----------TT----TTT----B--TT----T
-----k----------------------##-------gg----#####---k---g--#-##----y-g--kkk--TT-----k------------------------kk#----ggg-k-TT---------tt-TT-----#----------TT----TTT------kTT----T
XXXXXXXXXXXXXXXXXXXXXXXXXXXXXXXXXXXXXXXXXXXXXXXXXXXXXXXXXXXXXXXXXXXXXXXXXXXXXXXXXXXXXXXXXXXXXXXXXXXXXXXXXXXXXXXXXXXXXXXXXXXXXXXXXXXXXXXXXXXXXXXXXXXXXXXXXXXXXXXXXXXXXXXXXXXXXXXX
XXXXXXXXXXXXXXXXXXXXXXXXXXXXXXXXXXXXXXXXXXXXXXXXXXXXXXXXXXXXXXXXXXXXXXXXXXXXXXXXXXXXXXXXXXXXXXXXXXXXXXXXXXXXXXXXXXXXXXXXXXXXXXXXXXXXXXXXXXXXXXXXXXXXXXXXXXXXXXXXXXXXXXXXXXXXXXXX
