------------------------------------------------------------------------------------------------------------------------------------------------------------------------------------------------
------------------------------------------------------------------------------------------------------------------------------------------------------------------------------------------------
------------------------------------------------------------------------------------------------------------------------------------------------------------------------------------------------
----------------------------------------------------------------SSSSSSSSSS--------------------------------------SSSSSSSS----------------------------------------SSSSSSSSSSSSSSSS----------------
------------------------------------------------------------------------------------------------------------------------------------------------------------------------------------------------
------------------------------------------------------------------------------------------------------------------------------------------------------------------------------------------------
--------%%%%%%%%-@S@QSSSQ----S------------------------ooo----------------------------QQQ----------------oo----So------------------------Q----------------------U----------------------SSS-------
---------||||||---------------------------------------------------------------------------------------------------------------------------------------------------------------------------------
---------||||||----------------------------------------------------------------------------------------------------------------------------------------------o----------------------------------
---------||||||--------g------------------------------------------------------------------------------------------------------------------------------------------------------------------------
------%%%%%%%%%%----SSSS-----SSS----------------#----QQQQ----o-------------------------------o-------o---------------------###---------------o---------------@S---------------------------------
-------||||||||---------------------------------#------------------------TT-----------------------------------------------#####---------------------------K---------------#---------------------
-------||||||||---------------------------------#-----------------B--B---TT---TT-------------------------------------#---######---------------------------#----------B---##----------tt---------
-------||||||||----k--k---k-------gggg------k---#-----------kk----b--b---TT---TT---k-kg------------kgg------k-k------#---######---g----k----kkk---ggggg---#----------b---##---g------tt---------
XXXXXXXXXXXXXXXXXXXXXXXXXXX-XXXXXXXXXXXXXXXXXXXXXXXXXXXXXXXXXXXXXXXXXXXXXXXXXXXXXXXXXXXXXXXXXXXXXXXXXXXXXXXXXXXXXXXXXXXXXXXXXXXXXXXXXXXXXXXXXXXXXXXXXXXXXXXXXXXXXXXXXXXXXXXXXXXXXXXXXXXXXXXXXXXX
XXXXXXXXXXXXXXXXXXXXXXXXXXX-XXXXXXXXXXXXXXXXXXXXXXXXXXXXXXXXXXXXXXXXXXXXXXXXXXXXXXXXXXXXXXXXXXXXXXXXXXXXXXXXXXXXXXXXXXXXXXXXXXXXXXXXXXXXXXXXXXXXXXXXXXXXXXXXXXXXXXXXXXXXXXXXXXXXXXXXXXXXXXXXXXXX
