------------------------------------------------------------------------------------------------------------------------------------------------------------------------------------------------
------------------------------------------------------------------------------------------------------------------------------------------------------------------------------------------------
--------------------------------------------------------------------------------t---------------------------------------------------------------------------------------------------------------
--------------------------------------------------------------------------------t---------------------------------------------------------------------------------------------------------------
--------------------------------------------------------------------------------t----------------------------------k----------------------------------------------------------------------------
------------------------------------------------------------------------------------------------------------------##-------------------------------#--------------------------------------------
--------%%%%%%%%------------SSS-------------SS--SS-----SS-----------------------SS%------------------------------------------o--S-------------------------------U-------------------------------
---------||||||----------SSSSSS-----------------------%%--------------------------|-ooo------------------ooo-------------oo---------o-------------------ooo-----R------------------------ooo----
---------||||||---y--------S-S------------------------||--------------------------|-------------------------------------------------------------------------------------------------------------
---------||||||--KSSS--SSSSSSS------------------------||--------------------------|-------------------------------------------------------------------------------------------------------------
------%%%%%%%%%%--------------------------------------||-@------------------------|--------------------TT----------------------------------------------------------------TT---------------------
-------||||||||-SSS-----------TT--------------TT------||--------------------TT----TT-----TT------------TT---------------------TT--------------------tt-TT---------TT-----TT-TT---------TT-------
-------||||||||---------------TT--------------TT------||--------------------TT---TTT-----TT------------TT---------------------TT--------------------tt-TT---------TT-----TT-TT---------TT-------
-------||||||||-----------kkk-TT--------------TT----gg||-------k--g---------TT---TTT--g-kTT----g-------TT---------------------TT----------y-gggg----tt-TT---------TT-----TT-TT-k--k----TT-------
XXXXXXXXXXXXXXXXXXX-----XXXXXXXXXXXXXXXXXXXXXXXXXXXXXXXXXXXXXXXXXXXXXXXXXXXXXXXXXXXXXXXXXXXXXXXXXXXXXXXXXXXXXXXXXXXXXXXXXXXXXXXXXXXXXXXXXXXXXXXXXXXXXXXXXXXXXXXXXXXXXXXXXXXXXXXXXXXXXXXXXXXXXXXX
XXXXXXXXXXXXXXXXXXX------XXXXXXXXXXXXXXXXXXXXXXXXXXXXXXXXXXXXXXXXXXXXXXXXXXXXXXXXXXXXXXXXXXXXXXXXXXXXXXXXXXXXXXXXXXXXXXXXXXXXXXXXXXXXXXXXXXXXXXXXXXXXXXXXXXXXXXXXXXXXXXXXXXXXXXXXXXXXXXXXXXXXXXX
