------------------------------------------------------------------------------------------------------------------------------------------------------------------------------------------------
------------------------------------------------------------------------------------------------------------------------------------------------------------------------------------------------
------------------------------------------------------------------------------------------------------------------------------------------------------------------------------------------------
------------------------------------------------SSSSSSSSSSSSSSSS--------------------------------SSSSSSSSSSSSSS--SSSSSSSSSSSSSSSS----------------SSSSSSSSSSSSSSSSSSSSSSSSSSSSSSS-SSS-------------
------------------------------------------------S---------------------------------------------------------------S-------------------------------------------------------------------------------
------------------------------------------------------------------------------------------------------------------------------------------------------------------------------------------------
--------%%%%%%%%--------SS--------------oo----------------SS--So---------------------------------oo------o---------------------S-----SQSSSS--SSS-----------------o------------------------------
---------||||||---------------------------------------------------------------------------------------------------------------------------------------------------------------------------------
---------||||||---------------------------------------------------------------------------------------------------------------------------------------------------------------------------------
---------||||||--------------------------------------------##----o------------------------------o----------------------------------------------------------#------------------------------------
------%%%%%%%%%%-------------S----------------------------###----------------o--------------###-----------#----------------------------QQ----o------------####-------tt-------------------------
-------||||||||------------------------------------------####----------------------------#--###----------##-----------------------------------------------####-------tt-------------------------
-------||||||||--------------------------##--------------####--#-----------------------###-####----------##----------tt--B----TT------------------------TT####-------tt-----------B------B------
-------||||||||----------------k---------##----------k-######--#---yggk-----ggg-------#########------k--###----------tt--b----TT---ygg---------g--k-----TT#####------tt-------#---b------b----g-
XXXXXXXXXXXXXXXXXXXX-XXXXXXXXXXXXXXXXXXXXXXXXXXXXXXXXXXXXXXXX-XXXXXXXXXXXXXXXXXXXXXXXXXXXXXXXXXXXXXXXXXXXXXXXXXXXXXXXXXXXXXXXXXXXXXXXXXXXXXXXXXXXXXXXXXXXXXXXXX-XXXXXXXXXXXXXXXXXXXXXXXXXXXXXXXX
XXXXXXXXXXXXXXXXXXXX--XXXXXXXXXXXXXXXXXXXXXXXXXXXXXXXXXXXXXXXXXXXXXXXXXXXXXXXXXXXXXXXXXXXXXXXXXXXXXXXXXXXXXXXXXXXXXXXXXXXXXXXXXXXXXXXXXXXXXXXXXXXXXXXXXXXXXXXXX-XXXXXXXXXXXXXXXXXXXXXXXXXXXXXXXX
