------------------------------------------------------------------------------------------------------------------------------------------------------------------------------------------------
------------------------------------------------------------------------------------------------------------------------------------------------------------------------------------------------
------------------------------------------------------------------------------------------------------------------------------------------------------------------------------------------------
-----------------------------------------------------------------#------------------------------------------------------------------------------SSSSSSSSSS--------------------------------------
------------------------------------------------------------------------------------------------------------------------------------------------------------------------------------------------
------------------o-------------------------------------------------------------------------------------------------------ooo-------------------------------------------------------------------
--------%%%%%%%%--%-----------------------------------------------------------------------------------SSSS-----S-------------------------------o--------------------QQQQQSS-SSSS----------------
---------||||||---|-----------------------------------------------------------------------------------------------------------------------------------------------------------------------------
---------||||||---|-----------------------------------------------------------------------------------------------------------------------------------------------------------------------------
---------||||||---|-----------------------------------------------------------------------------------------------------------------------------------------------------------------------------
------%%%%%%%%%%--|---------------------------------------------------------#-#-------------#---------tt-------------2-------------------TT---------------------------QQQS--SQS-----------------
-------||||||||---|-------------------------------------------##---------TT-#-#--#---------##---------tt---------------TT----------------TT---------------------------------------------TT------
-------||||||||---|--------------------------TT--------tt----###---------TT-#----#------TT###---------tt---------------TT----TT----------TT----------tt-------U-------------------TT----TT----U-
-------||||||||---g--------gk-----g--g-------TT-g-g----tt---####--gggg---TT-#-#--#------TT###-#-------tt---kgy---------TT----TT---kk-k---TT-------#--tt------ggg---k--------k-----TT----TT----g-
XXXXXXXXXXXXXXXXXXXXXXXXXXXXXXXXXXXXXXXXXXXXXXXXXXXXXXXXXXXXXXXXXXXXXXXXXXXXXXXXXXXXXXXXXXXXXXXXXXXXXXXXXXXXXXXXXXXXXXXXXXXXXXXXXXXXXXXXXXXXXXXXXXXXXXXXXXXXXXXXXXXXXXXXXXXXXXXXXXXXXXXXXXXXXXXX
XXXXXXXXXXXXXXXXXXXXXXXXXXXXXXXXXXXXXXXXXXXXXXXXXXXXXXXXXXXXXXXXXXXXXXXXXXXXXXXXXXXXXXXXXXXXXXXXXXXXXXXXXXXXXXXXXXXXXXXXXXXXXXXXXXXXXXXXXXXXXXXXXXXXXXXXXXXXXXXXXXXXXXXXXXXXXXXXXXXXXXXXXXXXXXXX
