------------------------------------------------------------------------------------------------------------------------------------------------------------------------------------------------
------------------------------------------------------------------------------------------------------------------------------------------------------------------------------------------------
------------------------------------------------------------------------------------------------------------------------------------------------------------------------------------------------
-------------------------------------------------#---------------SSS------------SSSS------------------------------------------------------------SSSS----------------------------SSSS------------
--------------------------------------------------------------------------------------------------------------oo-------------------------------o------------------------------------------------
------------------------------------------------------------------------------------------------------------------------------------------------------------------------------------------------
--------%%%%%%%%--------------------QQQSSSS--S-o------------------------------------------------------------------------------------QQQQ-------o-----------------o----SS------------------------
---------||||||----------------------------------#----------------------------------------------------------------------------------------------------------------------------------------------
---------||||||------------------------------oo---------------------------------S----------------------------------------------------------####-------------------------------------------------
---------||||||---------------------------------------------------------------------#------------------------------------------------------###--------------------------------------------------
------%%%%%%%%%%------------SS-o------------S@S--------------o------------------------------------------------------------------##Q-------#####------------------------------o------------------
-------||||||||----------------------------------------------#------------#-------------------#-------------------------------------------####----------TT--------------------------------------
-------||||||||------------------------------------------TT--#-------tt---#------------------###----------B-------------------------------#####---B-----TT----TT------------------B------b------
-------||||||||---g------------g--gkok------k------------TT--##------tt---#---##------------####---k-ggg--b-------g----k-----##----kgggg#-#####---b-----TT----TT-----k------k-----b------b----g-
XXXXXXXXXXXXXXXXXXXXXXXXXXXXXXXXXXXXXXXXXXXXXXXXXXXXXXXXXXXXXXXXXXXXXXXXXXXXXXXXXXXXXXXXXXXXXXXXXXXXXXXXXXXXXXXXXXXXXXXXXXXXXXXXXXXXXXXXXXXXXXXXXXXXXXXXXXXXXXXXXXXXXXXXXXXXXXXXXXXXXXXXXXXXXXXX
XXXXXXXXXXXXXXXXXXXXXXXXXXXXXXXXXXXXXXXXXXXXXXXXXXXXXXXXXXXXXXXXXXXXXXXXXXXXXXXXXXXXXXXXXXXXXXXXXXXXXXXXXXXXXXXXXXXXXXXXXXXXXXXXXXXXXXXXXXXXXXXXXXXXXXXXXXXXXXXXXXXXXXXXXXXXXXXXXXXXXXXXXXXXXXXX
