------------------------------------------------------------------------------------------------------------------------------------------------------------------------------------------------
------------------S-----------------------------------------------------------------------------------------------------------------------------------------------------------------------------
------------------------------------------------------------------------------------------------------------------------------------------------------------------------------------------------
----------------SSSSSSSSSSSSSSSS--------------------------------SSSSSSS-----------------------------------------SSSSSSSSSSSS-------------------------------------SSSSSSS------------------------
------------------------------------------------------------------------------------------------------------------------------------------------------------------------------------------------
------------------------------------------------------------------------------------------------------------------------------------------------------------------------------------------------
--------%%%%%%%%--------------So--------------------------------------SSSS-------------------------------------o--------------------QoQSSSSSSS@S--------------------------------------SQo-------
---------||||||---------------------------------------------------------------------------------------------------------------------------------------------------------------------------------
---------||||||-----------------------------------------------------------------S-------------------o-------------------------------------------------------------------------------------------
---------||||||-o-oo-----------o----------------------------------------------------##----------------------------------------------------------------------------------------------------------
------%%%%%%%%%%--------------------------------------------------------------------##---------------2--------------------------------QQQ---SS-------2--------------------#------------------o--
-------||||||||-------------#----------------------------##----------tt----------------------------------TT---------------------------------------------TT---------------##---------------------
-------||||||||-----------#-#---------------------------####---------tt----------------TT----TT----------TT----------tt-------U-------------------#-----TT---------------##----------tt---------
-------||||||||----------##-k------kk-g-------gg-----#######---------tt------y---------TT----TT--ggy---k-TT--#-------tt-----k-y-------------------g-----TT----g---------###---g------tt-----kkk-
XXXXXXXXXXXXXXXXXXXXXXXXXXXXXXXXXXXXXXXXXXXXXXXXXXXXXXXXXXXXXXXXXXXXXXXXXXXXXXXXXXXXXXXXXXXXXXXXXXXXXXXXXXXXXXXXXXXXXXXXXXXXXXXXXXXXXXXXXXXXXXXXXXXXXXXXXXXXXXXXXXXXXXXXXXXXXXXXXXXXXXXXXXXXXXXX
XXXXXXXXXXXXXXXXXXXXXXXXXXXXXXXXXXXXXXXXXXXXXXXXXXXXXXXXXXXXXXXXXXXXXXXXXXXXXXXXXXXXXXXXXXXXXXXXXXXXXXXXXXXXXXXXXXXXXXXXXXXXXXXXXXXXXXXXXXXXXXXXXXXXXXXXXXXXXXXXXXXXXXXXXXXXXXXXXXXXXXXXXXXXXXXX
