------------------------------------------------------------------------------------------------------------------------------------------------------------------------------------------------
------------------------------------------------------------------------------------------------------------------------------------------------------------------------------------------------
------------------------------------------------------------------------------------------------------------------------------------------------------------------------------------------------
----------------------S-------------------------SSSSSSSSSS-----S------------------------------------------------SSSSSSSSSSSSSS----------------------------------SSSSSSSSSS------SSSSSSSSSSSS----
--------------------------------------------------------------------------------------------------------------------------------------------------------------oo--------------------------------
------------------------------------------------------------------------------------------------------------------------------------------------------------------------------------------------
--------%%%%%%%%-oo-----------------SSSSSS--SSSS----------------SoooS-SSoS---SoS------------------------------------------------SSS@SSSSSS---SSS--------------------------------oooo---Soo---SSS
---------||||||----------------------------------------------------------------------------------------------------------------------------------K----------------------------------------------
---------||||||---------------------------------------------------------------------------------------------------------------------------------------------------------------------------------
---------||||||----------------------------------------------------------------------------------------------------------SS-----------------------------------------------------o---------------
------%%%%%%%%%%----------###-------S---------------------------S---QQQQQ----US----------TT-------------------------------------QSQQQSSSSSSSS@SS------------------------------------tt----------
-------||||||||----------####-----------------------------#------------------------------TT--------------------------------------------------------------TT-------------------------tt----#-----
-------||||||||----------###-----------------------------##---TT-------------------------TT-------------------TT---------#-------------------------------TT-------------------TT----tt---##-----
-------||||||||--------#####--------ggg--------g-----g---##---TT-------------------kgg---TT-------k----y-k----TT----g----#----k----kgg------------kgggg--TT---k---k----k-k----TT----tt--###-----
XXXXXXXXXXXXXXXXXXXXXXXXXXXXXXXXXXXXXXXXXXXXXXXXXXXXXXXXXXXXXXXXXXXXXXXXXXXXXXXXXXXXXXXXXXXXXXXXXXXXXXXXXXXXXXXXXXXXXXXXXXXXXXXXXXXXXXXXXXXXXXXXXXXXXXXXXXXXXXXXXXXXXXXXXXXXXXXXXXXXXXXXXXXXXXXX
XXXXXXXXXXXXXXXXXXXXXXXXXXXXX-XXXXXXXXXXXXXXXXXXXXXXXXXXXXXXXXXXXXXXXXXXXXXXXXXXXXXXXXXXXXXXXXXXXXXXXXXXXXXXXXXXXXXXXXXXXXXXXXXXXXXXXXXXXXXXXXXXXXXXXXXXXXXXXXXXXXXXXXXXXXXXXXXXXXXXXXXXXXXXXXXX
