------------------------------------------------------------------------------------------------------------------------------------------------------------------------------------------------
------------------------------------------------------------------------------------------------------------------------------------------------------------------------------------------------
------------------------------------------------------------------------------------------------------------------------------------------------------------------------------------------------
---------------------------------#-------------------------------SSSSSSSSSS---------------------SSSSSSSSSS----SS--------------------------------SSSSSSSSSSSS----SSSSSSSSSS----------------------
------------------------------------------------------------------------------------------------------------------------------o-----------------------------------------------------------------
------------------------------------------------------------------------------------------------------------------------------------------------------------------------------------------------
--------%%%%%%%%-----------S-------------------o---------------------------------S--SS----------------------------o-QQQSSS----@S-----------------S-----------SSS--------------------QQQQQS------
---------||||||---------------------------------------%----------------------------------------------------------------------------------------#------------------------------------------------
---------||||||---------------------------------------|----------------------------------------------------------------------------------------#------------------------------------------------
---------||||||---------------------------------------|----------------------------------------------------------------------------------------#o-----------------------------------------------
------%%%%%%%%%%---------SSSS@S-----------------------|--------------------------------------US-----------------------------------------------##----------------------tt--------Q-Q----QQQ---S--
-------||||||||---------------------------#----------t|-----------------------------------K--------------------------------------------Tt---###----------TT-----------tt------------------------
-------||||||||----------------------t---##---------tt|--------------t--------------------B-----------t--------------------------------TT--####----------TT-----------tt------------------------
-------||||||||----------------------t---###--------ttt------gg-----tt------------ggggg---b---kok-----t-------g----kog----------g-g----TT--#####-----k---TT---k-------tt-----gg----k------------
XXXXXXXXXXXXXXXX--%%%%%---X---XXXXXXXXXXXXXXXXXXXXXXXXXXXXXXXXXXXXXXXXXXXXXXXXXXXXXXXXXXXXXXXXXXXXXXXXXXXXXXXXXXXXXXXXXXXXXXXXXXXXXXXXXXXXXXXXXXXXXXXXXXXXXXXXXXXXXXXXXXXXXXXXXXXXXXXXXXXXXXXXXX
XXXXXXXXXXXXXXXX---|||--------XXXXXXXXXXXXXXXXXXXXXXXXXXXXXXXXXXXXXXXXXXXXXXXXXXXXXXXXXXXXXXXXXXXXXXXXXXXXXXXXXXXXXXXXXXXXXXXXXXXXXXXXXXXXXXXXXXXXXXXXXXXXXXXXXXXXXXXXXXXXXXXXXXXXXXXXXXXXXXXXXX
