------------------------------------------------------------------------------------------------------------------------------------------------------------------------------------------------
------------------------------------------------------------------------------------------------------------------------------------------------------------------------------------------------
------------------------------------------------------------------------------------------------------------------------------------------------------------------------------------------------
----------------------------------------------------------------SSSSSSS---------SSSSSSSSSSSSSS----------------------------------SSSSSSSS----------------------------------------SSSSSSSSSSS-----
------------------------------------------------------------------------------------------------------------------------------------------------------------------------------------------------
------------------------------------------------------------------------------------------------------------------------------------------------------------------------------------------------
--------%%%%%%%%---------------o-------------------------------------------------------------------------------------------------------------------------------------------------o--------------
---------||||||----------------#----------------------------------------------------------------------------------------------------------------S-----------------------------------------------
---------||||||--------------###--------------------------------------------------------------------------------------------#-#-----------------------------------------------------------------
---------||||||-oo-----------###-------------------------------------------------------------------------------------------##-#---------------------------------------------#-#-----------------
------%%%%%%%%%%-------------###---------------------2--------------------#--------------------------2-------------------TT####--------------------------------------2-----####-----------------
-------||||||||-------------####------tt-----------------TT---------------#---------tt------------------------#----------TT##-#-----------------------------------------TT-####------S----------
-------||||||||-----------U-####------tt-----------------TT----------B----#---------tt---#----#--------tt----##----------TT####------tt---------#-----------------------TT-####------S---##-----
-------||||||||---ggggg---#-####------tt------gg-g-----k-TT----o-----b---##---##----tt--------g-g-g----tt---###---g--#--########--#--tt-----ggg-#----------kgk----g--k--TT-####----------#----k-
XXXXXXXXXXXXXXXXXXXXXXXXXXXXXXXXXXXXXXXXXXXXXXXXXXXXXXXXXXXXXXXXXXXXXXXXXXXXXXXXXXXXXXXXXXXXXXXXXXXXXXXXXXXXXXXXXXXXXXXXXXXXXXX-XXXXXXXXXXXXXXXXXXXXXXXXXXXXXXXXXXXXXXXXXXXXXXX-XXXXXXXXXXXXXXXX
XXXXXXXXXXXXXXXXXXXXXXXXXXXXXXXXXXXXXXXXXXXXXXXXXXXXXXXXXXXXXXXXXXXXXXXXXXXXXXXXXXXXXXXXXXXXXXXXXXXXXXXXXXXXXXXXXXXXXXXXXXXXXXX-XXXXXXXXXXXXXXXXXXXXXXXXXXXXXXXXXXXXXXXXXXXXXXX-XXXXXXXXXXXXXXXX
