------------------------------------------------------------------------------------------------------------------------------------------------------------------------------------------------
------------------------------------------------------------------------------------------------------------------------------------------------------------------------------------------------
------------------------------------------------------------------------------------------------------------------------------------------------------------------------------------------------
----------------SSSSSSSSSSSS--------------------SSSSSSSSSSSSSSSS---------------------------------SSSSSSSSS--------------------------------------SSSSSSSSS--------S-SSSSSSSS---------------------
------------------------------------------------S-----------------------------------------------------------------------------------------------------------------------------------------------
------------------------------------------------------------------------------------------------------------------------------------------------------------------------------------------------
--------%%%%%%%%---------------------------------------------o--------------------------------------------------oooo---Soo---SoS--------------------------------oooo----ooo----S--oSS---------oo
---------||||||---------------------------------------------------------------------------------------------------------------------------------------------------------------------------------
---------||||||---------------------------------------------------------------------o-----------------------------------------------------------------------------------------------------------
---------||||||-----------------------------------------SSSS------------------------#---------------------------o--------------------------##-------------------oo-------------------------#----
------%%%%%%%%%%-----------#------------------------------------------------------------------------------------S----QS-----SUS-----------###--------------------------------------SS----###----
-------||||||||----------###------------TT-------------------------------TT--------------------------------------------------------------####-------------------------------------------###-----
-------||||||||---------####------------TT---TT---------------TT---------TT--------------TT--TT------------#----------------------------#####----------------------------#-------------#####----
-------||||||||---------####------gggg--TT---TT-------------g-TT-----gg--TT---ko---------TT--TT------g----##--g------k--------------ggg######-#---k----k-----------------###----------######----
XXXXXXXXXXXXXXXXXXXXXXXXXXXXXXXXXXXXXXXXXXXXXXXXXXXXXXXXXXXXXXXXXXXXXXXXXXXXXXXXXXXXXXXXXXXXXXXXXXXXXXXXXXXXXXX-XXXXXXXXXXXXXXXXXXXXXXXXXXXXXXXXXXXXXXXXXXXXXXXXXXXXXXXXXXXXXXXXXXXXXXXXXXXXXXXX
XXXXXXXXXXXXXXXXXXXXXXXXXXXXXXXXXXXXXXXXXXXXXXXXXXXXXXXXXXXXXXXXXXXXXXXXXXXXXXXXXXXXXXXXXXXXXXXXXXXXXXXXXXXXXXXXXXXXXXXXXXXXXXXXXXXXXXXXXXXXX-XXXXXXXXXXXXXXXXXXXXXXXXXXXXXXXXXXXXXXXXXXXXXXXXXX
