------------------------------------------------------------------------------------------------------------------------------------------------------------------------------------------------
------------------------------------------------------------------------------------------------------------------------------------------------------------------------------------------------
------------------------------------------------t---------------------------------------------------------------t---------------t-----------------------------------------------t---------------
------------------------------------------------t---------------------------------------------------------------t---------------t-----------------------------------------------t---------------
------------------------------------------------t---------------------------------------------------------------t---------------S-----------------------------------------------t---------------
----------------------------------------------------------------------------------------------------------------t---------------------------------------------------------------t---------------
--------%%%%%%%%--------------------------------SS-------------------------------------------------------------oSS-------------oSS-----------------------------o----------------SS--------------
---------||||||--------------------------------------o-------------------o------------------------------ooo-------------------------oo------------------oo----------o---------------ooo---------
---------||||||---------------------------------------------------------------------------------------------------------------------------------------------------------------------------------
---------||||||---------------------------------------------------------------------------------------------------------------------------------------------------------------------------------
------%%%%%%%%%%--SS---------------QQ-----QQQQ----------------------tt--------------------------QQQ-tt------------TT-------------TTT--------------------------------------------TT--------------
-------||||||||-----K--------#-------------------T----tt-TT---------tt------------------------------tt------------TT-----------t-TTT-----TT---------tt-------------------TT-----TT----tt-TT-----
-------||||||||-------------##------------------TT----tt-TT---------tt-----tt------------TT---------tt-----tt-----TT--tt-------t-TTTT----TT---------tt-------------------TT-----TTT---tt-TT-----
-------||||||||------------####----ggg--------ggTT----tt-TT----gg---tt-----tt----------k-TT----kg---tt-----tt-----TT--tt-----ggt-TTT----kTT--gggK---tt-----------------k-TT-----TTT---ttkTT----g
XXXXXXXXXXXXXXXXXXXXXXXXXXXXXXXXXXXXXXXXXXXXXXXXXXXXXXXXXXXXXXXXXXXXXXXXXXXXXXXXXXXXXXXXXXXXXXXXXXXXXXXXXXXXXXXXXXXXXXXXXXXXXXXXXXXXXXXXXXXXXXXXXXXXXXXXXXXXXXXXXXXXXXXXXXXXXXXXXXXXXXXXXXXXXXXX
XXXXXXXXXXXXXXXXXXXXXXXXXXXXXXXXXXXXXXXXXXXXXXXXXXXXXXXXXXXXXXXXXXXXXXXXXXXXXXXXXXXXXXXXXXXXXXXXXXXXXXXXXXXXXXXXXXXXXXXXXXXXXXXXXXXXXXXXXXXXXXXXXXXXXXXXXXXXXXXXXXXXXXXXXXXXXXXXXXXXXXXXXXXXXXXX
