------------------------------------------------------------------------------------------------------------------------------------------------------------------------------------------------
------------------------------------------------------------------------------------------------------------------------------------------------------------------------------------------------
------------------------------------------------------------------------------------------------------------------------------------------------------------------------------------------------
----------------------------------------------------------------SSSSSSSS------------------------S-------------------------------SSSSSSSS-------S------------------------------------------------
----------------------------------------------------------------------------------------------------------------------------------------------------------------------------------------------o-
---------------------------------------------------------------------------o--------------------------------------------------------------------------------------------------------------------
--------%%%%%%%%---------------------SSS--------------------------------------------QQQSSSSS-SSo-----------------SoooSSo-------S--------------------QQSS------o---------------------QQQQSSS--SSS
---------||||||---------------------------------------------------------------------------------------------------------------------------------------------------------------------------------
---------||||||------------------------------------------------------------------------------o--------------------------------------------------------------------------------------------------
---------||||||--------------------------------------------------------------------------------------------------o------------------------------------------------------------------------------
------%%%%%%%%%%###--###-----U---------------oS---------------------------------Q------QQ---S@S------------------------------U----------------------------------------------##---------QQ---SQ--
-------||||||||-###--------------------------------------TT-----------tt---------------------------------TT---------------------------------------------##-------------TTT--##------------------
-------||||||||-###--------------------------------------TT-----------tt---------------------------------TT---TT--------------------------------------####-------------TTT--##------------------
-------||||||||-###k------k-k---------------k-----k--k---TT----#------tt-----k-----kgg------k-kg---------TT---TT---k--gg--#-k-----b----------ggg-----#####--------g----TTT--##-----k--------k---
XXXXXXXXXXXXXXXXXXXXXXXXXXXXXXXXXXXXXXXXXXXXXXXXXXXXXXXXXXXXXXXXXXXXXXXXXXXXXXXXXXXXXXXXXXXXXXXXXXXXXXXXXXXXXXXXXXXXXXXXXXXXXXXXXXXXXXXXXXXXXXXXXXXXXXXXXXXXXXXXXXXXXXXXXXXXXXXXXXXXXXXXXXXXXXXX
XXXXXXXXXXXXXXXXXXXXXXXXXXXXXXXXXXXXXXXXXXXXXXXXXXXXXXXXXXXXXXXXXXXXXXXXXXXXXXXXXXXXXXXXXXXXXXXXXXXXXXXXXXXXXXXXXXXXXXXXXXXXXXXXXXXXXXXXXXXXXXXXXXXXXXXXXXXXXXXXXXXXXXXXXXXXXXXXXXXXXXXXXXXXXXXX
