------------------------------------------------------------------------------------------------------------------------------------------------------------------------------------------------
------------------------------------------------------------------------------------------------------------------------------------------------------------------------------------------------
------------------------------------------------------------------------------------------------------------------------------------------------------------------------------------------------
------------------------------------------------SSSSSSS-------------------------SSSSSSS--------------------------S------------------------------------------------------------------------------
------------------------------------------------------------------------------------------------------------------------------------------------------------------------------------------------
------------------------------------------------------------------------------------------------------------------------------------------------------------------------------------------------
--------%%%%%%%%-o------------------------------------------------------------------------------------SSSS-------------------------S--------------------------------QQQSSSS---S-----------------
---------||||||-------------------------------------------------------------------------------------%%------------------------------------------------------------------------------------------
---------||||||-------------------------------------------------------------------------------------||------------------------------------------------------------------------------------------
---------||||||-------------------------------------------------------------------------------------||--------------#---------------------------------------------------------------------------
------%%%%%%%%%%--SoS----------U--------------------------------------------------------------------||-----------------------------------TT--------------------------Q-QQQ--SQ-------2----------
-------||||||||--------------------------TT--------------B---------------TT-------------TTT---------||-----------------tt----#-----------TT------------tt-------------------------------TT------
-------||||||||--------------------------TT--------------b----##---------TT-------------TTT---TT----|tt--#-------------tt----#-----------TT-------B----tt-----U-------------------B-----TT------
-------||||||||-------k--------S---------TT--------------b---###-k-----k-TT-------------TTT---TT----|tt--#-------------tt---####---k-k---TT-------g----tt----gg----k--------k--k--g-----TT---g#-
XXXXXXXXXXXXXXXX-XXXXXXXXX----XXXXXXXXXXXXXXXXXXXXXXXXXXXXXXXXXXXXXXXXXXXXXXXXXXXXXXXXXXXXXXX-XXXXXXXXXXXXXXXXXXXXXXXXXXXXXXXXXXXXXXXXXXXXXXXXXXXXXXXXXXXXXXXXXXXXXXXXXXXXXXXXXXXXXXXXXXXXXXXXXX
XXXXXXXXXXXXXXXX-XXXXXXXXX---XXXXXXXXXXXXXXXXXXXXXXXXXXXXXXXXXX-XXXXXXXXXXXXXXXXX-XXXXXXXXXXX-XXXXXXXXXXXXXXXXXXXXXXXXXXXXXXXXXXXXXXXXXXXXXXXXXXXXXXXXXXXXXXXXXXXXXXXXXXXXXXXXXXXXXXXXXXXXXXXXXX
