------------------------------------------------------------------------------------------------------------------------------------------------------------------------------------------------
------------------------------------------------------------------------------------------------------------------------------------------------------------------------------------------------
------------------------------------------------------------------------------------------------------------------------------------------------------------------------------------------------
--------------------------------------------------------------------------------SSSSSSSSSSSSSSS-------------------------------------------------------------------------------------------------
------------------------------------------------------------------------------------------------------------------------------------------------------------------------------------------------
------------------------------------------------------------------------------------------------------------------------------------------------------------------------------------------------
--------%%%%%%%%-------------------------------------------------SSSSSSSSS---SSS------------------------------------------------------SSSS-----o---------------------------------ooo--SSo------o
---------||||||-----------------------------oo----------------------------------------------------------------------------------------#---------------------------------------------------------
---------||||||------------------------------------------------------------------------------------------------------------------------------------------------------------------------------ooo
---------||||||----------------------------------------%--------------------------------SS------------------------------------------------------------------------------------------------------
------%%%%%%%%%%-----------------------##--------------|--------QQQQQ-SSSSS%SSSS-----------------------------------------TT--------------------------------------------------##------o-------US-
-------||||||||----------TT----------------------------|-------------------|---------------------------------------------TT------------------------------TT-----------------###-----------------
-------||||||||----------TT-----#----------------------|-------------------|---------------------------tt---------B------TT------------------------------TT------------TT---###-----------------
-------||||||||----------TT----o#----------------------|------------gg-----|------#--k--------##-------tt--kk-----b------TT---k-#----k------------gk-----TT---#-g-gg---TT---###----k-k----------
XXXXXXXXXXXXXXXX----XXXXXXXXXXXXXXXXXXXXXXXXXX-XX---XXXX-XXXX%%%XXXXXXXXXX-|-XXXXXXXXXXXXXXXXXXXXXXXXXXXXXXXXXXXXXXXXXXXXXXXXXXXXXXXXXXXXXXXXXXXXXXXXXXXXXXXXXXXXXXXXXXXXXXXXXXXXXXXXXXXXXXXXXXX
XXXXXXXXXXXXXXXX----XXXXXXXXXXXXXXXXXXXXXXXXXXXXX----XXX--XXXX|XXXXXXXXXXX-|XXXXXXXXXXXXXXXXXXXXXXXXXXXXXXXXXXXXXXXXXXXXXXXXXXXXXXXXXXXXXXXXXXXXXXXXXXXXXXXXXXXXXXXXXXXXXXXXXXXXXXXXXXXXXXXXXXXX
