------------------------------------------------------------------------------------------------------------------------------------------------------------------------------------------------
------------------------------------------------------------------------------------------------------------------------------------------------------------------------------------------------
------------------------------------------------------------------------------------------------------------------------------------------------------------------------------------------------
--------------------------------SSSSSSS-------------------------SSSSSSS--------------------------S----------------------------------------------------------------------------------------------
------------------------------------------------------------------------------------------------------------------------------------------------------------------------------------------------
------------------------------------------------------------------------------------------------------------------------------------------------------------------------------------------------
--------%%%%%%%%---------------------------------------Qoo----------------------------SQQ------o--------------------QQQQQSS---o-----------------ooo-----o-----oo--------------------QQQQQS---SSS
---------||||||---------------------------------------------------------------------------------------------------------------------------------------------------------------------------------
---------||||||---------------------------------------------------------------------------------------------------------------------------------------------------------------------------------
---------||||||----------oooo-------------------------------------------------------------------------------------------------------------------------------------------------------------------
------%%%%%%%%%%SS-------%%%----------------------------------------------------####QQ-------SS-----------------Q------QQ-------------------------------------------------------QS-----QQQ------
-------||||||||-----------|--------------T-----T--------------------------------#-----------------------TT----T--------------------------------------------------------t------------------------
-------||||||||-----------|-------------TTT---TT------------------------tt---TT-#-----------------B-----TT----TT-------------------------T---------------##------------tt----TT-----------------
-------||||||||-----------|-------b-----TTT---TT---k-------kkkk---b----ktt---TTg#--k-k------------b-----TT----TT---------------g--g------T---ggg-----k--###-----g-----ttt----gT---o------------#
XXXXXXXXXXXXXXXX--XX------|-----XXXXXXXXXXXXXXXXXXXXXXXXXXXXXXXXXXXXXXXXXXXXXXXXXXXXXXXXXXXXXXXXXXXXXXXXXXXXXXTXXXXXXXXXXXXXXXXXXXXXXXXXXXXXXXXXXXXXXXXXXXXXXXXXXXXXXXXXXXXXXXXXXXXXXXXXXXXXXXXX
XXXXXXXXXXXXXXXX--X-------|-----XXXXXXXXXXXXXXXXXXXXXXXXXXXXXXXXXXXXXXXXXXXXXXXXXXXXXXXXXXXXXXXXXXXXXXXXXXXXXXXXXXXXXXXXXXXXXXXXXXXXXXXXXXXXXXXXXXXXXXXXXXXXXXXXXXXXXXXXXXXXXXXXXXXXXXXXXXXXXXXX
