------------------------------------------------------------------------------------------------------------------------------------------------------------------------------------------------
------------------------------------------------------------------------------------------------------------------------------------------------------------------------------------------------
------------------------------------------------------------------------------------------------------------------------------------------------------------------------------------------------
------------------------------------------------SSSSSSSSSSSSSSSS----------------SSSSSSS-------------------------SSSSSSS---------------------------------------------------------SSSSSSS-------SS
------------------------------------------------S-----------------------------------------------------------------------------------------------------------------------------------------------
------------------------------------------------S-----------------------------------------------------------------------------------------------------------------------------------------------
--------%%%%%%%%----------------------------------------oo------------------------------------------QQQ--------o-----------------ooo--SS------oo------------------o--SSSS------S----------------
---------||||||---------------------------------------------------------------------------------------------------------------------------------------------------------------------------------
---------||||||------------------------------------------------------------------------------------------------------------------------------------------------------------#--------------------
---------||||||-------------------o-------------------------------------------------------------------------------------------------------------------------------------------------------------
------%%%%%%%%%%-------------------------TT------------------------------------------------------#QQ-------------------------------------------------2------------------------------------------
-------||||||||--------------------------TT----------------------------t-----------------------------------------------tt----------------##------#-----tt----------------#--------------TT------
-------||||||||--------------------------TT----------B-------------------------------ttt-----TT-----------#-##---------tt-----@---------###-----TT-----ttt---T----------###-------B-----TT---TT-
-------||||||||-------------------gggg---TT-------b--t------gggg-----ttk----k--------ttt-t---TTT---kgggg###-#---k-b----tt----ggT----ty--###-----TTt----tt---###-----og#-###-k---k-b----kTt---TT-
XXXXXXXXXXXXXXXX------XXXX------XXXXXXXXXXXXXXXXXXXXXXXXXXXXXXXXXXXXXXXXXXXXXXXXXXXXXX%XXXXXXXXXXXXXXXXXXXXXXXXXXXXXXXXXXXXXXXXXXXXXXXXXXXXXXXXXXXXXXXXXXXXXXXXXXXXXXXXXXXXXXXXXXXXXXXXXXXXXXXXX
XXXXXXXXXXXXXXXX--X---XXXX------XXXXXXXXXXXXXXXXXXXXXXXXXXXXXXXXXXXXXXXXXXXXXXXXXXXXXXXXXXXXXXXXXXXXXXXXXXXXXXXXXXXXXXXXXXXXXXXXXXXXXXXXXXXXXXXXXXXXXXXXXXXXXXXXXXXXXXXXXXXXXXXXXXXXXXXXXXXXXXXX
