------------------------------------------------------------------------------------------------------------------------------------------------------------------------------------------------
------------------------------------------------------------------------------------------------------------------------------------------------------------------------------------------------
------------------------------------------------------------------------------------------------------------------------------------------------------------------------------------------------
-------------------------------------------------------------------------------------------SS------SSSSSSSSSSSSS------------------------------------SSSSSSSSSSSS--------------------------------
---------------------------------------------------------------------------S------------------------------SS-S-------------S----------------------------SSSSSS------------------------------S---
-------------------------------------k-------------------------------------------------------------------S---S-----------------------k----------------SSSS--SS------------------------------SS--
--------%%%%%%%%---------QQ---------SSoS-------------SSS----SS-------SSSSSSS----SSSSSSSSS---SSS---USSSSSS---SSS---SSSSSSSSSSSS-----SSSSS----SSSSSSSSSSSSSSSSUSS---SSSSSS----SSS-SSSSSSSSSSSSSSS-
---------||||||----------------------SS----------------------------------------------------------------------------------------------S-----------------------------SS---------------------------
---------||||||---------------------------------------------------------------------------------------------------------------------------------------------------------------------------------
---------||||||------------------------------------------------------------------------------------ooo----o--------o----------------------------------------o-----------------------------------
------%%%%%%%%%%-------------------S-SS---SSSS-------------------SSSSSSSSS---------@--------------SSSS----SS------SSSS------------SSS----------------------SSS----------------------------------
-------||||||||------------------------------------------TT---TT------------TT-----------TT--------------SS----y-----------------------------------------TT--------------TT---TT---------TT-----
-------||||||||-T---------%%%----------------------------TT---TT------------TT-----------TT---------------S-S--#-----------------------------------------TT-----T--------TT---TT---------TT----T
-------||||||||-T-----g----|--g----kk--kkk------T----y---TT---TT--gg----gg--TT-------y---TT----k---kggg------k-T---gggg--k---------kk--k-----k--------g-kTT-----T----y---TT---TT------g-kTT----T
XXXXXXXXXXXXXXXXXX--XXXXXXXXXXXXXXXXXXXXXXXXXXXXXXXXXXXXXXXXXXXXXXXXXXXXXXXXXXXXXXXXXXXXXXXXXXXXXXXXXXXXXXXXXXXXXXXXXXXXXXXXXXXXXXXXXXXXXXXXXXXXXXXXXXXXXXXXXXXXXXXXXXXXXXXXXXXXXXXXXXXXXXXXXXXX
XXXXXXXXXXXXXXXXXX--XXXXXXXXXXXXXXXXXXXXXXXXXXXXXXXXXXXXXXXXXXXXXXXXXXXXXXXXXXXXXXXXXXXXXXXXXXXXXXXXXXXXXXXXXXXXXXXXXXXXXXXXXXXXXXXXXXXXXXXXXXXXXXXXXXXXXXXXXXXXXXXXXXXXXXXXXXXXXXXXXXXXXXXXXXXX
