------------------------------------------------------------------------------------------------------------------------------------------------------------------------------------------------
------------------------------------------------------------------------------------------------------------------------------------------------------------------------------------------------
------------------------------------------------------------------------------------------------------------------------------------------------------------------------------------------------
--------------------------------SSSSSSS-----------------------------------------SSSSSSSSSS--------------------------------------SSSSSSSSSS------SSSSSSSSSSS--SS---------------------------------
------------------------------------------------------------------------------------------------------------------------------------------------------------------------------------------------
------------------------------------------------------------------------------------------------------------------------------------------------------------------------------------------------
--------%%%%%%%%-----SSSS--------------oS------o-----------------------Q-------------------------o-----Soo-----S------------------------------------------------SSSSSSSS-----SSS----------------
---------||||||------------------------------------------------------------------o--------------------------------------------------------------------------------------------------------------
---------||||||-----------------------------------------------------------------------------------------------------TT--------------------------S-----------------------------------------------
---------||||||-----------------------------------------------------------------------------------------------------TT--------------------------------------------------------------------------
------%%%%%%%%%%---------------------------##-------------#------------------U-----------------------o--------------##------------------------------------------#---S--------USS----------------
-------||||||||----------------------------#--------------#------------tt---------------TT#-----------------------------TT--------------------------------#------------------------------TT-----
-------||||||||---------------------------##-------------##------------tt---------------TT#---TT------------------------TT----TT-----tt------------------###-----------------------------TT---TT
-------||||||||------gg--------------k---###-------k-k---##-----g-gy---tt---------k-----TT#---TT---------##-----g-----k-TT----TT--g--tt-----k-k----------###--#----kgggg--k-------k------TT---TT
XXXXXXXXXXXXXXXXXXXXXXXXXXXXXXXXXXXXXXXXXXXXXXXXXXXXXXXXXXXXXXXXXXXXXXXXXXXXXXXXXXXXXXXXXXXXX-XXXXXXXXXXXXXXXXXXXXXXXXXXXXXXXXXXXXXXXXXXXXXXXXXXXXXXXXXXXXXXX-XXXXXXXXXXXXXXXXXXXXXXXXXXXXXXXXXX
XXXXXXXXXXXXXXXXXXXXXXXXXXXXXXXXXXXXXXXXXXXXXXXXXXXXXXXXXXXXXXXXXXXXXXXXXXXXXXXXXXXXXXXXXXXXX-XXXXXXXXXXXXXXXXXXXXXXXXXXXXXXXXXXXXXXXXXXXXXXXXXXXXXXXXXXXXXXX-XXXXXXXXXXXXXXXXXXXXXXXXXXXXXXXXXX
