-----------------------S------------------------------------------------------------------------------------------------------------------------------------------------------------------------
------------------------------------------------------------------------------------------------------------------------------------------------------------------------------------------------
-----------------------S------------------------------------------------------------------------------------------------------------------------------------------------------------------------
----------------SSS-----------------------------------------------------------------------------------------------------------------------------SSSSSSSSSSSS-S----------------------------------
------------------------------------------------------------------------------------------------------------------------------------------------------------------------------------------------
---------------------------------------------------------------------------------------------------------------------------------------------------------------------------oooo-----------------
--------%%%%%%%%-------------------------------------SoSSS-----S-------------------------------o-------------------------------o----------------------------------------------------QQ---------o
---------||||||-SS%%%%%o-------------------------------------------------------o-----------------------------------------------------------------------------------------------o----------------
---------||||||----|||----------------------------------------------------------------------------------------------#-----------------------------------------------o---------------------------
---------||||||----|||-----SSSS-------------------------------------------------------------------------------------#-----------------------------------------------#----------#----------------
------%%%%%%%%%%S--|||-----S--------------------------------------------------#--------------#-----------------------------------------------------------------------2--------##-------------#--
-------||||||||----|||----------------tt-------------------#------------------#----------#---#---------S---------------------------------------------ttt---------------------###-------------#--
-------||||||||----|||-----K----------tt--------------------------------TT----#------tt--#-####-TT--------------------------------B------------------ttt------TT-------TT---####------------##--
-------||||||||----|||-----S------b---tt-----ggg-----gg----k------g-----TT--####-----tt###-####-TT-----------gg---g----------##g--b----k-----ggg-----ttt------TT-------TT---####---kgggg--#-##--
XXXXXXXXXXXXXXXX--X|||-XX--XS---XXXXXXXXXXXXXXXXXXXXXXXXXXXXXXXXXXXXXXXXXXXXXXXXXXXXXXXXXXXXXXXXXXXXXXXXXXXXXXXXXXXXXXXXXXXXXXXXXXXXXXXXXXXXXXXXXXXXXXXXXXXXXXXXXXXXXXXXXXXXXXXXXXXXXXXXXXXXXXXX
XXXXXXXXXXXXXXXX--X|||-XX--X----XXXXXXXXXXXXXXXXXXXXXXXXXXXXXXXXXXXXXXXXXXXXXXXXXXXXXXXXXXXXXXXXXXXXXXXXXXXXXXXXXXXXXXXXXXXXXXXXXXXXXXXXXXXXXXXXXXXXXXXXXXXXXXXXXXXXXXXXXXXXXXXXXXXXXXXXXXXXXXXX
