------------------------------------------------------------------------------------------------------------------------------------------------------------------------------------------------
------------------------------------------------------------------------------------------------------------------------------------------------------------------------------------------------
------------------------------------------------------------------------------------------------------------------------------------------------------------------------------------------------
--------------------------SSSS--------------------------------------------------SSSSS------------------------------------------------------------SSSSSSSSSS---------------------SSSSSSSS--------
------------------------------------------------------------------------------------------------------------------------------------------------------------------------------------------------
------------------------------------------------------------------------------------------------------------------------------------------------------------------------------------------------
--------%%%%%%%%-------------------SQSQSoS---SSS-------------------QQQQQQS----oS----------------------SSSS----@---------------------QQQQQ-----------------------------SSo------S----------------
---------||||||---------------------------------------------------------------------------------------------------------------------------------------------------------------------------------
---------||||||--------------------------------------------------------------S------------------------------------------------------------------------------------------------------------------
---------||||||---------------------------------------------------------------------------------------------------------------------------------------------------------------------------------
------%%%%%%%%%%---------T----------SS@QQS--SUS-----------------###---SQQ----SS------2-----------------QQ----U-------------------------------Q---------------------------------------2----------
-------||||||||---S------TT------------------------------#------#-##-----------------------------------------------------TT------------------------------------------t--------------------------
-------||||||||----------TT--------------------------t--##---T--####--------------------Tt----T--------------------------TT--k--------------------B------K----U-----tt----#--------------B------
-------||||||||------k---TT-----------------k--------t####---#g-####-kk---------g-g----ktt----TT-----kk---------g-g--k---TT--#g----k--k-----k--g--b------b---ggg---ktt----#-----T------k-b----gg
XXXXXXXXXXXXXXXXXXXXXXXXXXXXXXXXXXXXXXXXXXXXXXXXXXXXXXXXXXXXXXXXXXXXXXXXXXXXXXXXXXXXXXXXXXXXXXXXXXXXXXXXXXXXXXXXXXXXXXXXXXXXXXXXXXXXXXXXXXXXXXXXXXXXXXXXXXXXXXXXXXXXXXXXXXXXXXXXXXXXXXXXXXXXXXXX
XXXXXXXXXXXXXXXXXXXXXXXXXXXXXXXXXXXXXXXXXXXXXXXXXXXXXXXXXXXXXXXXXXXXXXXXXXXXXXXXXXXXXXXXXXXXXXXXXXXXXXXXXXXXXXXXXXXXXXXXXXXXXXXXXXXXXXXXXXXXXXXXXXXXXXXXXXXXXXXXXXXXXXXXXXXXXXXXXXXXXXXXXXXXXXXX
