------------------------------------------------------------------------------------------------------------------------------------------------------------------------------------------------
------------------------------------------------------------------------------------------------------------------------------------------------------------------------------------------------
------------------------------------------------------------------------------------------------------------------------------------------------------------------------------------------------
------------------------------------------------SSS---------------------------------------------------------------------------------------------SSSSSSSS----------------------------------------
------------------------------------------------------------------------------------------------------------------------------------------------------------------------------------------------
------------------------------------------------------------------------------------------------------------------------------------------------------------------------------------------------
--------%%%%%%%%--------------------QQQS-------------------------o--QQQSQS----SS----------------------SSSS---S@-----------------SoSQQ--SQS-----S--------------------QQQQQSSS-S@-----------------
---------||||||------------------------------------%%%%%------S---------------------------------------------------------------------------------------------------------------------------------
---------||||||-------------------------------------|||-----------------------------------------------------------------------------------------------------------------------------------------
---------||||||-------------------------------------|||------------------------------------------------k------------#------------------g--------------------------------------------------------
------%%%%%%%%%%#----2------------------QS--SSSS----||tt--------#---S-SS-----U------------------------SQQ---SSS-----------------Q#Q-QSSS----S@S-----------------------QQQQ--SQS-----------------
-------||||||||-------------------------------------||tt---------------------#-----------------------------------------------------------------------tt---------------------------------TT------
-------||||||||-----------K---------------------#---||tt-----K---------------##----------------------------------------TT----TT----------------------tt---------------------------B-----TT------
-------||||||||--------k--#--k------------------#---||tt---k-g-g---kgggg--k-###------k----g---k------------------------TT----TT----k--gg--k----------tt------kgg--kk--k---------g-b-----TT---g--
XXXXXXXXXXXXXXXXXXXXXXXXXXXXXXXXXXXXXXXXXXXXXXXXXXX-|XXXXXXXXXXXXXXXXXXXXXXXXXXXXXXXXXXXXXXXXXXXXXXXXXXXXXXXXXXXXXXXXXXXXXXXXXXXXXXXXXXXXXXXXXXXXXXXXXXXXXXXXXXXXXXXXXXXXXXXXXXXXXXXXXXXXXXXXXXX
XXXXXXXXXXXXXXXXXXXXXXXXXXXXXXXXXXXXXXXXXXXXXXXXXXX-XXXXXXXXXXXXXXXXXXXXXXXXXXXXXXXXXXXXXXXXXXXXXXXXXXXXXXXXXXXXXXXXXXXXXXXXXXXXXXXXXXXXXXXXXXXXXXXXXXXXXXXXXXXXXXXXXXXXXXXXXXXXXXXXXXXXXXXXXXXX
