------------------------------------------------------------------------------------------------------------------------------------------------------------------------------------------------
------------------------------------------------------------------------------------------------------------------------------------------------------------------------------------------------
------------------------------------------------------------------------------------------------------------------------------------------------------------------------------------------------
--------------------------------SSSSSSSS--------------------------------------------------------SSSSSSSSSSSS----------------------------------------------------SSSS----------------------------
----------------------------------------------------------------------------------------------o-------------------------------------------------------------------------------------------------
------------------------------------------------------------------------------------------------------------------------------------------------------------------------------------------------
--------%%%%%%%%SSoooSS------S------------------------QQ-------------------------oo-QQSSSS---SoS--------------------QQQQQ-----------------------------So----------------------------QQQSQS---SSS
---------||||||---------------------------------------------------------------------------------------------------------------------------------------------------------------------------------
---------||||||---------------------------------------------------------------------------------------------------------------------------------------------------------------------------------
---------||||||------------------------------------------------------------------------------------------------------------------------------------------------------------------------o--------
------%%%%%%%%%%----S-----------------------------#------------------2----------------S-S----S-------------------------S-----o--------------------------------------------------------SSSS--SSS-
-------||||||||---------------K-----------------#-#---------------------TT-------------------------------------------------------TT-----TT------------------------------------------------------
-------||||||||----------------------tt-------U-###---------------------TT---TT------------------------tt-----@------------------TT-----TT---TT-------------------------------##----------------
-------||||||||-----ggk---k-k-----yg-tt-------gg###-k-k----k----g-g-----TT---TT------yk----------------tt----gg----ggg---------g-TT-----TT---TT-----------------g-----------g###--ggggg---------
XXXXXXXXXXXXXXXXXXXXXXXXXXXXXXXXXXXXXXXXXXXXXXXXXXXXXXXXXXXXXXXXXXXXXXXXXXXXXXXXXXXXXXXXXXXXXXXXXXXXXXXXXXXXXXXXXXXXXXXXXXXXXXXXXXXXXXXXXXXXXXXXXXXXXXXXXXXXXXXXXXXXXXXXXXXXXXXXXXXXXXXXXXXXXXXX
XXXXXXXXXXXXXXXXXXXXXXXXXXXXXXXXXXXXXXXXXXXXXXXXXXXXXXXXXXXXXXXXXXXXXXXXXXXXXXXXXXXXXXXXXXXXXXXXXXXXXXXXXXXXXXXXXXXXXXXXXXXXXXXXXXXXXXXXXXXXXXXXXXXXXXXXXXXXXXXXXXXXXXXXXXXXXXXXXXXXXXXXXXXXXXXX
