------------------------------------------------------------------------------------------------------------------------------------------------------------------------------------------------
------------------------------------------------------------------------------------------------------------------------------------------------------------------------------------------------
------------------------------------------------------------------------------------------------------------------------------------------------------------------------------------------------
----------------SSSSSSSS--------------------------#---------------------------------------------------------------------------------------------------------------------------------------------
----------------S---------------------------------#-#-------------------------------------------------------------------------------------------------------------------------------------------
----------------------------------------------------------------------------------------------------------------------------------##------------------------------------------------------------
--------%%%%%%%%SSSoo---------------------------------------------------------------------------SS--------------SS%----------------------------o---------------U----------------SSS----------S-o
---------||||||-------------------------------------#-%---------%-------------------------------------------------|--------------------------------------oo--------------------------o----------
---------||||||---------------------------------------|---------|------------------------S------------------------|---------------------------------------K-------------------------------------
---------||||||---------------------------------------|---------|------------------------SSS----------------------|------------------------------------------------------S----------------------
------%%%%%%%%%%---------TT-------SS------------------|---------|-TT--------TT--------------------SSS-------------|----------------------------Q------------------SS----------------------------
-------||||||||----------TT---------K-----------------|---------|-TT--------TT---------TT----------------TT-------|---tt-TT---------tt------------------------------------------TT-------TT-----
-------||||||||----------TT----#--------------------TT|-----TT--|-TT--------TT------tt-TT-----#----------TT-----TT|---tt-TT---------tt--T--tt---------------TT------------------TT-------TT----T
-------||||||||------y---TT----#--------------------TT|-----TT--|-TT---k----TT----K-tt-TT---kk#----ggg---TT-----TT|---tt-TT----g----tt-----tt----gggg-----k-TT-k----------k-----TT----g-kTT----T
XXXXXXXXXXXXXXXXXXXXXXXXXXX---XXXXXXXXXXXXXXXXXXXXXXXXXXXXXXXXXXXXXXXXXXXXXXXXXXXXXXXXXXXXXXXXXXXXXXXXXXXXXXXXXXXXXXXXXXXXXXXXXXXXXXXXXXXXXXXXXXXXXXXXXXXXXXXXXXXXXXXXXXXXXXXXXXXXXXXXXXXXXXXXXX
XXXXXXXXXXXXXXXXXXXXXXXXXXXX--XXXXXXXXXXXXXXXXXXXXXXXXXXXXXXXXXXXXXXXXXXXXXXXXXXXXXXXXXXXXXXXXXXXXXXXXXXXXXXXXXXXXXXXXXXXXXXXXXXXXXXXXXXXXXXXXXXXXXXXXXXXXXXXXXXXXXXXXXXXXXXXXXXXXXXXXXXXXXXXXXX
