------------------------------------------------------------------------------------------------------------------------------------------------------------------------------------------------
-------------------------------------------------------------------------------------------------K----------------------------------------------------------------------------------------------
------------------------------------------------------------------------------------------------------------------------------------------------------------------------------------------------
----------------------------------------------------------------SSSSSSSS--------SSSSSSSSSSSSSSSS--------------------------------SSSSSSSSSS------SSSSSSSSSSSS------------------------------------
-------------------------------------------------------------------------------------------------------------------------------------------------S----------------------------------------------
------------------------------------------------------------------------------------------------------------------------------------------------------------------------------------------------
--------%%%%%%%%-----------------o----SSSSS-SSSS--o------------S-----------------o---------------SoSSSS------SSS---------------o-oo-------------oooo---Sooo--SSSS-SSQS-------S@S----------------
---------||||||------------------------------------------------------------------------------------------------------------------------------------------------------------------o--------------
---------||||||--------------------------------------------#--------------------S-----------------------------o---------------------------------------------------------------o-----------------
---------||||||------------------------k--------oo---------#------------------------------------o--o--------------------------------------------o-----------------------------------------------
------%%%%%%%%%%-------------------QQQQQQ----oS-----------##------------------------------------S--SSS-------SSS----------#-------------------------------------#QQQ--------S@SS----------------
-------||||||||----------TT------------------------------###--------------------------------------------------------------#----------tt------------------##------------------------------TT-----
-------||||||||----------TT---TT------------------------####-------------TT----------------------------------------------##----------tt-----------------####-----------------------------TT---TT
-------||||||||-------y--TT---TT---g----------------ggg######--------g---TT---k------k-----g--g----k-kkk--k---------ggg-###----------tt-----k-kg-------#####k------gggg---k-------g----k-TT---TT
XXXXXXXXXXXXXXXXXXXXXXXXXXXXXXXXXXXXXXXXXXXXXXXXXXXXXXXXXXXXXXXXXXXXXXXXXXXXXXXXXXXXXXXXXXXXXXXXXXXXXXXXXXXXXXXXXXXXXXXXXXXXXXXXXXXXXXXXXXXXXXXXXXXXXXXXXXXXXXXXXXXXXXXXXXXXXXXXXXXXXXXXXXXXXXXX
XXXXXXXXXXXXXXXXXXXXXXXXXXXXXXXXXXXXXXXXXXXXXXXXXXXXXXXXXXXXXXXXXXXXXXXXXXXXXXXXXXXXXXXXXXXXXXXXXXXXXXXXXXXXXXXXXXXXXXXXXXXXXXXXXXXXXXXXXXXXXXXXXXXXXXXXXXXXXXXXXXXXXXXXXXXXXXXXXXXXXXXXXXXXXXXX
