------------------------------------------------------------------------------------------------------------------------------------------------------------------------------------------------
------------------------------------------------------------------------------------------------------------------------------------------------------------------------------------------------
------------------------------------------------------------------------------------------------------------------------------------------------------------------------------------------------
-------------------------------------------------------------------------------------------------S-------------------------------S--------------------------------------------------------------
------------------------------------------------------------------------------------------------------------------------------------------------------------------------------------------------
------------------------------------------------------------------------------------------------------------------------------------------------------------------------------------------------
--------%%%%%%%%-----------------------------------------------U----------S---------QQQQQS-----S-----------------ooo-----------o--------S-----------QQQQQ------S----------------------SSSS------
---------||||||--#--------------------------------------------------------------S---------------------------------------------------------------------------------------------------------------
---------||||||--------------------------------------------------------------------------------------------------------------oo-----------------------------------------------------------------
---------||||||------------------------------------------------------------------o--------------------------------------------------------------------------------------------------------------
------%%%%%%%%%%------------------------------------------T----------------------#------Q----U-------------------------------SS-----------------######-S-----#-------2--------------------------
-------||||||||------------------------------------------TT---------------------------------------------------------------------------tt---------------------#-----------TT-#--------t----------
-------||||||||-------------------------------T----------TT----------t----------------------------------tt---TT-----------#----------ttt--------------------##----------TTT-#-o------t----------
-------||||||||-----------#----#--b----------kT---kkgy---TT-------gggtt-----------gy--------k-----k----ktt---##----kgy----#-------gg-ttt----ggg----k-k-k----##----t----ktTT-###-----tt----------
XXXXXXXXXXXXXXXXXXXXXXXXXXXXXXXXXXXXXXXXXXXXXXXXXXXXXXXXXXXXXXXXXXXXXXXXXXXXXXXXXXXXXXXXXXXXXXXXXXXXXXXXXXXXXXXXXXXXXXXXXXXXXXXXXXXXXXXXXXXXXXXXXXXXXXXXXXXXXXXXXXXXXXXXXXXXXXXXXXXXXXXXXXXXXXXX
XXXXXXXXXXXXXXXXXXXXXXXXXXXXXXXXXXXXXXXXXXXXXXXXXXXXXXXXXXXXXXXXXXXXXXXXXXXXXXXXXXXXXXXXXXXXXXXXXXXXXXXXXXXXXXXXXXXXXXXXXXXXXXXXXXXXXXXXXXXXXXXXXXXXXXXXXXXXXXXXXXXXXXXXXXXXXXXXXXXXXXXXXXXXXXXX
