--------------------------------------------------------------------------------------------------------------------------------------------------------------------------------
--------------------------------------------------------------------------------------------------------------------------------------------------------------------------------
--------------------------------------------------------------------------------------------------------------------------------------------------------------------------------
SSS-----------------------------------------------------------------------------------------------------------------------------------------------------------------------------
--------------------------------------------------------------------------------------------------------------------------------------------------------------------------------
--------------------------------------------------------------------------------------------------------------------------------------------------------------------------------
------------------------------@S-----------------%%--------------S-------SQQ-------SS-SS----------------------------------------------------------------------------------------
-------------------------------------------------||-------------------------------------------------------o-----------------------------------------------oo----o---------------
%%%%%%%------------------------------------------||-----------------------------------------------------------------------------------#-----------------------------------------
-|||||-----------------------------------SSS-----||---------------------------------------------------------------------------------###-----------------------------------------
-|||||----------------------K-----------------#--||----------------------------------SS-----##-------------------------------------#--#---------------------------TT------------
-|||||----------------------------------------#--||------TT-----T---------------------------TT---------TT-------------------------TT-##--TT------------TT---------TT------------
-|||||----------------------------------------#--|T------TT-----T-----B-------------------#-TT---------TT--------------------#---TTT#-#--TT---------tt-TT--B------TT------------
-|||||-----------k----------------------T-----#--|T---g--TT----kT-----b--------y-------k-##-TT---------TT--------k----------##---TTT###--TT-----g---tt-TT--b------TT-----------g
-XXX||----%%%----XXXXXXXXX--XXXyXXXXXXXXXXXXXXXXXXXXXXXXXXXXXXXXXXXXXXXXXXXXXXXXXXXXXXXXXXXXXXXXXXXXXX-XXXXXXXXX-XXXXXXXXXXXXXXXXXXXXXXXXXXXXXXXXXXXXXXXXXXXXXXXXXXXXXXXXXXXXXXX
-XXX||-----|----XXXXXXXXXX--XXXXXXXXXXXXXXXXXXXXXXXXXXXXXXXXXXXXXXXXXXXXXXXXXXXXXXXXXXXXXXXXXXXXXXXXXX-XXXXXXXXXXXXXXXXXXXXXXXXXXXXXXXXXXXXXXXXXXXXXXXXXXXXXXXXXXXXXXXXXXXXXXXXX
