------------------------------------------------------------------------------------------------------------------------------------------------------------------------------------------------
------------------------------------------------------------------------------------------------------------------------------------------------------------------------------------------------
------------------------------------------------------------------------------------------------------------------------------------------------------------------------------------------------
----------------SSSSS--------------------------------------------------------------SSSS----------SSSSSSSSSSS------------------------------------SSSSSSSSSSS----------------------S--------------
------------------------------------------------------------------------------------------------------------------------------------------------------------------------------------------------
------------------------------------------------------------------------------------------------------------------------------------------------------------------------------------------------
--------%%%%%%%%-----------------ooo----o-----oS-------SS----------------------------------------oo-----oo----------------------------------------------------------QQQSSSS--S@S----------------
---------||||||------------o-----------------------%%%%---------------------------------------------------------S--------------o----------------------------------------------------------------
---------||||||----%-------%%-----------------------||--------------------------------------------------------------TT---------#----------------------------------------------------------------
---------||||||----|-------||-----------------------||--------------------------------------------------------------##--------##----------------------------------------------------------------
------%%%%%%%%%%---|-------||-----------------------||t---------------t------o------------#-#------------------------2--------##-------------o--------t--------------Q-QQ----Q------------------
-------||||||||----|-------||-----------------------|tt---------------tt-----------------T#----------t------------------T----###---------------------tt---------------------------------TT------
-------||||||||----|-t-----||-------------B---------ttt---------------tt------T------B---TT---T-----tt---#-------------TTT--####----------b----------ttt------T-------------------B-----TT--#TT-
-------||||||||----|tt-----||--#---k---g-#b---------ttt------ggg-----ttt-----kg------b---T#---#-----tt---##-----g-g----TT--#####---k-----Tb----------ttt-----kg----kk----------g--b-----TT--#Tg-
XXXXXXXXXXXXXXXX--XXXXXXXXXXXX-XXXXXXXXXXXXXXXXXXXXXXXXXXXXXXXXXXXXXXXXXXXXXXXXXXXXXXXXXXXXXXXXXXXXXXXXXXXXXXXXXXXXXXXXXXXXXXXXXXXXXXXXXXXXXXXXXXXXXXXXXXXXXXXXXXXXXXXXXXXXXXXXXXXXXXXXXXXXXXXXX
XXXXXXXXXXXXXXXX--XXXXXXXXXXXX-XXXXXXXXXXXXXXXXXXXXXXXXXXXXXXXXXXXXXXXXXXXXXXXXXXXXXXXXXXXXXXXXXXXXXXXXXXXXXXXXXXXXXXXXXXXXXXXXXXXXXXXXXXXXXXXXXXXXXXXXXXXXXXXXXXXXXXXXXXXXXXXXXXXXXXXXXXXXXXXXX
