------------------------------------------------------------------------------------------------------------------------------------------------------------------------------------------------
------------------------------------------------------------------------------------------------------------------------------------------------------------------------------------------------
------------------------------------------------------------------------------------------------------------------------------------------------------------------------------------------------
-------------------------------------------------------------------------------------------------S----------------------------------------------------------------------------------------------
------------------------------------------------------------------------------------------------------------------------------------------------------------------------------------------------
------------------o-----------o-----------------------------------------------------------------------------------------------------------------------------------------------------------------
--------%%%%%%%%------------------------------------------------------------------------o------o-----------------oo---S------------------------------QQQQ------------------------oo---Soo-------
---------||||||--------------oo-------------------------------------------------S---------------------------------------------------------------------------------------------------------------
---------||||||---------------------------------------------------------------------------------------------------------------------------------------------------------------------------------
---------||||||----------ooo--------------------------------------------------------------------------------------------------------------------------------------------------------------------
------%%%%%%%%%%---------%%%-------------------------------------------------o---------------------------------------------------------------------------------------2--------------------------
-------||||||||---TT------|----------------------------------------------------------------------------tt-----------------------------tt--------------------------------TTT---------------------
-------||||||||---TT------|-------B---------------------------------------#----------------------------tt----TT----------#------------tt---------------------#----------TTT---------tt---##-----
-------||||||||---TT------|----o--b------k----##---------------o-----k---##----------g-------##g--b----tt----TT----------#------------tt-----k---ggy---------#-g--ggg---TTT---g-----tt---##-----
XXXXXXXXXXXXXXXX--XXXXXXX%|--%%%XXXXXXXXXXXXXXXXXXXXXXXXXXXXXXXXXXXXXXXXXXXXXXXXXXXXXXXXXXXXXXXXXXXXXXXXXXXXXXXXXXXXXXXXXXXXXXXXXXXXXXXXXXXXXXXXXXXXXXXXXXXXXXXXXXXXXXXXXXXXXXXXXXXXXXXXXXXXXXXX
XXXXXXXXXXXXXXXX--XXXXXX-||---|-XXXXXXXXXXXXXXXXXXXXXXXXXXXXXXXXXXXXXXXXXXXXXXXXXXXXXXXXXXXXXXXXXXXXXXXXXXXXXXXXXXXXXXXXXXXXXXXXXXXXXXXXXXXXXXXXXXXXXXXXXXXXXXXXXXXXXXXXXXXXXXXXXXXXXXXXXXXXXXXX
