------------------------------------------------------------------------------------------------------------------------------------------------------------------------------------------------
------------------------------------------------------------------------------------------------------------------------------------------------------------------------------------------------
------------------------------------------------------------------------------------------------------------------------------------------------------------------------------------------------
----------------SSSSSSSSSSSSSSSS-------------------------------------------------#--------------------------------SSSSSS-SS-----SSSSSSSS--------------------------------------------------------
----------------S-------------------------------------------------------------------------------------------------------------------------------------------------------------------------------
----------------SS-------------S----------------------------------------------------------------------------------------------------------o------------------------------------o----------------
--------%%%%%%%%SSS--------SSSSS-------------------------------o-------------------------------o-----------------oo------------o--------------------QQQQQS-----@-----------------oo-------------
---------||||||------------------------------------------------------------------------------------------------------------------------------------------------#---------------o----------------
---------||||||-----------------------------------------------------------------------------###---------------------------------------------------------------#---------------------------------
---------||||||-Sooo-----------o-----------------------------------------------------------####-----------------o---------------------------------------------#---------------------------------
------%%%%%%%%%%SSSS-S-------SSS----------------------------------------------------------#####---------------------------------------tt--------##-----------##---------------------------------
-------||||||||-T--------------------tt---------------------------------------------------#####--------tt-----------------------------tt---------------------##--------tt----#-----------TT-----
-------||||||||-T------TT----#-------tt---------------------------B-----------TT---------######--------tt----------------##-----------tt-----@--------------###--------tt---##-----------TT-----
-------||||||||-T------TT--g-#-------tt-----ggg----kgy-------kg---b-----------TT---k-k--#######-g-g----tt----ggg-----k--###-----#-----tt-----gg----kggg-----##k#g-g----tt---####-----k---TT-----
XXXXXXXXXXXXXXXXXXXXXXXXXXXXXXXXXXXXXXXXXXXXXXXXXXXXXXXXXXXXXXXXXXXXXXXXXXXXXXXXXXXXXXXXXXXXXXX-XXXXXXXXXXXXXXXXXXXXXXXXXXXXXXXXXXXXXXXXXXXXXXXXXXXXXXXXXXXXXXXXXXXXXXXXXXXXXXXXXXXXXXXXXXXXXXXX
XXXXXXXXXXXXXXXXXXX-XXXXXXXXXXXXXXXXXXXXXXXXXXXXXXXXXXXXXXXXXXXXXXXXXXXXXXXXXXXXXXXXXXXXXXXXXXX-XXXXXXXXXXXXXXXXXXXXXXXXXXXXXXXXXXXXXXXXXXXXXXXXXXXXXXXXXXXXXXXXXXXXXXXXXXXXXXXXXXXXXXXXXXXXXXXX
