------------------------------------------------------------------------------------------------------------------------------------------------------------------------------------------------
------------------------------------------------------------------------------------------------------------------------------------------------------------------------------------------------
------------------------------------------------------------------------------------------------------------------------------------------------------------------------------------------------
-----------------------------------------------------------------------------------SSSSSSSSSSSSS-------------------------SSSSSSS--------------------------SSSS-----SSSSSSSSSSSSS----------------
--------------------------------------------------------------------------------------SSSSSSSS--------------------------------------------------------------------------------------------------
--------------------------------------------------------------------------------------SSSS--SS---------------------------------------------------------------S---------------S------------------
--------%%%%%%%%--------------------SSSSSS-------------SSS---------SSSS-----SSS---SSSSSSSSSSSS--------------SS--SS---SS-----SSS---SSSSSUSSSSSSS---SSSSSSS---SSSSSSS----S---SUSS-------S-----SSS-
---------||||||--------------------------------------------------------------------------------------------------------------------------------------S-------S----------------------------------
---------||||||----------------------------------------------------S-----------------------------------SSS-----------------------------------------SS-------------------------------------------
---------||||||--------------------oo------------------------------o---------------oooo-----------------SSSS-----------------------oo--------------oo-------------------------------------------
------%%%%%%%%%%#---T------------SSSSSS-----------SS--------------SSSS-----------SSSSS------SSS---S------SSS------SSS-------------SSS-K-----------SSSS----S-----------------------SS------------
-------||||||||-#---TT------------------------------K--------------------TT----T-----------------------------------------TT----T-------------------------TT----T---------TT--------------------T
-------||||||||-----TT---------------------------------------------------TT----T-----------------------------------------TT----T-------------------------TT----T---------TT--------------------T
-------||||||||-----TT------------yg---g-k---------g--------##-----kk----TT----T---g-gg-----------K-------kkkk#----k-y---TT----T---gggg-k----k-----kk--k-TT--k-T------g-kTT--------ggg-g-k---k-T
XXXXXXXXXXXXXXXXX---XXXX-------XXXXXXXXXXXXXXXXXXXXXXXXXXXXXXXXXXXXXXXXXXXXXXXXXXXXXXXXXXXXXXXXXXXXXXXXXXXXXXXXXXXXXXXXXXXXXXXXXXXXXXXXXXXXXXXXXXXXXXXXXXXXXXXXXXXXXXXXXXXXXXXXXXXXXXXXXXXXXXXXX
XXXXXXXXXXXXXXXXX---XXXX-------XXXXXXXXXXXXXXXXXXXXXXXXXXXXXXXXXXXXXXXXXXXXXXXXXXXXXXXXXXXXXXXXXXXXXXXXXXXXXXXXXXXXXXXXXXXXXXXXXXXXXXXXXXXXXXXXXXXXXXXXXXXXXXXXXXXXXXXXXXXXXXXXXXXXXXXXXXXXXXXXX
