------------------------------------------------------------------------------------------------------------------------------------------------------------------------------------------------
------------------------------------------------------------------------------------------------------------------------------------------------------------------------------------------------
------------------------------------------------------------------------------------------------------------------------------------------------------------------------------------------------
------------------------------------------------SSSSSSS---------------------------------------------------------SSSSSSSSSSS--------------------------------------SSSSSS-------------------------
------------------------------------------------------------------------------------------------------------------------------------------------------------------------------------------------
------------------------------------------------------------------------------------------------------------------------------------------------------------------------------------------------
--------%%%%%%%%----------------------SSSS-----S---------------------QQSoS---SSS----------------------------------------------------QQQQQS----@------------------------SS-----------------------
---------||||||----------------o---------------------------------------------------------------o-------------------------------------------------#---------------------------------------------#
---------||||||---------------------------------------------------------------------TT---------------------------------------------------------------------------------------------------------#
---------||||||---------------------------------------------------------------------TT------------------------------------------------------------o---------------------------------#----------#
------%%%%%%%%%%-##-------###------------------------------------------------o------##--------------------#-----------tt--------Q------QQQ--------T--2----------------------------------------##
-------||||||||-###-------###----------------------------B--------------------------------T----#----------#-----------tt-------------------------TTT----TT-----------t-----------------t------##
-------||||||||-#T#------####--------tt-----------B------b----TT----------------T--------TT---##-----B---TT---TT------tt------T------------------TT-----TT---TT-----tt-----------------tt----###
-------||||||||-TT#-----###-k-------gtt-----------b------b----TT---k-kk-----k---T--------TT---##-----b---T#---#T------tt-----gg----ggg-----------TT-----TT--#TT-----tt----------T------tt---####
XXXXXXXXXXXXXXXXXXXXXXXXXXXXXXXXXXXXXXXXXXXXXXXXXXXXXXXXXXXXXXXXXXXXXXXXXXXXXXXXXXXXXXXXXXXXXXXXXXXXXXXXXXXXXXXXXXXXXXXXXXXXXXXXXXXXXXXXXXXXXXXXXXXXXXXXXXXXXXXXXXXXXXXXXXXXXXXXXXXXXXXXXXXXXXXX
XXXXXXXXXXXXXXXXXXXXXXXXXXXXXXXXXXXXXXXXXXXXXXXXXXXXXXXXXXXXXXXXXXXXXXXXXXXXXXXXXXXXXXXXXXXXXXXXXXXXXXXXXXXXXXXXXXXXXXXXXXXXXXXXXXXXXXXXXXXXXXXXXXXXXXXXXXXXXXXXXXXXXXXXXXXXXXXXXXXXXXXXXXXXXXXX
