------------------------------------------------------------------------------------------------------------------------------------------------------------------------------------------------
------------------------------------------------------------------------------------------------------------------------------------------------------------------------------------------------
------------------------------------------------------------------------------------------------------------------------------------------------------------------------------------------------
------------------------------------------------SSSSSSSSS--------------SSS----------------------SSSSSSSSSSSSSSSS----------------SSSSSS--------------------------SSSSSSS-------------------------
------------------------------------------------------------------------------------------------S-----------------------------------------------------------------------------------------------
------------------------------------------------------------------------------------------------------------------------------------------------------------------------------------------------
--------%%%%%%%%------SSSSS----S-oo------------------------------oo-----oo-------oo------o----------------------oooo---------SSSooo----SooS----S-oo-----------------------------Sooo--SSoSS--SSS
---------||||||---------------------------------------------------------------------------------------------------------------------------------------------------------------------------------
---------||||||--------------o----------------------------------------------------------------------------------------------------------------------------------------------------------------o-
---------||||||--o--------------ooo------------------------##--------------------o------------------------------o--------------------------------o------------------------------oo--------------
------%%%%%%%%%%------------SoS---------------------------###-#-------------------------------------------------S---------------------------------------------------------------SS---QQQ-----SSS
-------||||||||---------------------------#---------------###-#----------##------------------------------#---------------------------tt-------------------#-------------TT----------------------
-------||||||||--------------------------##---TT---------####-##---------##--------------##--------------##--------------------------tt------------------##-------------TT----@-----------------
-------||||||||----kkk-------------------##---TT-----g--#####-##-----k-####--------k-----##--------------##---g-----ggg-#-#----------tt-----k-k-----gggg###-k---k-------TT----gg-----kk-----k---
XXXXXXXXXXXXXXXXXXXXXXXXXXXXXXXXXXXXXXXXXXXXXXXXXXXXXXXXXXXXXXXXXXXXXXXXXXXXXXXXoXXXXXXXXXXXXXXXXXXXXXXXXXXXXXXXXXXXXXXXXXXXXXXXXXXXXXXXXXXXXXXXXXXXXXXXXXXXXXXXXXXXXXXXXXXXXXXXXXXXXXXXXXXXXXXX
XXXXXXXXXXXXXXXXXXXXXXXXXXXXXXXXXXXXXXXXXXXXXXXXXXXXXXXXXXXXXXXXXXXXXXXXXXXXXXXXXXXXXXXXXXXXXXXXXXXXXXXXXXXXXXXXXXXXXXXXXXXXXXXXXXXXXXXXXXXXXXXXXXXXXXXXXXXXXXXXXXXXXXXXXXXXXXXXXXXXXXXXXXXXXXXX
