------------------------------------------------------------------------------------------------------------------------------------------------------------------------------------------------
------------------------------------------------------------------------------------------------------------------------------------------------------------------------------------------------
------------------------------------------------------------------------------------------------------------------------------------------------------------------------------------------------
------------------------------------------------------------------------------------------------------------------------------------------------------------------------------------------------
------------------------------------------------------------------------------------------------------------------------------------------------------------------------------------------------
------------------------------------------------------------------------------------------------------------------------------------------------------------------------------------------------
--------%%%%%%%%---------------------------------------@------------------------SS---------QQQQ-------------------------------------------------------------------------------------------------
---------||||||---------------------------------------------------------------------------------------------------------------------------------------------------------------------------------
---------||||||---------------------------------------------------------------------------------------------------------------------------K-----------------------------------------------------
---------||||||---------------------------------------------------------------------------------------------y----------------------------SS-----------------------------------------------------
------%%%%%%%%%%-----------------------------------------------------------------------------Q-------------------TTT----------------------------------------------------------QQ--TT--------QQ--
-------||||||||-T------------------------------------------------------------------------------------------------TTT-------------------TT---------TT------------------------------TT------------
-------||||||||-T------T---tt---------------------------------------------------------B--------------------------TTTT------------------TT---------TT-----------------------------TTT------------
-------||||||||-T------T---bt--------------------gg--------------ggg------ggg-------g-b-------g----g-g-------#---TTTT---------gg-------TT---------TT--gg------gg------g---y-gggg--TT---g-----ggg
XXXXXXXXXXXXXXXXXXXXXX-XXXXXXXXXXXXXXXXXXXXXXXXXXXXXXXXXXXXXXXXXXXXXXXXXXXXXXXXXXXXXXXXXXXXXXXXXXXXXXXXXXXXXXXXXXXXXXXXXXXXXXXXXXXXXXXXXXXXXXXXXXXXXXXXXXXXXXXXXXXXXXXXXXXXXXXXXXXXXXXXXXXXXXXXX
XXXXXXXXXXXXXXXXXXXXXX-XXXXXXXXXXXXXXXXXXXXXXXXXXXXXXXXXXXXXXXXXXXXXXXXXXXXXXXXXXXXXXXXXXXXXXXXXXXXXXXXXXXXXXXXXXXXXXXXXXXXXXXXXXXXXXXXXXXXXXXXXXXXXXXXXXXXXXXXXXXXXXXXXXXXXXXXXXXXXXXXXXXXXXXXX
