--------------------------S---------------------------------------------------------------------------------------------------------------------------------------------------------------------
----------------------S---S---------------------------------------------------------------------------------------------------------------------------------------------------------------------
--------------------------S---------------------------------------------------------------------------------------------------------------------------------------------------------------------
----------------------SSSSS-------------------------------------------------------------------------------------------------------------------------------------SSSSSSSS------------------------
----------------------------------------------------------------------------------------------------------o-------------------------------------------------------------------------------------
------------------------------------------------------------------------------------------------------------------------------------------------------------------------------------------------
--------%%%%%%%%--------------------------------------QSSSSSSSSS-----------oo----------------------QQSQQQSSS---------------------ooo--SSS------S-ooo----------SS---------------------SQQ--------
---------||||||--#------------------------------SS-------------------------------#------------------------------S-------------------------------------------------------------------------------
---------||||||--------------------------------------------------------TT-----------------------------------------------------------------------------------------------------------------------
---------||||||--------------------------------ooo---------------------TT-------oo---------------------g---------------------------------------o---------------------------------------g--------
------%%%%%%%%%%---------------------------------------UQ-----S--------##--------------#------------US@#Q---SQS---------------------------------S-----------SSS------------------------2--------
-------||||||||--##----t---------------------------------------------------------------t---------@--------------------------------------------------------------------tt---------------------#--
-------||||||||--##----t------------------------------------------------------------------------------------------------B----#--------------#------------------------ttt-----TT-----------------
-------||||||||--TT----t-----ggg------------------gg-------g------gg-g---------------------g-------k------k-k-----------b----###----ggg-----k------ggg---------------ttt-----TT---gy---------#--
XXXXXXXXXXXXXXXXXXXXXXXXXXXXXXXXXXXXXXXXXXXXXXXXXXXXXXXXXXXXXXXXXXXXXXXXXXXXXXXXXXXXXXXXXXXXXXXXXXXXXXXXXXXXXXXXXXXXXXXXXXXXXXXXXXXXXXXXXXXXXXXXXXXXXXXXXXXXXXXXXXXXXXXXXXXXXXXXXXXXXXXXXXXXXXXX
XXXXXXXXXXXXXXXXXXXXXXXXXXXXXXXXXXXXXXXXXXXXXXXXXXXXXXXXXXXXXXXXXXXXXXXXXXXXXXXXXXXXXXXXXXXXXXXXXXXXXXXXXXXXXXXXXXXXXXXXXXXXXXXXXXXXXXXXXXXXXXXXXXXXXXXXXXXXXXXXXXXXXXXXXXXXXXXXXXXXXXXXXXXXXXXX
