------------------------------------------------------------------------------------------------------------------------------------------------------------------------------------------------
------------------------------------------------------------------------------------------------------------------------------------------------------------------------------------------------
------------------------------------------------------------------------------------------------------------------------------------------------------------------------------------------------
-----------------------------------S------------SSSS-SSS---------------------------------------------------------SSSSSS-------------------------SSSSSSS-------------------------SSSS------------
------------------------------------------------------------------------------------------------------------------------------------------------------------------------------------------------
------------------------------------------------------------------------------------------------------------------------------------------------------------------------------------------------
--------%%%%%%%%----------------------------------------o------o----------------------------------------------------------------------QQQ-------------------------------o-----------------------
---------||||||--o--------##--------------------------------------------------------------------------------------------------------------------------------------------------------------------
---------||||||----------###-------------------------------#------------------------------------------------------------------------------------------------------------------------------------
---------||||||----------###-------------------------------#---------------------------------------------------------------------o--------------------------------------------------------------
------%%%%%%%%%%---------###------------------------------####----------------------------------------------##--------------###-----------------------------------------------------------------
-------||||||||---TT----###------------------------------#####-------------------------------------------TT##--------------####---------------------------#-------------------------------------
-------||||||||---TT--######------B-----------TT---------#####----------TT---#--------#------------------TT##-#------tt--#-####--------------------------##---o-------------------B-----tt------
-------||||||||---TT--######------b-----------TT-----k--######----------TT---##-#-----#------k-------k---TT##-#------tt--######----ygggy-----gg---k----k-##--g#------k----#-------b-----tt----g-
XXXXXXXXXXXXXXXXXXXXXXXXXXX-XXXXXXXXXXXXXXXXXXXXXXXXXXXXXXXXXXXXXXXXXXXXXXXXXXXXXXXXXXXXXXXXXXXXXXXXXXXXXXXXXXXXXXXXXXXXXXXXXXXXXXXXXXXXXXXXXXXXXXXXXXXXXXXXXXXXXXXXXXXXXXXXXXXXXXXXXXXXXXXXXXXX
XXXXXXXXXXXXXXXXXXXXXXXXXXX--XXXXXXXXXXXXXXXXXXXXXXXXXXXXXXXXXXXXXXXXXXXXXXXXXXXXXXXXXXXXXXXXXXXXXXXXXXXXXXXXXXXXXXXXXXXXXXXXXXXXXXXXXXXXXXXXXXXXXXXXXXXXXXXXXXXXXXXXXXXXXXXXXXXXXXXXXXXXXXXXXXX
