------------------------------------------------------------------------------------------------------------------------------------------------------------------------------------------------
------------------------------------------------------------------------------------------------------------------------------------------------------------------------------------------------
------------------------------------------------------------------------------------------------------------------------------------------------------------------------------------------------
--------------------------------SSSSSSSSS-----------------------------------------------------------------------------------------------------------------------SSSSSSSSSSSS-SSS----------------
------------------------------------------------------------------------------------------------------------------------------------------------------------------------------------------------
--------------------------o---------------------------------------------------------------------------------------------------------------------------------------------------------------------
--------%%%%%%%%-%%------%%-----------------------------oo-------------------------------------------------------o------oo-------------------------------------S--------------------QQQQSSS---@-
---------||||||--||------||----------------------------------------------------------------------------------------%%%%-------------------------------------------------------------------------
---------||||||--||------||-----------------------------------------------------------------------------------------||--------------------------------------------------------------------------
---------||||||--||------||-----------------------------------------------------------------------------------------||--------------------------------------------------------------------------
------%%%%%%%%%%-||------%%----------------------------------o------------------------------------------------------||-----------------------------------------------------------------QQQ--SSS-
-------||||||||--||------||--------------------------------------------------##-------------------------------------||-----------------------------------TT--#-------2--------------------------
-------||||||||--||------||--------------#-----------------------------#-----##-------------------B-----TT----------tt------------B-----TT---TT----------TT--#-----------TT---------------------
-------||||||||--||------||----o-----g---###--g------k----------g------#-----##---gy--------------b-----TT---###----tt------------b-----TT---TT----------TT--##------g---TT---g----------------#
XXXXXXXXXXXXXXXX-%%%-X-XXXXX%%%%XXXXXXXXXXXXXXXXXXXXXXXXXXXXXXXXXXXXXXXXXXXXXXXXXXXXXXXXXXXXXXXXXXXXXXXXXXXXXXXXXXXXXXXXXXXXXXXXXXXXXXXXXXXXXXXXXXXXXXXXXXXXXXXXXXXXXXXXXXXXXXXXXXXXXXXXXXXXXXXX
XXXXXXXXXXXXXXXX--|----XX-XX-||-XXXXXXXXXXXXXXXXXXXXXXXXXXXXXXXXXXXXXXXXXXXXXXXXXXXXXXXXXXXXXXXXXXXXXXXXXXXXXXXXXXXXXXXXXXXXXXXXXXXXXXXXXXXXXXXXXXXXXXXXXXXXXXXXXXXXXXXXXXXXXXXXXXXXXXXXXXXXXXXX
