------------------------------------------------------------------------------------------------------------------------------------------------------------------------------------------------
------------------------------------------------------------------------------------------------------------------------------------------------------------------------------------------------
------------------------------------------------------------------------------------------------------------------------------------------------------------------------------------------------
---------------------------S---SSSSSSSSS-------------------------SSSS----------------------------S------------------------------SSSSSSS-------------------------SSSSSSSSS----SSS----------------
------------------------------------------------------------------------------------------------------------------------------------------------------------------------------------------------
------------------------------------------------------------------------------------------------------------------------------------------------------------------------------------------------
--------%%%%%%%%-------------------------------------Q-Q-------o-----------------ooo-----------o-----------------ooo-SSSSS---SoS------------------o--SS--------------------------oo---SS--------
---------||||||---------------------------------------------------------------------------------------------------------------------------------------------------------------------------------
---------||||||-----------SS-SSS--------------S--------------------------------------------------------------------------------------------------------------------------------------------##---
---------||||||-S----------SoSSS--------------------------------------------------------------------#--------------------------------------------------------------------------------------##---
------%%%%%%%%%%S-----------SSSS----------------------------------------------------------#---------------------S---QQ-------S--------------#-#-------------------------------------------####--
-------||||||||--------------------------------------------------------------------------##--------------------------------------------tt---###----------TT------------------------------#####--
-------||||||||------------------------------------------------------ttt-----------------##-------------TT---TT------------------------tt--####----------TT-------------tt---TT-----tt--######--
-------||||||||------------------------------kkg--gy---------#-------ttt------g----k-y--###-------b-----TT---TT----k-kk---------g------tt--####----kggg--TT-----k-------tt---TT-----ttk########-
XXXXXXXXXXXXXXXXXXXXXXXXXXXXXXXXXXXXXXXXXXXXXXXXXXXXXXXXXXXXXXXXXXXXXXXXXXXXXXXXXXXXXXXXXXXXXXXXXXXXXXXXXXXXXXXXXXXXXXXXXXXXXXXXXXXXXXXXXXXXXXXXXXXXXXXXXXXXXXXXXXXXXXXXXXXXXXXXXXXXXXXXXXXXXXXX
XXXXXXXXXXXXXXXXXXXXXXXXXXXXXXXXXXXXXXXXXXXXXXXXXXXXXXXXXXXXXXXXXXXXXXXXXXXXXXXXXXXXXXXXXXXXXXXXXXXXXXXXXXXXXXXXXXXXXXXXXXXXXXXXXXXXXXXXXXXXXXXXXXXXXXXXXXXXXXXXXXXXXXXXXXXXXXXXXXXXXXXXXXXXXXXX
