------------------------------------------------------------------------------------------------------------------------------------------------------------------------------------------------
------------------------------------------------------------------------------------------------------------------------------------------------------------------------------------------------
------------------------------------------------------------------------------------------------------------------------------------------------------------------------------------------------
-----------------S--------------SSSSSSSSSSSSSSSS--------------------------------SSSSSSSSSSSSSSSSSSSSSSSSSS----------------------SSSS------------SSSSSSSSSSSSSSSS--------------------------------
--------------------------------SS----------------------------------------------S----------------------------------------------------------------S----------------------------------------------
---------------------------------S--------------------------------------------------------------------------------------------------------------------------------------------------------------
--------%%%%%%%%--------So------ooo----SS-------oooo--SSoo----SS--o-----------------------------oooo--SSoo---SSSSSSSSSS------SSS--------------------------------SoooSSSSoo---SSS----QS--------SS
---------||||||---------------------------------------------------------------------------------------------------------------------------------------------------------------------------------
---------||||||------------------------------SS-------------------------------------------------------------------------------------------------------------------------------------------------
---------||||||---------------------------------ooo---------------------------------------------oo--------------oooo--------------------------------------------o-oo----------------------------
------%%%%%%%%%%------------------------------------------------------------------------------------------------SSSSSS--------SS--------------------------------SS--QQ-------SSS--------------S-
-------||||||||---------------------tt------------------------------------#-----o-----------------------------K-----------#---------------------------------------------------------------K-----
-------||||||||---------------------tt---###------------------------------#----------------------------------------------##-----------------------------------TT--------------------------------
-------||||||||------k--------kg----tt---###---------yk-----k-------gggg-##---k-%%--------------------k----gk--------ggg###-----%%k------k---g-------k---g----TT-----kggg----------ggggg--#---k-
XXXXXXXXXXXXXXXXXXXXXXXXXXXXXXXX--XXXXXXXXXXXXXXXXXXXXXXXXXXXXXXXXXXXXXXXXXXXXXXXXXXXXXXXXXXXXXXXXXXXXXXXXXXXXXXXXXXXXXXXXXXXXXXXXXXXXXXXXXXXXXXXXXXXXXXXXXXXXXXXXXXXXXXXXXXXXXXXXXXXXXXXXXXXXXX
XXXXXXXXXXXXXXXXXXXXXXXXXXXXXXXXXXXXXXXXXXXXXXXXXXXXXXXXXXXXXXXXXXXXXXXXXXXXXXXXXXXXXXXXXXXXXXXXXXXXXXXXXXXXXXXXXXXXXXXXXXXXXXXXXXXXXXXXXXXXXXXXXXXXXXXXXXXXXXXXXXXXXXXXXXX-XXXXXXXXXXXXXXXXXXXX
