--------------------------------------------------------------------------------------------------------------------------------------------------------------------------------
--------------------------------------------------------------------------------------------------------------------------------------------------------------------------------
--------------------------------------------------------------------------------------------------------------------------------------------------------------------------------
---------------------------------#----------------------------------------------------------------------------------------------------------------------------------------------
---------------------------------#-k---------------k----------------------------------------------------------------------------------------------------------------------------
--------------------------------%#%-----------------------------------------------------------------------------------------------##--------------------------------------------
----Q-------US-o----------------|-|---r-----------------------------SSS----------SS--------------------------------------------o-----------------------------o--SS--------------
--------------------------------|-|--%%%-----------------------------------------------------------------------------------------------------------------oo-------oooo----------
--------------------------------|-|---|-------------------------------------------------------------------------------------------------SS--------------------------------------
--------------------------oo----|-|---|--------------------------------------------------------------------------------------------------SS-------------------------------------
-Q-Q----------------------------|-|---|---------------------------SSS-----------TT-----------------------------Q---S--------------S--------------SS-------------TT--------------
--------------------------------|-|---|-----TT------K--------#------------------TT-------TT----T-------------------------TT---TT----tt------------------------TTTT----tt-TT----T
--------------------------------|-|---|--TT-TT---------TT---##-----------------TTT----B--TT----T----tt-TT--tt------------TT---TT----tt-TT--B------------------TTTT----tt-TT----T
---g-----------T-------------k--|-|---|k-TT-TT---------TT---###----------k-----TTT----b-kTT----T----tt-TT--tt------ggg---TT---TT----tt-TT--b-------------TT---TTTT----ttkTT----T
XXXXXXXXXXXXXXXXXXXXXXXXXXXXXXXXXXXXXXXXXXXXXXXXXXXXXXXXXXXXXXXXXXXXXXXXXXXXXXXXXXXXXXXXXXXXXXXXXXXXXXXXXXXXXXXXXXXXXXXXXXXXXXXXXXXXXXXXXXXXXXXXXXXXXXXXXXXXXXXXTXXXXXXXXXXXXXXX
XXXXXXXXXXXXXXXXXXXXXXXXXXXXXXXXXXXXXXXXXXXXXXXXXXXXXXXXXXXXXXXXXXXXXXXXXXXXXXXXXXXXXXXXXXXXXXXXXXXXXXXXXXXXXXXXXXXXXXXXXXXXXXXXXXXXXXXXXXXXXXXXXXXXXXXXXXXXXXXXTXXXXXXXXXXXXXXX
