------------------------------------------------------------------------------------------------------------------------------------------------------------------------------------------------
------------------------------------------------------------------------------------------------------------------------------------------------------------------------------------------------
------------------------------------------------------------------------------------------------------------------------------------------------------------------------------------------------
------------------------------------------------------------------------------------------------------------------------------------------------------------------------------------------------
------------------------------------------------------------------------------------------------------------------------------------------------------------------------------------------------
------------------------------------------------------------------------------------------------------------------------------------------------------------------------------------------------
--------%%%%%%%%--QSQQS@SQQQSSSS------------------------------------------------S------------------------------o%%%%-----------o-----------------%%----------Q--%%------------------------------
---------||||||---------------------------------------------------------------------o----------------------------||-o----------------------------||-------------o|--oo--------------------oo----
---------||||||--------------------------------------------------------------------------------------------------||------------------------------||-------------||------------------------------
---------||||||--------------------------------------------------------------------------------------------------||------------------------------||-------------||------------------------------
------%%%%%%%%%%QSQS---SQQQQQQ-------------------------------------So--------------------------------------------|TT--------------TT-------------||-------------|TTT----------------------------
-------||||||||---------------------------------TT--------------------------------TT-----TT----------------------|TT-----TT---TT--TT---TT--------||-------------|TTT-----TT------------TT-------
-------||||||||--------------------------TT-----TT---------tt--------------------TTT--tt-TT----------------B-----|TT-----TT---TT--TT---TT--tt----|TT------------|TTTT----TT------------TT-------
-------||||||||---------------g----ggg-g-TT---g-TT---------tt-g----ggg-g---------TTT--tt-TT----g-gg--------b--g--|TT-----TT---TT--TT---TT--tt----|TT---g-----ggg|TTTT----TT---gg-k-----TT-k-----
XXXXXXXXXXXXXXXXXXXXXXXXXXXXXXXXXXXXXXXXXXXXXXXXXXXXXXXXXXXXXXXXXXXXXXXXXXXXXXXXXXXXXXXXXXXXXXXXXXXXXXXXXXXXXXXXXXXXXXXXXXXXXXXX-XXXX--XX--XXXX-XXXXXXXXXXXXXXXXXXXXXXXXXXXXXXXXXXXXX--XXXXXXXXX
XXXXXXXXXXXXXXXXXXXXXXXXXXXXXXXXXXXXXXXXXXXXXXXXXXXXXXXXXXXXXXXXXXXXXXXXXXXXXXXXXXXXXXXXXXXXXXXXXXXXXXXXXXXXXXXXXXXXXXXXXXXXXXXXXXXXX--XX--XXXX-XXXXXXXXXXXXXXXXXXXXXXXXXXXXXXXXXXXXXX-XXXXXXXXX
