------------------------------------------------------------------------------------------------------------------------------------------------------------------------------------------------
------------------------------------------------------------------------------------------------------------------------------------------------------------------------------------------------
------------------------------------------------------------------------------------------------------------------------------------------------------------------------------------------------
--------------------------------SS------------------------------------------------SSSSSS-SS----S--------------------------------SSSSSSSSSSS-----------------------------------------------------
------------------------------------------------------------------------------------------------------------------------------------------------------------------------------------------------
-------------------------------------------------------------------------------------------------------------------------------------------------------------------------------o----------------
--------%%%%%%%%------------------------S------------QQSSSS----Soooo-----------o---------------------QQQoS---SSSSSSSQS---------#----------------------SSoS---SSo---------------S-ooo-----------o
---------||||||---------------------%%%---------------------------------------------------------------------------------------------------------------------------------------------------------
---------||||||----------------------|----------------------------------------------------------------------------------------o---------------------------------S-------------------------------
---------||||||----------------------|--------------------------o-----------------------------------------------------------------------------------------------S-------------------------------
------%%%%%%%%%%---------------------|tt--------------QQQ---SQS----------------------------------------------o---------------US------------------------------o---------------------------TT-----
-------||||||||----------T----T------|tt----------------------------------#--------------T-------------t------------------K--------------B------------t----------------------------------TT-----
-------||||||||----------TT----------ttt---------------------------------TT--------------TT---#--------t--------------------------B--B---b----T-------t----------------K-----------------TT-----
-------||||||||------ggg-TT-kkkT-----ttt-----gg----k----------------gggg-##-----k--------TT---#T------tt----k------k-ggo--k-------b--b---b---gg------kt-----k-----ggg--b----##-----k--y--TT-----
XXXXXXXXXXXXXXXXXXXXXXXXXXXXXXXXXXXXXXXXXXXXXXXXXXXXXXXXXXXXXXXXXXXXXXXXXXXXXXXXXXXXXXXXXXXXXXXXXXXXXXXXXXXXXXXXXXXXXXXXXXXXXXXXXXXXXXXXXXXXXXXXXXXXXXXXXXXXXXXXXXXXXXXXXXXXXXXXXXXXXXXXXXXXXXXX
XXXXXXXXXXXXXXXXXXXXXXXXXXXXXXXXXXXXXXXXXXXXXXXXXXXXXXXXXXXXXXXXXXXXXXXXXXXXXXXXXXXXXXXXXXXXXXXXXXXXXXXXXXXXXXXXXXXXXXXXXXXXXXXXXXXXXXXXXXXXXXXXXXXXXXXXXXXXXXXXXXXXXXXXXXXXXXXXXXXXXXXXXXXXXXXX
