------------------------------------------------------------------------------------------------------------------------------------------------------------------------------------------------
------------------------------------------------------------------------------------------------------------------------------------------------------------------------------------------------
------------------------------------------------------------------------------------------------------------------------------------------------------------------------------------------------
----------------SSSSSSSSSSSSS--------------------SSSSSS---------SSSSSSSSSSSSSSSSSSSSSSSSSSSSSSSS------------------S-------------SSSSSSSSSSSSSSSS-----SSSS-----------------------SSSS------------
--------------------------------------------------------------------------------------------------------------------------------SS--------------------------------------------------------------
--------------------------------------------------------------------------------------------------------------------------------SS--------------------------------------------------------------
--------%%%%%%%%----------------oooo--SS--------ooo---SSSS--------------------------------------SSSS@SSS------@S--------------------------------Sooo---So----SoSSSSS@SS------SSS----------------
---------||||||---------------------------------------------------------------------------------------------------------------------------------------------------------------------------------
---------||||||-----------------------------------------------------------------------------------------------o---------------------------------------------------------------o-#---------------
---------||||||-----------------o--------------o--------------------------------o---------------o-----------------------------------------------o-------------ooo-------------------------------
------%%%%%%%%%%--------------------------------------------------------------------------------#------------@SS--------------------------------S---o--------SSS#-----------S@SS----------------
-------||||||||-------------------------------------tt--------------------#--------------##------------------------------TT---TT------------------------------------------K---------------------
-------||||||||----------TT--------------##---------tt---#---------------##---TT-----#---##---#--------------------------TT---TT--------------------------------------------------------------TT
-------||||||||----k-g---TT----------g--###-#-------tt---#-----S---------##---TT-----#--####--#----gggg-----------kg-g---TT---TT----------------------------k------kgggg--k------------k------TT
XXXXXXXXXXXXXXXXXXXXXXXXXXXXXXXXXXXXXXXXXXXXXXXX--XXXXXXXXXXXXXXXXXXXXXXXXXXX-XXXXXXXXXXXXXXXXXXXXXXXXXXXXXXXXXXXXXXXXXXXXXXXXXXXXXXXXXXXXXXXXXXXXXXXXXXXXXXXXXXXXXXXXXXXXXXXXXXXXXXXXXXXXXXXXXX
XXXXXXXXXXXXXXXXXXXXXXXXXXXXXXXXXXXXXXXXXXXXXXXXX-XXXXXXXXXXXXXXXXXXXXXXXXXXX-XXXXXXXXXXXXXXXXXXXXXXXXXXXXXXXXXXXXXXXXXXXXXXXXXXXXXXXXXXXXXXXXXXXXXXXXXXXXXXXXXXXXXXXXXXXXXXXXXXXXXXXXXXXXXXXXXX
