------------------------------------------------------------------------------------------------------------------------------------------------------------------------------------------------
------------------------------------------------------------------------------------------------------------------------------------------------------------------------------------------------
------------------------------------------------------------------------------------------------------------------------------------------------------------------------------------------------
--------------------------------SSSSSSSSSSSSSSSSSSSSSSSSS-----------------------SSSSSSSSSSSS----SSSSSSSSSSSSSSSS------------------SSSSS---------SSSSSSSSSSSSSSSS--------------------------------
---------------------------------S--------------------------------------------------------------S-----------------------------------------------------------------------------------------------
------------------------------------------------------------------------------------------------------------------------------------------------------------------------------------------------
--------%%%%%%%%------SSSS---------------------S-oo----SSo-----------S----------ooo-----SSSS-SSS----------------SooSSSS------SSS-----------------o------------SSoooo---ooo---SoS-oo------------o
---------||||||---------------------------------------------------------------------------------------------------------------------------------------------------------------------------------
---------||||||---------------------------------------------------------------------------------------------------------------------------------------------------------------------------------
---------||||||-----------------------------------------------------------------o-----------#-------------------oooo--------------------------------------------o---------------oo--------------
------%%%%%%%%%%--------------------------#-----------------------------------------------#####-----------------SSSSS--------S----------------------------------S----o--------------------------
-------||||||||---------------------------##--------ttk-------------------K--------------#######-----SS----------------------------------TT----------tt----------------------------------TT-----
-------||||||||------tt--------------#---###--------ttt---------------------------------########-----tt-------------------#--------------TT---TT-----tt----------------------------------TT-----
-------||||||||------tt-----k-k------#--####--#-----ttt----ggg------gggk------ko-------#########-----tt----g--#-----gggg-##-------g--g---TT---TT-----tt-----k--------k--###--------kgggg-TT-----
XXXXXXXXXXXXXXXXXXXXXXXXXXXXXXXXXXXXXXXXXXXXXXXXXXXXXXXXXXXXXXXXXXXXXXXXXXXXXXXXXXXXXXXXXXXXXXXXXXXXXXXXXXXXXXXXXXXXXXXXXXXXXXXXXXXXXXXXXXXXXXXXXXXXXXXXXXXXXXXXXXXXXXXXXXXXXXXXXXXXXXXXXXXXXXXX
XXXXXXXXXXXXXXXXXXXXXXXXXXXXXXXXXXXXXXXXXXXXXXXXXXXXXXXXXXXXXXXXXXXXXXXXXXXXXXXXXXXXXXXXXXXXXXXXXXXXXXXXXXXXXXXXXXXXXXXXXXXXXXXXXXXXXXXXXXXXXXXXXXXXXXXXXXXXXXXXXXXXXXXXXXXXXXXXXXXXXXXXXXXXXXXX
