------------------------------------------------------------------------------------------------------------------------------------------------------------------------------------------------
------------------------------------------------------------------------------------------------------------------------------------------------------------------------------------------------
------------------------------------------------------------------------------------------------------------------------------------------o-----------------------------------------------------
----------------SSSSSSSSSSSSSSSSSSSSSSSSSSSSSSSS-------------------------------------S----------SSSSSSSS------------------------SSSSSSS--------------------------------------------SSS----------
------------------------------------------------------------------------------------------------------------------------------------------------------------------------------------------------
-------------------------------------------------------------------------------------------------------------------------------------------oo---------------------------------------------------
--------%%%%%%%%SSS---------------------S--------ooo-----------o-----------------o-----Soo----SS---------------S--------------------------SSS---------Soo-----------------------oooo--SSo-----SS
---------||||||--------------------------------------------------#------------------------------------------------------------------------------------------------------------------------------
---------||||||---------------------------------------------------------------------------------------------------------------##------------------------------------T---------------------------
---------||||||--oo-----#------------------------------------------------------------------------------o----------------------##------------------------------------#-----------o---------------
------%%%%%%%%%%SSSS---TT-------------tt---------------------------------------------o-----------------t-----------------TT-###--------t--------------------------------------------------------
-------||||||||-------TTT----TT------ttt-----------------TT---------------#----------tt---------T------tt----##----------TT-#-##-------tt--------------------------------T----------------#-----
-------||||||||-------TTT----TT------ttt-----------------TT--------------TT---##-----tt---------T------TT----TT----------TT--##--------tt-------------------------B-----TT-----------t---##-----
-------||||||||--TT---kTT----kT------ttt-----ggg---k-k---TT--------gggg--TT---##-----tt---------T------TT--##T#----k-----TT---##T-----ttt---kk-------kkk----k---TTb-----TT---gg------to-###-----
XXXXXXXXXXXXXXXXXXXXXXXXXXXXXXXXXXXXXXXXXXXXXXXXXXXXXXXXXXXXXXXXXXXXXXXXXXXXXXXXXXXXXXXXXXXXXXXXXXXXXXXXXXXXXXXXXXXXXXXXXXXXXXXXXXXXXXXXXXXXXXXXXXXXXXXXXXXXXXXXXXXXXXXXXXXXXXXXXXXXXXXXXXXXXXXX
XXXXXXXXXXXXXXXXXXXXXXXXXXXXXXXXXXXXXXXXXXXXXXXXXXXXXXXXXXXXXXXXXXXXXXXXXXXXXXXXXXXXXXXXXXXXXXXXXXXXXXXXXXXXXXXXXXXXXXXXXXXXXXXXXXXXXXXXXXXXXXXXXXXXXXXXXXXXXXXXXXXXXXXXXXXXXXXXXXXXXXXXXXXXXXXX
