------------------------------------------------------------------------------------------------------------------------------------------------------------------------------------------------
------------------------------------------------------------------------------------------------------------------------------------------------------------------------------------------------
------------------------------------------------------------------------------------------------------------------------------------------------------------------------------------------------
-----------------SS-----------------------------SSSS--S---------SSSSSSSS------------------------SSSSSSS---------------------------------------------------------SSSSSSS-------------------------
----------------------------------------------o-------------------------------------------------------------------------------------------------------------------------------------------------
------------------------------------------------------------------------------------------------------------------------------------------------------------------------------------------------
--------%%%%%%%%-----------------ooo--SSoSS--S@S-------------------------------S--oo-----------------------------------oo------S---------------S-o----Soo-----SS---------------S----------------
---------||||||---------------------------------------------------------------------------------------------------------------------------------------------------------------------------------
---------||||||------------------------------S-S----------------------------------------------------------------------------------------------------------------------------------------------#-
---------||||||------------------------------------------------------------------------------------------------------------------------------##---------------------------------------------###-
------%%%%%%%%%%--------------------oo-------US-----------------------t-------------------------------tt--------------Q------o--------------###-------------------------------#----------TT-###-
-------||||||||----------------------------------------t--------------t------------------TT-----------tt---------------------------------TT####-------t----------------tt----##----------TT-###-
-------||||||||---------------------------------------tt-----TT------tt--#---------------TT-----------tt--------------------------------TTT####------tt----------------tt---###----------TT####-
-------||||||||--------------ooo----ty------------k---tt-----TTg-----tt--#----g---gggg---TT---#-------tt----ggg-#------k----k-----gg----TTT####------tt----#g---g------Tt--####---k--k---TT####-
XXXXXXXXXXXXXXXXXXXXXXXXXXXXXX%XXXXXXXXXXXXXXXXXXXXXXXXXXXXXXXXXXXXXXXXXXXXXXXXXXXXXXXXXXXXXXXXXXXXXXXXXXXXXXXXXXXXXXXXXXXXXXXXXXXXXXXXXXXXXXXX-XXXXXXXXXXXXXXXXXXXXXXXXXXXXXXXXXXXXXXXXXXXXXXX-
XXXXXXXXXXXXXXXXXXXXXXXXXXXXXXXXXXXXXXXXXXXXXXXXXXXXXXXXXXXXXXXXXXXXXXXXXXXXXXXXXXXXXXXXXXXXXXXXXXXXXXXXXXXXXXXXXXXXXXXXXXXXXXXXXXXXXXXXXXXXXXX-XXXXXXXXXXXXXXXXXXXXXXXXXXXXXXXXXXXXXXXXXXXXXXX-
