------------------------------------------------------------------------------------------------------------------------------------------------------------------------------------------------
------------------------------------------------------------------------------------------------------------------------------------------------------------------------------------------------
------------------------------------------------------------------------------------------------------------------------------------------------------------------------------------------------
----------------------------------------------------------------SS------------------------------------------------SSSSSS-----------------------------------------SSSSSSSSS------SSSSSSS---------
------------------------------------------------------------------------------------------------------------------------------------------------------------------------------------------------
--------------------------------------------------------------------------o------------------------------------------------------------------------------------o--------------------------------
--------%%%%%%%%----------------------------------oo--SSo------S--------------------------------------------------------oo-------------------------------------S-----------------------SS-------
---------||||||---------------------------------------------------------------------------------------------------------------------------------------------------------------------------------
---------||||||-----------------------------------------------o-------------------------------#-------------------------------------------------------------------------------------------------
---------||||||------------------o--------------o---------------------------------------------#-------------------------------------------------------------------------------------------------
------%%%%%%%%%%---SSSS---------SSS----------SS--------------SSS-----------------------------###---------TT----------------------------------##--------------SS-----------#-#----------------o--
-------||||||||-------------------------------K-----------------------tt-----##--------tt---###----------TT---------------------------------###---------------------------#-##-------tt---------
-------||||||||---------TT--------------------------------------------tt-----##--------tt---###----------TT---------tt---##-----------------###-------------------------TT--##-------tt---------
-------||||||||---------TT--------ggggg----gk------k-g----------------tt-----##-g-g----tt--####---ggggy--TT---------tt---##---k------------####---gggg----k-------y-----TT--##-g-----tt-----kggg
XXXXXXXXXXXXXXXXXXXXXXXXXXXXXXXXXXXXXXXXXXXXXXXXXXXXXXXXXXXXXXXXXXXXXXXXXXXXXXXXXXXXXXXXXXXXXXXXXXXXXXXXXXXXXXXXXXXXXXXXXXXXXXXXXXXXXXXXXXXXXXX-XXXXXXXXXXXXXXXXXXXXXXXXXXXXXXXXXXXXXXXXXXXXXXXX
XXXXXXXXXXXXXXXXXXXXXXXXXXXXXXXXXXXXXXXXXXXXXXXXXXXXXXXXXXXXXXXXXXXXXXXXXXXXXXXXXXXXXXXXXXXXXXXXXXXXXXXXXXXXXXXXXXXXXXXXXXXXXXXXXXXXXXXXXXXXXXX-XXXXXXXXXXXXXXXXXXXXXXXXXXXXXXXXXXXXXXXXXXXXXXXX
