------------------------------------------------------------------------------------------------------------------------------------------------------------------------------------------------
------------------------------------------------------------------------------------------------------------------------------------------------------------------------------------------------
------------------------------------------------------------------------------------------------------------------------------------------------------------------------------------------------
----------------------------------------------------------------------------------------------------------------SSSSSSSS------------------------------------------------------------------------
-----------------------------------------------------------------------------------------------#------------------------------------------------------------------------------------------------
---------------------------------------------------------oooo-----------------------------------------------------------------------------------------------------------------------------------
--------%%%%%%%%%%%-------------------SSS------------------------------------------------------------QQQo------------------------------Q-------o------------------------------------------------
---------||||||--|--------------------oo---------------------ooo-o------------oo----------------------------------------------------------------------------------------------------------------
---------||||||--|------------------------------------------------------------------------------------------------------------------------------------------------------------------------------
---------||||||--|-----------------------------------------------------------------------------#------------------------------------------------------------------------------------------------
------%%%%%%%%%%-|-------------------------------#-----#----#-------------------#####---------#####----------U--------t----------------------------------TT---------------#--------------------#
-------||||||||--|-------------------------------#-----T#--##-------------------#-------------##-##-------------------tt---------------------------------TT--------------##------------tt-----##
-------||||||||--|-------------------t-----------#-----TT-###-------------------T------------##T---------------------ttt------T-------------------B------TT---B------B---##------------tt----###
-------||||||||--|-------------o---ggt----------TTg----TT-###-----------------#-T-----gy-----###---k-ggg----kkk------ttt----kkTT--gy---y-----k----b------TT---g------t-g###-----------ttt---g###
XXXXXXXXXXXXXXXX-|-XXXXXXXXXX%%%XXXXXXXXXXXXXXXXXXXXXXXXXXXXXXXXXXXXXXXXXXXXXXXXXXXXXXXXXXXXXXXXXXXXXXXXXXXXXXXXXXXXXXXXXXXXXXXXXXXXXXXXXXXXXXXXXXXXXXXXXXXXXXXXXXXXXXXXXXXXXXXXXXXXXXXXXXXXXXXX
XXXXXXXXXXXXXXXX-|-XXXXXXXXXX-|-XXXXXXXXXXXXXXXXXXXXXXXXXXXXXXXXXXXXXXXXXXXXXXXXXXXXXXXXXXXXXXXXXXXXXXXXXXXXXXXXXXXXXXXXXXXXXXXXXXXXXXXXXXXXXXXXXXXXXXXXXXXXXXXXXXXXXXXXXXXXXXXXXXXXXXXXXXXXXXXX
