------------------------------------------------------------------------------------------------------------------------------------------------------------------------------------------------
------------------------------------------------------------------------------------------------------------------------------------------------------------------------------------------------
------------------------------------------------------------------------------------------------------------------------------------------------------------------------------------------------
--------------------------------SSSSSSSS--------------------------------------------------------SSSSSSSSSSSSSSSS----------------SSSSSSS----------SSSSS------------------------------------------
------------------------------------------------------------------------------------------------------------------------------------------------------------------------------------------------
------------------------------------------------------------------------------------------------------------------------------------------------------------------------------------------------
--------%%%%%%%%S-----S-------------------------------S--------------------------ooo----oo----oo--------------------QQQQQ------------------------oo---------------------------------Q----------S
---------||||||---------------------------------------------------------------------------------------------------------------------------------------------------------------------------------
---------||||||-----------------------------------------------------------------------------------------------------------------------------------------------S-------------------------------o-
---------||||||---------------------------------------------------------------------------------------------------------------------------------------------------------------------------------
------%%%%%%%%%%---------SSSS@So---------------------------------------------------------------------------------#-----S-----Q--------------------------------------------------------------S@S-
-------||||||||---------------------------------------------------------------------------#---------------------------------------------TTT-----------------------------------------------------
-------||||||||----------------@-------##----TT-------------------------B----------------##---------------------------------------------TTT---o-----tt----------------tt------------------------
-------||||||||---gggg----------------###----TT---ggg--k-----k----g-----b-----g----k----###----------k--g----y----ggggg-----------k-----TTT---#g----tt------------g---tt-----ggg---kgggg--k-----
XXXXXXXXXXXXXXXXXXXXXXXXXXXXXXXXXXXXXXXXXXXXXXXXXXXXXXXXXXXXXXXXXXXXXXXXXXXXXXXXXXXXXXXXXXXXXXXXXXXXXXXXXXXXXXXXXXXXXXXXXXXXXXXXXXXXXXXXXXXXXXXXXXXXXXXXXXXXXXXXXXXXXXXXXXXXXXXXXXXXXXXXXXXXXXXX
XXXXXXXXXXXXXXXXXXXXXXXXXXXXXXXXXXXXXXXXXXXXXXXXXXXXXXXXXXXXXXXXXXXXXXXXXXXXXXXXXXXXXXXXXXXXXXXXXXXXXXXXXXXXXXXXXXXXXXXXXXXXXXXXXXXXXXXXXXXXXXXXXXXXXXXXXXXXXXXXXXXXXXXXXXXXXXXXXXXXXXXXXXXXXXXX
