------------------------------------------------------------------------------------------------------------------------------------------------------------------------------------------------
------------------------------------------------------------------------------------------------------------------------------------------------------------------------------------------------
------------------------------------------------------------------------------------------------------------------------------------------------------------------------------------------------
------------------------------------------------------------------------------------------------------------------------------------------------------------------------------------------------
--------------------------------------------------------------------------------------------------------------------------------------------------------------------------------%---------------
------------------------------------------o---------------oo--o-----------------------------------------------------------------------------------------------------------------|---------------
--------%%%%%%%%--@SQQSooooo--@%----------------------------------------------------------------%%%-------------------------------------------------------------%%%---------Q---%%%-------------
---------||||||----------------|-----------------------------------------o----------o------------|---------------------------------------ooo---------------------|--oo----------o|--------------
---------||||||----------------|-----------------------------------------------------------------|---------------------------------------------------------------|---------------|--------------
---------||||||-------------2--|-----------------------------------------------------------------|---------------------------------------------------------------|---------------|--------------
------%%%%%%%%%%----------SSQ--|--TT----------------------------------------TT-------------------|TT--------------------------------------------------SSU--------|T--------------TTT------------
-------||||||||------------#---|--TT--------TT----TT--------TT--------------TT-------------------TTT------------------------TT----TT------------------------TT---TTT-----TT------TTT------------
-------||||||||----%----K--#---|--TT--------TT----TT--------TT--------------TT----TT---T---------TTT------------------------T#----TT------------------------TT---TTT-----TT------TTTT-----------
-------||||||||----g-U-----#---|--TT-----y--TT----TT-----y--TT----ggg-----k-TT----TT---TT--------TTT--g--------g--ggy---y-#-##----TT---------------g---ggg--TT-k-TTT--g--TT---gg-TTTT---------gg
XXXXXXXXXXXXXXXXX--XXXXXXXXXXXXX-XXXXXXXXXXXXXXX-XXXXXXXXXXXXXXXXXXXXXXXXXXXXXXXXXXXXXXXXXXXXXXXXXXXXXXXXXXXXXXXXXXXXXXXXXXXXXXXXXXXXXXXXXXXXXXXXXXXXXXXXXXXXXXXXXXXXXXXXXXXXXXXXXXXXXXXXXXXXXXX
XXXXXXXXXXXXXXXXX--XXXXXXXXXXXXXXXXXXXXXXXXXXXXXXXXXXXXXXXXXXXXXXXXXXXXXXXXXXXXXXXXXXXXXXXXXXXXXXXXXXXXXXXXXXXXXXXXXXXXXXXXXXXXXXXXXXXXXXXXXXXXXXXXXXXXXXXXXXXXXXXXXXXXXXXXXXXXXXXXXXXXXXXXXXXXX
