------------------------------------------------------------------------------------------------------------------------------------------------------------------------------------------------
------------------------------------------------------------------------------------------------------------------------------------------------------------------------------------------------
------------------------------------------------------------------------------------------------------------------------------------------------------------------------------------------------
--------------------------------SSSSSSSS--------SSSSSSSS----------------------------------------SSSSSSSSSSSSSS-S--------------------------------SSSSSSSSSS----SS-----SSS------------------------
------------------------------------------------------------------------------------------------SS----------------------------------------------------------------------------------------------
-------------------------------------------------------------------------------------------------S----------------------------------------------------------------------------------------------
--------%%%%%%%%------SSSSS-------------------------------------------SSSS-----S--------------------------------SSSSQSSSoS---SSS------SSSS-----o-------------------------o-------ooS@SSS-----S@S
---------||||||---------------------------------------------------------------------------------------------------------------------------------------------------------------------------------
---------||||||--------------------------------------------------------------o----------------------------------------------------------------------------------------------------------------o-
---------||||||--------------------------------------------------------------------------------------------------ggg---o---------o----------------------------------------------ooo-------------
------%%%%%%%%%%-------------o-----------------------------------------------@S---------------------------------SSQSSSSSSS---SSS-------------o----------------------------##-----------------US-
-------||||||||---------------------------------------------------------------------------#------------------------------------------------------------------------------####-------------------
-------||||||||--------------------------------------------------------------------------##-------------------------------------------------------------------TT--------#####-------------------
-------||||||||---ggg------------------g------k------kgg------k---gg--------k-kg---------##----------g--------g----k--y---k-------gg----------k----------k----TT-------########----kggggg-#-----
XXXXXXXXXXXXXXXXXXXXXXXXXXXXXXXXXXXXXXXXXXXXXXXXXXXXXXXXXXXXXXXXXXXXXXXXXXXXXXXXXXXXXXXXXXXXXXXXXXXXXXXXXXXXXXXXXXXXXXXXXXXXXXXXXXXXXXXXXXXXXXXXXXXXXXXXXXXXXXXXXXXXXXXXXXXXXXXXXXXXXXXXXXXXXXXX
XXXXXXXXXXXXXXXXXXXXXXXXXXXXXXXXXXXXXXXXXXXXXXXXXXXXXXXXXXXXXXXXXXXXXXXXXXXXXXXXXXXXXXXXXXXXXXXXXXXXXXXXXXXXXXXXXXXXXXXXXXXXXXXXXXXXXXXXXXXXXXXXXXXXXXXXXXXXXXXXXXXXXXXXXXXXXXXXXXXXXXXXXXXXXXXX
