------------------------------------------------------------------------------------------------------------------------------------------------------------------------------------------------
------------------------------------------------------------------------------------------------------------------------------------------------------------------------------------------------
------------------------------------------------------------------------------------------------------------------------------------------------------------------------------------------------
--------------------------------SSSSSSSSS---------------------------------------SSSSSSSSSSS------SSSSSSS------------------------SSSSSSSSSS-------SSSSSS-----------------------------------------
------------------------------------------------------------------------------------------------------------------------------------------------------------------------------------------------
------------------------------------------------------------------------------------------------------------------------------------------------------------------------------------------------
--------%%%%%%%%-----------------------SS------SSooSSSSSSSSSSSSS--------------------------------ooo----Soo----SS-------------S----------------------------------oooo----o----SoS----------------
---------||||||---------------------------------------------------------------------------------------------------------------------------------------------------------------------------------
---------||||||---------------------------------------------------------------------------------------------------------------------------------------------------------------------------------
---------||||||---------------------------------oo------------oo--------------------------------o-------------------g-------------------------------------------g-------------------------------
------%%%%%%%%%%--------------------------------SS-----------SSS----------------------------------------------------##----#-------------------------------------##QQS--------US-----------------
-------||||||||----------TT----------tt--------------------------------------------------------------tt------------------##---------------#-----------------------------------------------------
-------||||||||----------TT----------tt--------------------------------TT---------------TT----TT-----tt-----------------###--------------##-----------------------------------------------------
-------||||||||---ggg----TT---yg-----tt------ggg----ggg-----------g----TT----k----g-----TT----TT-----tt---#-----------g####--------k-----##---g---k--k---k----g-------g##-k-------ggg---------kg
XXXXXXXXXXXXXXXXXXXXXXXXXXXXXXXXXXXXXXXXXXXXXXXXXXXXXXXXXXXXXXXXXXXXXXXXXXXXXXXXXXXXXXXXXXXXXXXXXXXXXXXXXXXXXXXXXXXXXXXXXXXXXXXXXXXXXXXXXXXXXXXXXXXXXXXXXXXXXXXXXXXXXXXXXXXXXXXXXXXXXXXXXXXXXXXX
XXXXXXXXXXXXXXXXXXXXXXXXXXXXXXXXXXXXXXXXXXXXXXXXXXXXXXXXXXXXXXXXXXXXXXXXXXXXXXXXXXXXXXXXXXXXXXXXXXXXXXXXXXXXXXXXXXXXXXXXXXXXXXXXXXXXXXXXXXXXXXXXXXXXXXXXXXXXXXXXXXXXXXXXXXXXXXXXXXXXXXXXXXXXXXXX
