-------------------------S----------------------------------------------------------------------------------------------------------------------------------------------------------------------
-------------------------S----------------------------------------------------------------------------------------------------------------------------------------------------------------------
------------------------------------------------------------------------------------------------------------------------------------------------------------------------------------------------
--------------------------------------------------------------------------------SS--------------------------------------------------------------SSS------------------------------SSSSSSSSS------
------------------------------------------------------------------------------------------------------------------------------------------------------------------------------------------------
------------------------------------------------------------------------------------------------------------------------------------------------------------------------------------------------
--------%%%%%%%%-----SSS-----S--------SS---------------------------------------o--------------------QQQSQSS--S@S----------------ooo----ooo----oo----------------S-SSQSSSSSS-SSSS----------------
---------||||||--------------------------------------%%-----------------------------------------------------------------------------------------S-----------------------------------------------
---------||||||--------------------------------------||-----------------------------------------------------------------------------------------------------------------------------------------
---------||||||-----------SS---S----------SS---------||-----------------------------------------------------------------------------------------------------------------------------------------
------%%%%%%%%%%-SSoS----------S---------------------||------------------TT---------------------------QQQ---SQ----------------------------------------tt--------Q-QQQ-SSSSSSS@SS-------------o--
-------||||||||---------#----------------------------|tt-----------------TT----------ttt--------------------------------TTT---------------------------tt--------------------------------TTT-----
-------||||||||--------##--------------#-------------|tt-----------------TT----------ttt--------------------------B-----TTT---K-----tt---##-----------tt-----#--------------------B-----TTT--TT-
-------||||||||-------###-------------##------g------|tt-----k-g--kkgggg###-----#----ttt-----yg----k--------k-----b-----TTT---g-----tt--###-----------tt-----ggg---ggggg-------k--b-----TTT--TT-
XXXXXXXXXXXXXXXXXXXXXXXXXX--XXXXXXXXXXXXXXXXXXXXXXXXXXXXXXXXXXXXXXXXXXXXXXXXXXXXXXXXXXXXXXXXXXXXXXXXXXXXXXXXXXXXXXXXXXXXXXXXXXXXXXXXXXXXXXXXXXXXXXXXXXXXXXXXXXXXXXXXXXXXXXX-XXXXXXXXXXXXXXXXXXXX
XXXXXXXXXXXXXXXXXXXXXXXXXX--XXXXXXXXXXXXXXXXXXXXXXXXXXXXXXXXXXXXXXXXXXXXXXXXXXXXXXXXXXXXXXXXXXXXXXXXXXXXXXXXXXXXXXXXXXXXXXXXXXXXXXXXXXXXXXXXXXXXXXXXXXXXXXXXXXXXXXXXXXXXXXX-XXXXXXXXXXXXXXXXXXXX
