------------------------------------------------------------------------------------------------------------------------------------------------------------------------------------------------
-----------------k------------------------------------------------------------------------------------------------------------------------------------------------------------------------------
------------------------------------------------------------------------------------------------------------------------------------------------------------------------------------------------
-----------------#------------------------------SSSSSSSSSSSSSSSSSSSSS--------------SSSSSS-------SSSSSSSSSSSSSSSSSSSSSSSSSSSSSSSSSSSSSSSSSSS---------------------------SS--------SSSSSSSSSSSSSSSS
------------------------------------------------SS---S---------------------------------------------------------------------------------------------------------------SS---------S----S----------
------------------------------------------------------------------------------------------------------------------------------------------------------------------------------------------------
--------%%%%%%%%---------------o----------------------------------------S--------oo------------S---------------------------------oo----SooS----S--ooQSQSo----S@S--------------SS----------------
---------||||||----------------------------------------------------%%%----------------S---------------------------------------------------------------------------------------------------------
---------||||||-----------------------------------------------------|----------------------#--------------------S-------------------------------------------------------------------------------
---------||||||-----------------------------------------------------|-----------ooo--------#-----------------------------------------------------oo-------------o-oo------------S---------------
------%%%%%%%%%%----------------------------------------------------|---------------------##----------------------------------------------------QQQQ----Q-------SSSS-----------#----------------
-------||||||||----------TT--------------TT-----------T-------------|--------------------###-------------##--------------------------tt----------------##---------------------##----------------
-------||||||||----------TT--------------TT----------tt-------------|----------#----tt-#####-------------##--------------------------tt----#-----------##-----------------#---##-----------#----
-------||||||||---kk-----TT-------kg##---TT---gg-----tt-------#-----|-k-------##----tt######------------###---#------g---k----g------tt---##--##------#-k------------k----#---##-----k----##--##
XXXXXXXXXXXXXXXXXXXXXXXXXXXXXXXXXXXXXXXXXXXXXXXXXXXXXXXXXXXXXXXXXXXXXXXXXXXXXXXXXXXXXXXXXXXXXXXXXXXXXXXXXXXXXXXXXXXXXXXXXXXXXXXXXXXXXXXXXXXXXXXXXXXXXXXXXXX-XXXXXXXXXXXXXXXXXXXXXXXXXXXXXXXXXXXX
XXXXXXXXXXXXXXXXXXXXXXXXXXXXXXXXXXXXXXXXXXXXXXXXXXXXXXXXXXXXXXXXXXXXXXXXXXXXXXXXXXXXXXXXXXXXXXXXXXXXXXXXXXXXXXXXXXXXXXXXXXXXXXXXXXXXXXXXXXXXXXXXXXXXXXXXXXX-XXXXXXXXXXXXXXXXXXXXXXXXXXXXXXXXXXXX
