-------------------%----------------------------------------------------------------------------------------------------------------------------------------------------------------------------
-------------------|----------------------------------------------------------------------------------------------------------------------------------------------------------------------------
-------------------|----------------------------------------------------------------------------------------------------------------------------------------------------------------------------
-------------------|----------------------------------------------------------------------------------------------------------------------------------------------------------------------------
-------------------|----------------------------------------------------------------------------------------------------------------------------------------------------------------------------
-------------------|--------------##--------------------------------------------------------------##--------------------------------------------------------------------------o---##------------
--------%%%%%%%%---|-------------------------------------------------------SQQQo--------------------------------------------SSSoSSS---------------------------------S---------------------------
---------||||||----|----------------------------------------------------------------------------------------------------oo----------oo-------------------SS-------------------------------------
---------||||||----|--------------------SS--------------------------------------------------------------------------------------------------------------SS--------------------------------------
---------||||||----|---------------------S---------------------------------------------------------------SS---------------------------------------------SSSS------------------------------------
------%%%%%%%%%%-##|--------------S---------------SS-------------------------------S------------------------------SS-----S------TT-------TT------------------------------TT---------------------
-------||||||||----|TT-T----------------------------------------TT------------------------T----------t-------------------------TTT-------TT----T-------TT----------------TT----T----tt-----tt---
-------||||||||----|TT-TT-----------tt-TT-----------------------TT-----------------------TT----T----tt-TT--tt------------------TTT----tt-TT----T----t--TT----------------TT----T----tt-TT--tt---
-------||||||||----|TT-TT-k---------tt-TT----------ggg----------TT----t------------ggg---TT----TK---tt-TT--tt------------------TTT----ttkTT----T----t--TT------------y---TT----Tg---tt-TT--tt---
XXXXXXXXXXXXXXXXXXXXXXXXXXXXXXXXXXXXXXXXXXXXXXXXXXXXXXXXXXXXXXXXXXXXXXXXXXXXXXXXXXXXXXXXXXXXXXXXXXXXXXXXXXXXXXXXXXXXXXXXXXXXXXXXXXXXXXXXXXXXXXXXXXXXXXXXXXXXXXXXXXXXXXXXXXXXXXXXXXXXXXXXXXXXXXXX
XXXXXXXXXXXXXXXXXXXXXXXXXXXXXXXXXXXXXXXXXXXXXXXXXXXXXXXXXXXXXXXXXXXXXXXXXXXXXXXXXXXXXXXXXXXXXXXXXXXXXXXXXXXXXXXXXXXXXXXXXXXXXXXXXXXXXXXXXXXXXXXXXXXXXXXXXXXXXXXXXXXXXXXXXXXXXXXXXXXXXXXXXXXXXXXX
