------------------------------------------------------------------------------------------------------------------------------------------------------------------------------------------------
------------------------------------------------------------------------------------------------------------------------------------------------------------------------------------------------
------------------------------------------------------------------------------------------------------------------------------------------------------------------------------------------------
------------------------------------------------SSSSS--------------------------------------------------------------------------------------------------------------SS-SS------------------------
------------------------------------------------------------------------------------------------------------------------------------------------------------------------------------------------
------------------------------------------------------------------------------------------------------------------------------------------------------------------------------------------------
--------%%%%%%%%------------------------------------------------------oSSS----------------------S-SSQSQQQS---SSS-----------------------SS-----------Q----------U-o------oo-----o-----QQQQ------o
---------||||||---------------------------------------------------------------------------------------------------------------------------------------------------------------------------------
---------||||||------------------------------o----------------------------------------------------------------o----------------------------------------------oo---------------------------------
---------||||||----------o---------------------------------------------S------------------------------------------------------------------------------------------------------------------------
------%%%%%%%%%%-----------------------------@--------------------#----S------------------------##QQQSSSSS-SS@SS-------------------------------------S-------@S------------------------------Q--
-------||||||||--------------------------------------------------#-----t--------------------------------------------------------------------------------------------------------#-#-------------
-------||||||||--------------------------------------tt---------##----tt--------------------------------------------------------------tt-----------------TT---------tt---##-----#-##------------
-------||||||||---%%%----------#---kok--------kg-----tt---------##----tt---k-k---------k-------g---k-ggg----------b-----------gg------tt-----------k-ggg-TT---------tt--###-----#-##-----------#
XXXXXXXXXXXXXXXX---|-X-XXXXXXXXXXXXXXXXXXXXXXXXXXXXXXXXXXXXXXXXXXXXXXXXXXXXXXXXXXXXXXXXXXXXXXXXXXXXXXXXXXXXXXXXXXXXXXXXXXXXXXXXX%%%XXXXXXXXXXXXXXXXXXXXXXXXXXXXXXXXXXXXXXXXXXXXXXXXXXXXXXXXXXXXX
XXXXXXXXXXXXXXXX---|-X-XXXXXXXXXXXXXXXXXXXXXXXXXXXXXXXXXXXXXXXXXXXXXXXXXXXXXXXXXXXXXXXXXXXXXXXXXXXXXXXXXXXXXXXXXXXXXXXXXXXXXXXXXX|XX-XXXXXXXXXXXXXXXXXXXXXXXXXXXXXXXXXXXXXXXXXXXXXXXXXXXXXXXXXXX
