------------------------------------------------------------------------------------------------------------------------------------------------------------------------------------------------
------------------------------------------------------------------------------------------------------------------------------------------------------------------------------------------------
------------------------------------------------------------------------------------------------------------------------------------------------------------------------------------------------
------------------------------------------------SSSSS-------------------------------------------SSSSSSSS----------------------------------------SSSSSSSSSSSSSSSS--------------------------------
------------------------------------------------------------------------------------------------------------------------------------------------------------------------------------------------
-----------------------------------------------------------------------------------------------------------------------------------------------------------------------------------------------o
--------%%%%%%%%----------------------------------------------------QSQSSS---SSS-oo------------o--------oo-------------------------Q-----------U--------------------QoQSSS---SS-----------------
---------||||||---------------------------------------------------------------------------------S--S%%%---------S---------------------------------------------------------------S---------------
---------||||||------TT------------------------------------------------------------------------------|---------------------------------------oo-------------------------------------------------
---------||||||------TT------------------------------------------------------------------------------|------------------------------------------------------------------------------------------
------%%%%%%%%%%-----##------------------------------------------------QQ---SUS-----------#----------|---------------------------------------@S------------------------------Qo-----------------
-------||||||||-TT------------------------------------tt---------------------------------##----------tt----------------------------------TT----------tt-----------------------------------------
-------||||||||-TT-------TT---------------------##----tt---------------------------------##----------tt----------------tt----------------TT----------tt--B-------------------------------TT-----
-------||||||||-TT-------TT---------gy---------g##----tt----gg-g---k--------k-------gggg-##-----#----tt----k-g-gg------tt---ggg----kggy--TT----------tt--b----g-------------------ggggg--TT-----
XXXXXXXXXXXXXXXXXXX-XXXXXXXXXXXXXXXXXXXXXXXXXXXXXXXXXXXXXXXXXXXXXXXXXXXXXXXXXXXXXXXXXXXXXXXXXXXXXXXXXXXXXXXXXXXXXXXXXXXXXXXXXXXXXXXXXXXXXXXXXXXXXXXXXXXXXXXXXXXXXXXXXXXXXXXXXXXXXXXXXXXXXXXXXXXX
XXXXXXXXXXXXXXXXXXX-XXXXXXXXXXXXXXXXXXXXXXXXXXXXXXXXXXXXXXXXXXXXXXXXXXXXXXXXXXXXXXXXXXXXXXXXXXXXXXXXXXXXXXXXXXXXXXXXXXXXXXXXXXXXXXXXXXXXXXXXXXXXXXXXXXXXXXXXXXXXXXXXXXXXXXXXXXXXXXXXXXXXXXXXXXXX
