------------------------------------------------------------------------------------------------------------------------------------------------------------------------------------------------
------------------------------------------------------------------------------------------------------------------------------------------------------------------------------------------------
------------------------------------------------------------------------------------------------------------------------------------------------------------------------------------------------
------------------------------------------------SSSSSSSSSS--------------------------------------SSSSSSSSSS-----S---------------------------------SS-------------SSS-----------------------------
------------------------------------------------------------------------------------------------------------------------------------------------------------------------------------------------
-----------------------------------------------------------------------------------------------------------------------------------------------------------------------------------------------o
--------%%%%%%%%------------------------------------------------------------------------------------------------------------------S@S-SSSS---SSS----------------------oo------------------------
---------||||||--------o------------------------S------------------------------#------------------------------------------------------------------------------------------------SS-------------o
---------||||||------------------------------SSSS------------------------------#------------------------------------------------------------------------------------------------S---o-----------
---------||||||-------------------------------oo-------------------------------#----------------------------------------------------------------------------------------------------------------
------%%%%%%%%%%---------------S------U------SSS------------------------------##------------------------------------------------------------SSSS----------------------tt------------SS-------o--
-------||||||||---------------------------------------------------------------##--K------TT---------------------------------------------------------------------------tt------------------------
-------||||||||-----------------------------------------------TT------------####---------TT---TT--B------B----TT----------------------------------B-----TT---TTTT-----tt-----------------TT-----
-------||||||||-----------------------y---U-----k-------------TT----ggg---#-####--y------TT---TT--b--b---b----TT-------------g-g---kgg---------k--b-----TT---TTTT-----tt---k-k----g------TT-----
XXXXXXXXXXXXXXXX-XXXXXXX-----X--XXXXXXXXXXXXXXXXXXXXXXXXXXXXXXXXXXXXXXXXXXX-XXXXXXXXXXXXXXXXXXXXXXXXXXXXXXXXXXXXXXXXXXXXXXXXXXXXXXXXXXXXXXXXXXXXXXXXXXXXXXXXXXXXXXXXXXXXXXXXXXXXXXXXXXXXXXXXXXXX
XXXXXXXXXXXXXXXX-XXXXXXX-----X--XXXXXXXXXXXXXXXXXXXXXXXXXXXXXXXXXXXXXXXXXXXXXXXXXXXXXXXXXXXXXXXXXXXXXXXXXXXXXXXXXXXXXXXXXXXXXXXXXXXXXXXXXXXXXXXXXXXXXXXXXXXXXXXXXXXXXXXXXXXXXXXXXXXXXXXXXXXXXXXX
