------------------------------------------------------------------------------------------------------------------------------------------------------------------------------------------------
------------------S-----------------------------------------------------------------------------------------------------------------------------------------------------------------------------
------------------------------------------------------------------------------------------------------------------------------------------------------------------------------------------------
----------------SSS----------SSS--------------------------------------------------------------------------------SSSSSSSSSSS---------------------------------------SSSS----------SSSSSSSS--------
------------------------------------------------------------------------------------------------------------------------------------------------------------------------------------------------
------------------------------------------------------------------------------------------------------------------------------------------------------------------------------------------------
--------%%%%%%%%-%%-------oo-----------------------------o----------------------------------------oo-----------------------------------QSS-----S-----------------oo------o----------------------
---------||||||--||------------------------------------------------------------#------------------------------------------------S---------------------------------------------------------------
---------||||||--||-------SS--------------------------------------------------#-----------------------------------------------------------------------------------------------------------------
---------||||||--||---So--SS-------------------------------------------------###----------------------------------------------------------------------------#-----------------------------------
------%%%%%%%%%%%%|---------------------------------------------------------####-------------------------------------------------------------o-------------####---------------------------------
-------||||||||-|||-----------------------2----------tt--------------------####---------------#-----------#----------------------------------#----------TTT###------------------------tt--------
-------||||||||-|||----------------------------------tt--------------------####---------TT---##----------##----------------------------B----##----B-----TTT###------------#-----------tt-----TT-
-------||||||||-|||----------g-g--kgg---------k------tt---#---k--------g---####---b-----TT---##----k-k---##-----------------k---g-gy---b----##----b-----TTT#####-----y----#-k-k-------tt-----TT-
XXXXXXXXXXXXXXXXX||--XXXXXXXXXXXXXXXXXXXXXXXXXXXXXXXXXXXXXXXXXXXXXXXXXXXXX-XXXX-XXXXXXXXXXXXXXXXXXXXXXXXXXXXXXXXXXXXXXXXXXXXXXXXXXXXXXXXXXXXXXXXXXXXXXXXXXXXXXXXXXXXXXXXXXXXXXXXXXXXXXXXXXXXXXXX
XXXXXXXXXXXXXXXXX||--XXXXXXXXXXXXXXXXXXXXXXXXXXXXXXXXXXXXXXXXXXXXXXXXXXXXXXXXXX-XXXXXXXXXXXXXXXXXXXXXXXXXXXXXXXXXXXXXXXXXXXXXXXXXXXXXXXXXXXXXXXXXXXXXXXXXXXXXXXXXXXXXXXXXXXXXXXXXXXXXXXXXXXXXXXX
