-----------------------K------------------------------------------------------------------------------------------------------------------------------------------------------------------------
-----------------------o---------------------------------------------------------S--------------------------------------------------------------------------------------------------------------
----------------------%%------------------------------------------------------------------------------------------------------------------------------------------------------------------------
----------------------||----------------------------------------------------------------------------------------SSSSSSSSSSSSS---SSSSSSSS-------------------------SSSSS----------SSSSSSSS--------
----------------------||------------------------------------------------------------------------------------------------------------------------------------------------------------------------
----------------------||--------------------------------------------------------------------------------------------------------------------------------------oo--------------------------------
--------%%%%%%%%------|%%%------------tSSS--------------o------o---------------o-----------------------SSSSS-SSS-------------------------------S--------------%%----------------------SSS-------
---------||||||-%%%%--|-|-------SS---%%------------------------------------------------------o----------------------------------------------------------------||--------------------------------
---------||||||--||---|-|------------||-----------------------S-----------------------------------------------------------------------------------------------||--------------------------------
---------||||||--||---|-|------------||----------------------------------------------------------------------------------------------------------o------------||--------------------------------
------%%%%%%%%%%-||---|-|------------||-------------------------------------#--------------------------------U-------2----#----------------------SS-----------||---------T------------t---------
-------||||||||--||---|-|------------||--------------t-------------------TT----------------------------t-------------2---TT-----------tt----------------------||---------TT----------tt---------
-------||||||||-%%|---|-|------#-----||--------------t---------------B---TT----------------------------t-----------------TT-----------tt---#-#----------------||--B--B---TT---TT-----tt---------
-------||||||||-|||---|-|------##----|t------g-g#---ttt------kg----k-b---TT--------g---k----gggg--g----t----k--------k---TT---#-##----tt---#g##---gggg-b------||--b--b---TT---TT-----tt---------
XXXXXXXXXXXXXXXX|||---%%%%%%%%%%XXXXXXXXXXXXXXXXXXXXXXXXXXXXXXXXXXXXXXXXXXXXXXXXXXXXXXXXXXXXXXXXXXXXXXXXXXXXXXXXXXXXXXXXXXXXXXXXXXXXXXXXXXXXXXXXXXXXXXXXXXXXXXXXXXXXXXXXXXXXXXXXXXXXXXXXXXXXXXXX
XXXXXXXXXXXXXXXX|||----||||X|||-XXXXXXXXXXXXXXXXXXXXXXXXXXXXXXXXXXXXXXXXXXXXXXXXXXXXXXXXXXXXXXXXXXXXXXXXXXXXXXXXXXXXXXXXXXXXXXXXXXXXXXXXXXXXXXXXXXXXXXXXXXXXXXXXXXXXXXXXXXXXXXXXXXXXXXXXXXXXXXXX
