--------------------------------------------------------------------------------------------------------------------------------------------------------------------------------
-------------------------------------------------------------------K------------------------------------------------------------------------------------------------------------
--------------------------------------------------------------------------------------------------------------------------------t-----------------------------------------------
--------------------------------------------------------------------------------------------------------------------------------------------------------------------------------
--------------------------------------------------------------------------------------------------------------------------------t-----------------------------------------------
---------------------------------------------------------------------------------------g-----ooo--------------------------------t-----------------------------------------------
------------------------------------------SSo-----------------------------------------SS-----------------------o----------------SS--------------S-----------SSSo----------------
-------#-----------------------------------------------------------------oo---------------------------------------------oooo----------------------------------------------------
--------------------------------------------------------------------------------------------------------------------------------------------------------------------------------
-------#------------------------------------------------------------------------------------------------------------------------------------------------------------------------
--TT---#----------------------------------------------------------S----------------------TT-----------------------S--------------T----------------------------------------------
--TT---#----------TT-----TT-----T---------------TT---------------------------------------TT----------------------------TT-------TT----tt-----------------------T---------TT-----
--TT--------------TT-----TT----#T---------------TT----tt---------------------------------TT----------------------------TT-------TT----tt-----------------TT----T---------TT-----
--TT---#----y-----TT-----TT----#T------k--g-----TT----tt-----------------------------y---TT----------------ggg-g-------TT-------TT----tt------g----------TT----T------gg-TT----k
XXXXXXXXXXXXXXXXXXXXXXXXXXXXXXXXXXXXXXXXXXXXXXXXXXXXXXXXXXXXXXXXXXXXXXXXXXXXXXXXXXXXXXXXXXXXXXXXXXXXXXXXXXXXXXXXXXXXXX-XXXXXXXXXXXXXXXXXXXXXXXXXXXXXXXXXXXXXXXXXXXXXXXXXXXXXXXXX
XXXXXXXXXXXXXXXXXXXXXXXXXXXXXXXXXXXXXXXXXXXXXXXXXXXXXXXXXXXXXXXXXXXXXXXXXXXXXXXXXXXXXXXXXXXXXXXXXXXXXXXXXXXXXXXXXXXXXX-XXXXXXXXXXXXXXXXXXXXXXXXXXXXXXXXXXXXXXXXXXXXXXXXXXXXXXXXX
