------------------------------------------------------------------------------------------------------------------------------------------------------------------------------------------------
------------------------------------------------------------------------------------------------------------------------------------------------------------------------------------------------
------------------------------------------------------------------------------------------------------------------------------------------------------------------------------------------------
------------------------------------------------SSSSSSSSSSSSSSSS------------------------------------------------SSSSSSSSSSS--SSS--------------------------------SSSSSS---------------SSS--------
------------------------------------------------------------------------------------------------------------------------------------------------------------------------------------------------
---------------------------------------------------------------------------------------------------------------------------------------------------------------o--------------------------------
--------%%%%%%%%--o---SSSS----SS-----SSS----------------------------------------S-SS@SS------S@S---------------o----------------SooSSSSSo----SSS--------------------------------oooo---ooo---S-S
---------||||||---------------------------------------------------------------------------------------------------------------------------------------------------------------------------------
---------||||||-------------------------------------------------------------------------------o-------------------------------------------------------------------------------------------------
---------||||||-----------------------------------------------------------------------------------------------------------------o-oo-------------------------------------o------o---------------
------%%%%%%%%%%-------------oS-----------------------------------------------------U--------US---------------------------------S-SSQQ-------SSS------@SSS%%%@SS---------------------#----------
-------||||||||----------------------------------------o----------------------------------K----------------------------------------------------------------|-------------------------#----------
-------||||||||----------------------------------------##----TT-------tt-------------------------------------------------#---------------------------------|------------------TT-----#----------
-------||||||||----gggk-----k-------ggg------ggg-------#-----TT---ggg-tt----k-k----kgggg----------g---g--k----k------k---#-----------ggg----------gggggg---|-----------k------TT-----#----------
XXXXXXXXXXXXXXXXXXXXXXXXXXXXXXXXXXXXXXXXXXXXXXXXXXXXXXXXXXXXXXXXXXXXXXXXXXXXXXXXXXXXXXXXXXXXXXXXXXXXXXXXXXXXXXXXXXXXXXXXXXXXXXXXXXXXXXXXXXXXXXXXXXXXXXXXXXXXXXXXXXXXXXXXXXXXXXXXXXXXXXXXXXXXXXXX
XXXXXXXXXXXXXXXXXXXXXXXXXXXXXXXXXXXXXXXXXXXXXXXXXXXXXXXXXXXXXXXXXXXXXXXXXXXXXXXXXXXXXXXXXXXXXXXXXXXXXXXXXXXXXXXXXXXXXXXXXXXXXXXXXXXXXXXXXXXXXXXXXXXXXXXXXXXXXXXXXXXXXXXXXXXXXXXXXXXXXXXXXXXXXXXX
