------------------------------------------------------------------------------------------------------------------------------------------------------------------------------------------------
------------------------------------------------------------------------------------------------------------------------------------------------------------------------------------------------
------------------------------------------------------------------------------------------------------------------------------------------------------------------------------------------------
-------------------------SSSSS--SSSSSSSSS-----------------------SSSSSSSS-----------SSSSSSSSSSSSS---------------------------------SSSSSS--------------------------------S------------------------
------------------------------------------------------------------------------------------------------------------------------------------------------------------------------------------------
------------------------------------------------------------------------------------------------------------------------------------------------------------------------------------------------
--------%%%%%%%%-Soo----o----oo----------------------SSS----------------------------------------------------------oS@SSoo----S@T---------------------ooSSS-----------------------oo------------o
---------||||||---------------------------------------------------------------------------------------------------------------------------------------------------------------------------------
---------||||||--------------SSS----------------------------------------------------------------------------------------------------------------------------------------------------------------
---------||||||------------SoSSo----------------------------------------------------------------------------------------------------------------------------------------------------------------
------%%%%%%%%%%--#----------SSS------------------------------##----------------S-------##--------------------------Q--------US-----------------------------------------------##----------------
-------||||||||---S-------------------------------------------#-----------#-----------y###---#----------t--------------------------------TT-----------t-------------------#--##-----------------
-------||||||||------------------------------------------------------B---TT----T------####---#--T------tt------T---------------------B---TT--TT-------t------------------T#-##T------t---##-----
-------||||||||--#-k--------------b---ty----gggg----ggg-----#--#-----b---##---kT-----#####---#--T------tt-----#T---k--gg-------------b---TT--##-------tt---k-k----------TT#-###-----tt---##-----
XXXXXXXXXXXXXXXXXXXXXXXXXXXXXXXXXXXXXXXXXXXXXXXXXXXXXXXXXXXXXXXXXXXXXXXXXXXXXXXXXXXXXXXXXXXXXXXXXXXXXXXXXXXXXXXXXXXXXXXXXXXXXXXXXXXXXXXXXXXXXXXXXXXXXXXXXXXXXXXXXXXXXXXXXXXXXXXXXXXXXXXXXXXXXXXX
XXXXXXXXXXXXXXXXXXXXXXXXXXXXXXXXXXXXXXXXXXXXXXXXXXXXXXXXXXXXXXXXXXXXXXXXXXXXXXXXXXXXXXXXXXXXXXXXXXXXXXXXXXXXXXXXXXXXXXXXXXXXXXXXXXXXXXXXXXXXXXXXXXXXXXXXXXXXXXXXXXXXXXXXXXXXXXXXXXXXXXXXXXXXXXXX
