------------------------------------------------------------------------------------------------------------------------------------------------------------------------------------------------
------------------------------------------------------------------------------------------------------------------------------------------------------------------------------------------------
------------------------------------------------------------------------------------------------------------------------------------------------------------------------------------------------
-----------------------------------------------------------------------------------------------------------------------------------------------------------------SSSSSSSS-------SSSSS-----------
------------------------------------------------------------------------------------------------------------------------------------------------------------------------------------------------
---------------------------oo-------------------------------------------------------------------------------------------------------------------------------------------------------------------
--------%%%%%%%%----------%%%-------QQQSSSS----o-------------------------------------------------ooo----o-----oo--------------------QQQQQSS--SSS----------------ooo-----oo-----o-----------S----
---------||||||------------|--------------------------------------------------------------------------------------------------------------------S-----------------------------------------------
---------||||||------------|-----------------S--------------------------------------------------------------------------------------------------S-----------------------------------------------
---------||||||------------|-----------------------------------------------------------------------------------------------------o--------------------------------------------------------------
------%%%%%%%%%%------%%%%%%%S--------------SS-------------------------------o-------------------------------U-------------------------QQ----o--------------------------------------------------
-------||||||||--------|||||-------------------------ttt--------------------------------------------------------------tt---------------------------------TT---------------------------tt--------
-------||||||||--------|||||-------------------------ttt--------------------------------------------------------------tt---------------------------------TT---------tt----------%-----tt--------
-------||||||||--------|||||-------y--------k--------ttt------#------k-k--#-#----------------ggg----gy------k-k-------tt-----ggg--oyo-------k------------TT--#g-----tt----#-----|-----tt-----g-g
XXXXXXXXXXXXXXXX-%%%%%%%||X|-%%-XXXXXXXXXXXXXXXXXXXXXXXXXXXXXXXXXXXXXXXXXXXXXXXXXXXXXXXXXXXXXXXXXXXXXXXXXXXXXXXXXXXXXXXXXXXXXXXXXXXXXXXXXXXXXXXXXXXXXXXXXXXXXXXXXXXXXXXXXXXXXXXXXXXXXXXXXXXXXXXX
XXXXXXXXXXXXXXXX--|||||-||-|-||-XXXXXXXXXXXXXXXXXXXXXXXXXXXXXXXXXXXXXXXXXXXXXXXXXXXXXXXXXXXXXXXXXXXXXXXXXXXXXXXXXXXXXXXXXXXXXXXXXXXXXXXXXXXXXXXXXXXXXXXXXXXXXXXXXXXXXXXXXXXXXXXXXXXXXXXXXXXXXXXX
