------------------------------------------------------------------------------------------------------------------------------------------------------------------------------------------------
------------------------------------------------------------------------------------------------------------------------------------------------------------------------------------------------
------------------------------------------------------------------------------------------------------------------------------------------------------------------------------------------------
----------------------------------------------------------------SSSS-----------------------------S------------------------------SSSSSSSS-------------------------S-----------------S------------
------------------------------------------------------------------------------------------------------------------------------------------------------------------------------------------------
------------------------------------------------------------------------------------------------------------------------------------------------------------------------------------------------
--------%%%%%%%%----------------------QSSSS--SSS-----SSSSS------------------------------------------------------SSSSQSSSQ----S-S--------S----------UQSSSSS----@S-----------------oo-------------
---------||||||---------------------------------------------------------------------------------------------------------------------------------------------------------------------------------
---------||||||-------------------------------------------------------------------------------------T---------------------------#---------------------------------------------------------------
---------||||||----------------o--------------------------------------------------------------------#-------------------------------------------------------------------------------------------
------%%%%%%%%%%-----SS---------#----QQQQ---S@SS-----------------------------------------------------#----------##--#--------US-------t---------QQQQS-------------------------------------------
-------||||||||-S----------------------------------------------------------------------B----------------------------------------------t--------------------------------------------------TT-----
-------||||||||-T----------------------------------------------------B-----------------b----------------TT---TT----------------------ttt--------------------------B-----TT---TT------t---TT-----
-------||||||||-T---------y--------k----------------gtk-----------k--t-k----------gg---b----k-k-T-g-----TT---TT----kgg----k-----k----ttt-----gg-------k-k---------g----kTt---TT------t---##-----
XXXXXXXXXXXXXXXXXXXXXXXXXXXXXXXXXXXXXXXXXXXXXXXXXXXXXXXXXXXXXXXXXXXXXXXXXXXXXXXXXXXXXXXXXXXXXXXXXXXXXXXXXXXXXXXXXXXXXXXXXXXXXXXXXXXXXXXXXXXXXXXXXXXXXXXXXXX-XXXXXXXXXXXXXXXXXXXXXXXXXXXXXXXXXXXX
XXXXXXXXXXXXXXXXXXXXXXXXXXXXXXXXXXXXXXXXXXXXXXXXXXXXXXXXXXXXXXXXXXXXXXXXXXXXXXXXXXXXXXXXXXXXXXXXXXXXXXXXXXXXXXXXXXXXXXXXXXXXXXXXXXXXXXXXXXXXXXXXXXXXXXXXXXX-XXXXXXXXXXXXXXXXXXXXXXXXXXXXXXXXXXXX
