------------------------------------------------------------------------------------------------------------------------------------------------------------------------------------------------
-----------------------------------------------------------------K------------------------------------------------------------------------------------------------------------------------------
------------------------------------------------------------------------------------------------------------------------------------------------------------------------------------------------
--------------------------------SSSSSSSSS-----SS------------------------------------------------SSSSSSSS----------------------------------------SSSSSSSSSSSSSSSS--------------------------------
------------------------------------------------------------------------------------------------------------------------------------------------------------------------------------------------
-----------------------------------------------------------------------------------------------------------------------------------------------------------------------------------------------o
--------%%%%%%%%S-S--------------------------------------------o-K---------------oo---SSSS----SS------------------------------------QSQSSSS--SSS---------------S--------------------QQQSSS--SSSS
---------||||||--------------------------------------------------#----------------%%%%%---------------------------------------------------------------------------------------------------------
---------||||||-----------------S--------------------------------------------------|||----------------------------------------------------------------------------------------------------------
---------||||||--------------------------------------------------------------------|||-------------------------------------------------k-----------------------------2--------------------------
------%%%%%%%%%%-SQS-SS@SSS--SS------------------------------U-----------TT--------|tt----------------tt-------------------------#Q----SSS--SoS----------------------2-----------------------SSS
-------||||||||-------------------------------#--------K-----------------TT--------|tt----------------tt----------------TT---------------------------tt-----------------TT----------------------
-------||||||||------------------------------###-------------------------TT--------|tt---#------------tt----------B-----TT---------------------------tt-----------------TT----TT----------------
-------||||||||----g-----------------------#-#####-k---k--k-k-----g------TT--------|tt---##-----##----tt-----gg---b-----TT----##--gggg---------------tt-------g---#-----TT----TT--ggggg-----k---
XXXXXXXXXXXXXXXXXXXXXXX---X-----XXXXXXXXXXXXXXXXXXXXXXXXXXXXXXXXXXXXXXXXXXXXXXXXXXXXXXXXXXXXXXXXXXXXXXXXXXXXXXXXXXXXXXXXXXXXXXXXXXXXXXXXXXXXXXXXXXXXXXXXXXXXXXXXXXXXXXXXXXXXXXXXXXXXXXXXXXXXXXXX
XXXXXXXXXXXXXXXXXXXXX-X------XX-XXXXXXXXXXXXXXXXXXXXXXXXXXXXXXXXXXXXXXXXXXXXXXXXXXXXXXXXXXXXXXXXXXXXXXXXXXXXXXXXXXXXXXXXXXXXXXXXXXXXXXXXXXXXXXXXXXXXXXXXXXXXXXXXXXXXXXXXXXXXXXXXXXXXXXXXXXXXXXXX
