------------------------------------------------------------------------------------------------------------------------------------------------------------------------------------------------
------------------------------------------------------------------------------------------------------------------------------------------------------------------------------------------------
------------------------------------------------------------------------------------------------------------------------------------------------------------------------------------------------
--------------------------------SSSSSSSS--------SSSSSSSS------------------------------------------------------------------------SSS--------------SS-------------SSSSSSSSSSSSSSSS----------------
-----------------------------------------------S------------------------------------------------------------------------------------------------------------------------------------------------
-----------------------------------------------o------------------------------------------------------------------------------------------------------------------------------------------------
--------%%%%%%%%-----------------------SS------S--------------------------------------------------------------------QSSSSS-------------------------------------------------------ooo-----------o
---------||||||--------------------%%%---------------%%---------------------------------------------------------------------------------------------------------S-------------------------------
---------||||||---------------------|----------------||---------------------------------------------T-----------------------------------------------------------S---TT--------------------------
---------||||||-----------o---------|----------------||---------------------------------------------#---------------------------------------------------------------##--------------------------
------%%%%%%%%%%----------%---------|----------------|tt-----------------TT--------------------------------------------QQ----US------2--TT------------tt----------------------------------------
-------||||||||-----------|---------|t-----#---------|tt-----------------TT---------------------T------o-----#------------------TT------TT-----T------tt---------------TT----------------##-----
-------||||||||-----------|---------|----------------ttt-----------------TT---T-----------------T------TT----##-----------------TT------TT----TT-----ttt--------T------TT----TT----------##-----
-------||||||||-----------|--r-o----|t-----y----##---ttt---k-ggg--kk-k---TT---TT------g---k-k---T------TT----##----k--g---------TT---k-kTTT---TT-----ttt-----kggT-----kTT---TTT----k-ggg###-----
XXXXXXXXXXXXXXXX-----%%%%%%%%%%%XXXXXXXXXXXXXXXXXXXXXXXXXXXXXXXXXXXXXXXXXXXXXXXXXXXXXXXXXXXXXXXXXXXXXXXXXXXXXXXXXXXXXXXXXXXXXXXXXXXXXXXXXXXXXXXXXXXXXXXXXXXXXXXXXXXXXXXXXXXXXXXXXXXXXXXXXXXXXXXX
XXXXXXXXXXXXXXXX------|||||||||-XXXXXXXXXXXXXXXXXXXXXXXXXXXXXXXXXXXXXXXXXXXXXXXXXXXXXXXXXXXXXXXXXXXXXXXXXXXXXXXXXXXXXXXXXXXXXXXXXXXXXXXXXXXXXXXXXXXXXXXXXXXXXXXXXXXXXXXXXXXXXXXXXXXXXXXXXXXXXXXX
