--------------------------------------------------------------------------------------------------------------------------------------------------------------------------------
--------------------------------------------------------------------------------------------------------------------------------------------------------------------------------
--------------------------------------------------------------------------------------------------------------------------------------------------------------------------------
--------------------------------------------------------------------------------------------------------------------------------------------------------------------------------
-------------------------------------------------------------------k------------------------------------------------------------------------------------------------------------
------------------------------------------------------------------##--------------##--------------------------------------------------------------------------------------------
---------------------------------------------------------S--------------------------------------SSSS---------Q-oSSS---------S--------------------------------o-----------------o
-----%-------------------------------------------------------------------o---------------o-------------------------ooo----------------------------------oooo--------------------
-----|--------------------------------------------------------------------------------------------------------------------------------------------------------------------------
-----|-------------------------------------------------------------------SS-----------------------------------------------------------------------------------------------------
-----|------------SS-------------------------------------------------------------SS-----------------------------TT--------------------------------S----------------------------Q
-----|---TT---------K----------------------------------------------------------------t-------------------TT-----TT----tt-TT----T----tt-----tt-----------------TT----tt-----tt---
-----|---TT------------T----------------------#---------------------tt-TT-----------tt-----tt------------TT----TTT----tt-TT----T----tt-TT--tt----------TT-----TT----tt-TT--tt---
-----|---TT------------T----------------------#------g--------------tt-TT-----------tt--T--tt------gggg-kTT----TTT----ttkTT----T----tt-TT--tt----------TT-k---TTg---tt-T---tt---
X--XXXXX-XX----XXXXXXXXXXXXXXXXXXXXXXXXXXXXXXXXXXXXXXXXXXXXXXXXXXXXXXXXXXXXXXXXXXXXXXXXXXXXXXXXXXXXXXXXXXXXXXXXXXXXXXXXXXXXXXXXXXXXXXXXXXXXXXXXXXXXXXXXXXXXXXXXXXXXXXXXXXXXXXXXX
X---XXXXXXX-----XXXXXXXXXXXXXXXXXXXXXXXXXXXXXXXXXXXXXXXXXXXXXXXXXXXXXXXXXXXXXXXXXXXXXXXXXXXXXXXXXXXXXXXXXXXXXXXXXXXXXXXXXXXXXXXXXXXXXXXXXXXXXXXXXXXXXXXXXXXXXXXXXXXXXXXXXXXXXXXX
