------------------------------------------------------------------------------------------------------------------------------------------------------------------------------------------------
------------------------------------------------------------------------------------------------------------------------------------------------------------------------------------------------
------------------------------------------------------------------------------------------------------------------------------------------------------------------------------------------------
----------------SSSSSSSSSSSSSSSS----------------------------------------------------------------------------------------------------------------------------------------------------------------
----------------------S-SSS-SSS--------------------------------------------------------------------------------------------------------------------k--------------------------------------------
-----------------------SSSS-SSS-------------------------------------------------------------------------------------------------------------------##--------------------------------------------
--------%%%%%%%%-----------SSSS------------SSSS----------------o-----S-----------SS---SSSSSSSS------------------S---------------------------SQQo----------------SS------------------------------
---------||||||---Ko-------SSSS--------------------------------------------------------------------------SS---------------o-----------------------------oooo-----------------------------SS-----
---------||||||-----------------------------------------------------------------------------------------SS--------------------------------------------------------------------------------------
---------||||||----------ooooSo-------------------------------------------------------------------------SSSS--------------------------------------------SSS------------------------------SS-----
------%%%%%%%%%%------------SSS---------------------tt---------Q---------TT--------S------SSS----------------------------TT--------------------Q--------------TT------------------S-------------
-------||||||||--------------------------------T----tt-------------------TT---TT-----------------------------------------TT---TT----tt-----tt----------TT-----TT---------TT------------TT-------
-------||||||||--------------------------------T----tt-----tt------------TT---TT---------TT---------tt-TT----------------TT---TT----tt-----tt----------TT-----TTT--------TT---------tt-TT-------
-------||||||||----------------------g-k-------T----tt-----tt-g----------TT---TT---gggg-kTT---------tt-TT-kk-k#----------TT---TTg---tt-----tt-g--------TT-k---TTT---ggg-kTT----g----tt-TT----k#-
XXXXXXXXXXXXXXXXXX----%%%--X--XXXXXXXXXXXXXXXXXXXXXXXXXXXXXXXXXXXXXXXXXXXXXXXXXXXXXXXXXXXXXXXXXXXXXXXXXXXXXXXXXXXXXXXXXXXXXXXXXXXXXXXXXXXXXXXXXXXXXXXXXXXXXXXXXXXXXXXXXXXXXXXXXXXXXXXXXXXXXXXXXX
XXXXXXXXXXXXXXXXoX-----|--XX--XXXXXXXXXXXXXXXXXXXXXXXXXXXXXXXXXXXXXXXXXXXXXXXXXXXXXXXXXXXXXXXXXXXXXXXXXXXXXXXXXXXXXXXXXXXXXXXXXXXXXXXXXXXXXXXXXXXXXXXXXXXXXXXXXXXXXXXXXXXXXXXXXXXXXXXXXXXXXXXXXX
