------------------------------------------------------------------------------------------------------------------------------------------------------------------------------------------------
------------------------------------------------------------------------------------------------------------------------------------------------------------------------------------------------
------------------------------------------------------------------------------------------------------------------------------------------------------------------------------------------------
----------------------------------------------------------------------------------------------------------------SSSSSSSS---------------------------------------------------------SSSSSSS--------
------------------------------------------------------------------------------------------------------------------------------------------------------------------------------------------------
------------------------------------------------------------------------------------------------------------------------------------------------------------------------------------------------
--------%%%%%%%%----------------------SS--------------SS-------------------------------SS----------------------o------------------------------------QQQSSS---SSS--------------------------------
---------||||||-S-----------------------------------------------------------------%%%%----------------------------------------------------------------------------------------------------------
---------||||||--------------------------------------------------------------------||---------------B-------------------------------------------------------------------------------------------
---------||||||------------------------------SSS-----------------------------------||----SSSSSS----------------------2--------------------------S-----------------------------------------------
------%%%%%%%%%%--------------------####S-------------------------------------##---||-------------------------##----------#---#------------------------QQ-------------------#-------------------
-------||||||||---------------------#---------------------------------tt------##---|ttt----------------------###---------##---##-----ttt--------------------------------TTT###-----------TT-----
-------||||||||--------tt----------#---------#------------------------tt-----###---|ttt------------------TT-####---------TT---##-----ttt---------------------#----B-----TTT###-----------TT---TT
-------||||||||--------tt----g-g---k---------#-----------------g------tt----g###---|ttt----k------g----b-TT-####---------TT---####---ttt----gggg---y---------#----b-----TTT####------g---TT---TT
XXXXXXXXXXXXXXXXXXXXXXXXXXXXXXXXXXXXXXXXXXXXXXXXXXXXXXXXXXXXXXXXXXXXXXXXXXXXXXXXXXXXXXXXXXXXXXXXXXXXXXXXXXXXXXXXXXXXXXXXXXXXX-XXXXXXXXXXXXXXXXXXXXXXXXXXXXXXXXXXXXXXXXXXXXXXXXXXXXXXXXXXXXXXXXXX
XXXXXXXXXXXXXXXXXXXXXXXXXXXXXXXXXXXXXXXXXXXXXXXXXXXXXXXXXXXXXXXXXXXXXXXXXXXXXXXXXXXXXXXXXXXXXXXXXXXXXXXXXXXXXXXXX-XXXXXXXXXXX-XXXXXXXXXXXXXXXXXXXXXXXXXXXXXXXXXXXXXXXXXXXXXXXXXXXXXXXXXXXXXXXXXX
