--------------------------------------------------------------------------------------------------------------------------------------------------------------------------------
--------------------------------------------------------------------------------------------------------------------------------------------------------------------------------
--------------------------------------------------------------------------------------------------------------------------------------------------------------------------------
--------------------------------------------------------------------------------------------------------------------------------------------------------------------------------
-------------------------------------------------------------------k---------------------------------------------------------------g--------------------------------------------
------------------------------------------------------------------##---------------------------------------------------------oo---##--------------------------------------------
--------------------------------S%%---------------------------------------------SS%-----------------------------S%------------------------------------------SSooSS--------------
--------oo-----------------------||-ooo----------------------------------ooo------|--o---------------------------|---o------------------oo--------------ooo-------oooo----------
--------%%-%%%-------------------||-----------------------------------------------|---------------------SS-------|--------------------------------------------------------------
g-------||--|--------------------||----------------------SSS----------------------|---------------------SSS------|--------------------------------------------------------------
QQ------||--|--------------------|TT-----TT-----------------------S---------------|---------------S------S-------|-------TT-------------------------------------TT-------TT-----
--------||--|--------------------|TT-----TT----T-------TT--------------TT-------TT|------TT----------------------|TT-----TT---------tt------------------------TTTTT---tt-TT----T
--------||--|--------------------TTT-----TT----T-------TT--------------TT-------TT|---t--TT---------tt-----------|TT-----TT---------tt-TT--tt-----------------TTTTT-#-tt-TT----T
-gg-----||--|-------y-g--gk------TTT-----TT----T-------TT---kk---------TT-------TT|---t--TT----y----tt----k--k---|TT-----TT-----g---tt-TT--tt-----------------TTTTT---tt-TT----T
XXXXXXXXXXXXXXXXXXXXXXXXXXXXXXXXXXXXXXXXXXXXXXXXXXXXXXXXXXXXXXXXXXXXXXXXXXXXXXXXXXXXXXXXXXXXXXXXXXXXXXXXXXXXXXXXXXXXXXXXXXXXXXXXXXXXXXXXXXXXXXXXXXXXXXXXXXXXXXXXXXXXXXXXXXXXXXXX
XXXXXXXXXXXXXXXXXXXXXXXXXXXXXXXXXXXXXXXXXXXXXXXXXXXXXXXXXXXXXXXXXXXXXXXXXXXXXXXXXXXXXXXXXXXXXXXXXXXXXXXXXXXXXXXXXXXXXXXXXXXXXXXXXXXXXXXXXXXXXXXXXXXXXXXXXXXXXXXXXXXXXXXXXXXXXXXX
