------------------------------------------------------------------------------------------------------------------------------------------------------------------------------------------------
------------------------------------------------------------------------------------------------------------------------------------------------------------------------------------------------
------------------------------------------------------------------------------------------------------------------------------------------------------------------------------------------------
------------------SSSSSSSSSSSS----------------------------------------------------------------------------------SSSS-----------S-----------------S----------------------------------------------
------------------------------------------------------------------------------------------------------------------------------------------------------------------------------------------------
------------------------------------------------------------------------------------------------------------------------------------------------------------------------------------------------
--------%%%%%%%%SSSSSSSSSSSSSSSS--------------oo--------------------QQQSQSS--SSS---------------------QQQQS-----------------------ooo-----------o--------------------QQQQQSS--SSS----------------
---------||||||---------------------------------------------------------------------------------------------------------------------------------------------------------------------------------
---------||||||----------------------------#--------#----------------------------------------------------------------#-----------------------ooo------------------------------------------------
---------||||||-ooooo---------oo-----------#-------------------------------------------------------------------------#--------------------------------------------------------------------------
------%%%%%%%%%%SSSSSS-------SSS----------###-------------------QQQQQS@QSSSSS@S-------------------#---QQQ----Q-------2-----------------------S------------------QS----QQQS---U------------------
-------||||||||--------------------------####-------------------------------------------TT--------#---------------------------------------------------tt--------------------------------TTT-----
-------||||||||-------------------------#####---------tt--------------------------------TT---TT-##----------------------TT---TTT----------B-----------tt--------------------------------TTT-----
-------||||||||------kg--------g---k---#####----------tt-------g--gggg------------g-----TT---TT-###--k------k-----------TT---TTT---koy---##-------g---tt-----gg----k--------------g-----TTT---#-
XXXXXXXXXXXXXXXXXXXXXXXXXXXXXXXXXXXXXXXXXXXXXXXXXXXXXXXXXXXXXXXXXXXXXXXXXXXXXXXXXXXXXXXXXXXXXXXXXXXXXXXXXXXXXXXXXXXXXXXXXXXXXXXXXXXXXXXXXXXXXXXXXXXXXXXXXXXXXXXXXXXXXXXXXXXXXXXXXXXXXXXXXXXXXXXX
XXXXXXXXXXXXXXXXXXXXXXXXXXXXXXXXXXXXXXXXXXXXXXXXXXXXXXXXXXXXXXXXXXXXXXXXXXXXXXXXXXXXXXXXXXXXXXXXXXXXXXXXXXXXXXXXXXXXXXXXXXXXXXXXXXXXXXXXXXXXXXXXXXXXXXXXXXXXXXXXXXXXXXXXXXXXXXXXXXXXXXXXXXXXXXXX
