------------------------------------------------------------------------------------------------------------------------------------------------------------------------------------------------
------------------------------------------------------------------------------------------------------------------------------------------------------------------------------------------------
------------------------------------------------------------------------------------------------------------------------------------------------------------------------------------------------
------------------------------------------------SSSSSSSSSSSSSSSSSSSSSSS---------------------------------------------------------SSSSSSS---------------------------------------------------------
------------------------------------------------------------------------------------------------------------------------------------------------------------------------------------------------
---------------------------------------------------------------------------------------------------------------------------------------------------------------------------ooo-o----------------
--------%%%%%%%%-----------------------------------------------------------------------------------------------------------------oo-------------------SQQ------------------------ooo----------oo
---------||||||----------------------------------------------------------------------------------------------------------------#----------------------------------------------------------------
---------||||||----------------------------------------------------------------------------------------------------------------#----------------------------------------------------------------
---------||||||------------------------------------------------------------------------------------------------------------##--#----------------------------------------------------------------
------%%%%%%%%%%----------------------------------------------------------------------------------------------------------##--##-----t-------------------------------2--------o-----------#-----
-------||||||||----------TT----T------------------------------------------B--------------TT------------t-----------------####-##-----t-----------------t---------------tt----------------##-----
-------||||||||----------TT----T-------------T-----------------------B---TT---TT--B------TT---TT-------t-----------------T##--##----tt----------------tt---------------Tt---##-----------##-----
-------||||||||------ggg-TT---kT-----##------k---------------k-------b---TT---kT--b------TT---TT------tt----kk-----gg---####--##----tt------k---------tt----kk-g-ggg---Tt---k##g---k-y-####-----
XXXXXXXXXXXXXXXXXXXXXXXXXXXXXXXXXXXXXXXXXXXXXXXXXXXXXXXXXXXXXXXXXXXXXXXXXXXXXXXXXXXXXXXXXXXXXXXXXXXXXXXXXXXXXXXXXXXXXXXXXXXXXXXXXXXXXXXXXXXXXXXXXXXXXXXXXXXXXXXXXXXXXXXXXXXXXXXXXXXXXXXXXXXXXXXX
XXXXXXXXXXXXXXXXXXXXXXXXXXXXXXXXXXXXXXXXXXXXXXXXXXXXXXXXXXXXXXXXXXXXXXXXXXXXXXXXXXXXXXXXXXXXXXXXXXXXXXXXXXXXXXXXXXXXXXXXXXXXXXXXXXXXXXXXXXXXXXXXXXXXXXXXXXXXXXXXXXXXXXXXXXXXXXX-XXXXXXXXXXXXXXXX
