------------------------------------------------------------------------------------------------------------------------------------------------------------------------------------------------
------------------------------------------------------------------------------------------------------------------------------------------------------------------------------------------------
------------------------------------------------------------------------------------------------------------------------------------------------------------------------------------------------
--------------------------------------------------------------------------------SSSSSSSSSSS------SSSSSSSSS--------------------------------------SSSSSSSSSSSSSS-S--------------------------------
------------------------------------------------------------------------------------------------------------------------------------------------SS----------------------------------------------
------------------------------------------------------------------------------------------------------------------------------------------------------------------------------------------------
--------%%%%%%%%-------SSS-----S----------------oooo-----------------------------o------S--------oo-----oo------SSS@QSSSSS---SSS--------------------------------ooooSSSSoo---SSS---SQSQ---------
---------||||||---------------------------------------------------------------------------------------------------------------------------------------------------------------------------------
---------||||||-----------------------------------------------------o---------------------------------------------------------------------------------------------------------------------------
---------||||||------------------------------------------------------------------------------------------SS------------o----------------------------------------g--------------o----------------
------%%%%%%%%%%-------------U----------------------------###--------#------------------------------------------QSQQQSSSSSSSS@SS--------------------------------S---QQ-------SSS--------SSSSS@SS
-------||||||||------------------------------------------####------------------------tt------------------------------------------------tt-------------------------------------------------------
-------||||||||-----------------------------------------#####------------------------tt-------------tt---------------------------------tt---------------------TT--------------------------------
-------||||||||---gy-----------------------------------#####k----------k------kg-----tt-------g-----tt--------k----gggy-----------gg---tt----ggg-----g-k------TT-----kg-#---------gggggg-------k
XXXXXXXXXXXXXXXXXXXXXXXXXXXXXXXXXXXXXXXXXXXXXXXXXXXXXXXXXXXXXXXXXXXXXXXXXXXXXXXXXXXXXXXXXXXXXXXXXXXXXXXXXXXXXXXXXXXXXXXXXXXXXXXXXXXXXXXXXXXXXXXXXXXXXXXXXXXXXXXXXXXXXXXXXXX-XXXXXXXXXXXXXXXXXXXX
XXXXXXXXXXXXXXXXXXXXXXXXXXXXXXXXXXXXXXXXXXXXXXXXXXXXXXXXXXXXXXXXXXXXXXXXXXXXXXXXXXXXXXXXXXXXXXXXXXXXXXXXXXXXXXXXXXXXXXXXXXXXXXXXXXXXXXXXXXXXXXXXXXXXXXXXXXXXXXXXXXXXXXXXXXX-XXXXXXXXXXXXXXXXXXXX
