------------------------------------------------------------------------------------------------------------------------------------------------------------------------------------------------
------------------------------------------------------------------------------------------------------------------------------------------------------------------------------------------------
------------------------------------------------------------------------------------------------------------------------------------------------------------------------------------------------
-----------------#---------------SSS-----------------------------SSSSSSSSS----------------------SSSSSSSSSSS---------------------SSSSSSSSSS------SSSSSSSSSSSS------------------------------------
--------------------------------------------------------------------------------------------------------------------------------SSS-------------------------------------------------------------
----------------------------------------------------------------------------------------------------------------------------------S-------------------------------------------------------------
--------%%%%%%%%------S%So-----------------S-----------------------------------------------------------------------------------SSSSSSSSS-SSSSSSS-------------------------o------SSSS@SSS-----SSS
---------||||||---%%%--|-------------%----------------------------------------------------------------------------------------------------------------------------------------------------------
---------||||||----|---|-------------|----------------------------------------------------------------------------------------------------------------------------------------------------------
---------||||||----|---|-------------|------------------------------------------------------------------------------------------ooooo-------------------------------------------oooo-----------o
------%%%%%%%%%%---|---|-------------|tt-----------------------------------------------------------------------------###--------SSSSSS-------SSS--------------------------------SSSSS--------SSS
-------||||||||----|---|--#----------|tt-----------------TT---------------#---------------K---------------#----------------------------------------------TT-------------------------------------
-------||||||||----|---|-##----------|tt-----------------TT--------------##------------------------------##---TT-----------------------------------------TT---TT-----tt-------------------------
-------||||||||----|---|###----g-----|tt-----g-g--k------TT---k---k--k--###-------kggg--------kg-----k---##-k-TT-------------------k-gg-----k-k------k---TT---TT--k--tt--k----y------ggg#-k-k---
XXXXXXXXXXXXXXXXXXXXXXXXXXXXXXXXXXXXXXXXXXXXXXXXXXXXXXXXXXXXXXXXXXXXXXXXXXXXXXXXXXXXXXXXXXXXXXXXXXXXXXXXXXXXXXXXXXXXXXXXXXXXXXXXXXXXXXXXXXXXXXXXXXXXXXXXXXXXXXXXXXXXXXXXXXXXXXXXXXXXXXXXXXXXXXXX
XXXXXXXXXXXXXXXXXXXXXXXXXXXXXXXXXXXXXXXXXXXXXXXXXXXXXXXXXXXXXXXXXXXXXXXXXXXXXXXXXXXXXXXXXXXXXXXXXXXXXXXXXXXXXXXXXXXXXXXXXXXXXXXXXXXXXXXXXXXXXXXXXXXXXXXXXXXXXXXXXXXXXXXXXXXXXXXXXXXXXXXXXXXXXXXX
