------------------------------------------------------------------------------------------------------------------------------------------------------------------------------------------------
------------------------------------------------------------------------------------------------------------------------------------------------------------------------------------------------
------------------------------------------------------------------------------------------------------------------------------------------------------------------------------------------------
------------------------------------------------SSSSSSSooooSSS--SSSSSSSSSSS------SSSSSSSS-----------------------SSSSSSSS----------------------------------------SSSSSS----------SSSSSSSSSSS-----
------------------------------------------------------------------------------------------------------------------------------------------------------------------------------------------------
------------------------------------------------------------------------------------------------------------------------------------------------------------------------------------------------
--------%%%%%%%%-------------------------------U---o---------o------------------ooo----------------------------S----------------SoooSSSSoo---SSS--------------------------------ooo-----oo------
---------||||||---------------------------------------------------------------------------------------------------------------------------------------------------------------------------------
---------||||||---------------------------------------SSSSSSSSSS----------------------------------------------------------------------------------------------------------------S---------------
---------||||||----------------------------------------------------------------------------#------------------------------------o-o-------------------------------------------------------------
------%%%%%%%%%%------------#-------------------S-----------------------------------------##------------------------------------S---QQQQQ----US-----#-------------------------------------------
-------||||||||-----------#------------------------------------------tt------------------###-------------------------------------------------------------TT--------------------------tt---------
-------||||||||----------##-------------------------tt---------------tt--TT---TT---------###-----------TT---------------------TT-------------------------TT--------------------------tt---------
-------||||||||----k-----##--------kggg------ggg----tt-----g---------tt--TT---TT-----g-g####------gggg-TT---#--g--k------k----TT-----kg-----k------ggg---TT---k--------k-g-----k-----tt---------
XXXXXXXXXXXXXXXXXXXXXXXXXXXXXXXXXXXXXXXXXXXXXXXXXXXXXXXXXXXXXXXXXXXXXXXXXXXXXXXXXXXXXXXXXXXXXXXXXXXXXXXXXXXXXXXXXXXXXXXXXXXXX-XXXXXXXXXXXXXXXXXXXXXXXXXXXXXXXXXXXXXXXXXXXXXXXXXXXXXXXXXXXXXXXXXX
XXXXXXXXXXXXXXXXXXXXXXXXXXXXXXXXXXXXXXXXXXXXXXXXXXXXXXXXXXXXXXXXXXXXXXXXXXXXXXXXXXXXXXXXXXXXXXXXXXXXXXXXXXXXXXXXXXXXXXXXXXXXX-XXXXXXXXXXXXXXXXXXXXXXXXXXXXXXXXXXXXXXXXXXXXXXXXXXXXXXXXXXXXXXXXXX
