------------------------------------------------------------------------------------------------------------------------------------------------------------------------------------------------
------------------------------------------------------------------------------------------------------------------------------------------------------------------------------------------------
------------------------------------------------------------------------------------------------------------------------------------------------------------------------------------------------
------------------------------------------------SSSSSS----------SSSSSSSSSSSS------------------------------------SSS---------------------------------------------SSSSSSSS------------------------
------------------------------------------------------------------------------------------------------------------------------------------------------------------------------------------------
---------------------------------------------------------------------------------------------------------------------------------------g--------------------------------------------------------
--------%%%%%%%%-SoS-----------S-----------------------SSo-----S--------S------SS---Q----S-----o------------------------------------QQQQQS---------------------U----------------------SQS-------
---------||||||------------------------------------%%-------------------------------------------------------------------------------------------------------------------------------------------
---------||||||------------------------------------||----------------------------------------o--------------------------------------------------------------------------------------------------
---------||||||------------------------------------||-----------------------------------------------------------------#-------------------------------------------------------------------------
------%%%%%%%%%%------S@-----SS--------------------||-----------------------------Q----------@S-----------------------#---------Q-------Q--------------------------------------------QQ------o--
-------||||||||------------------------------------||tt--------------tt----------------------------------TT-----------tt----##--------------------------TTT------------tt----TT-----------------
-------||||||||------------------------------------||tt--------------tt---------------------------B------TT----------ttt---###--------------------------TTT------------tt----TT-----------------
-------||||||||-------------------gg--------kkk----||tt---------#----tt----k------gggg----k-------b------TT--g-------ttt---####---gg--------k-----gk----TTT--##-g----k-tt----TT-----------------
XXXXXXXXXXXXXXXXXXXXXXXXXXXXXXXXXXXXXXXXXXXXXXXXXXXXXXXXXXXXXXXXXXXXXXXXXXXXXXXXXXXXXXXXXXXXXXXXXXXXXXXXXXXXXXXXXXXXXXXXXXXXXXXXXXXXXXXXXXXXXXXXXXXXXXXXXXXXXXXXXXXXXXXXXXXXXXXXXXXXXXXXXXXXXXXX
XXXXXXXXXXXXXXXXXXXXXXXXXXXXXXXXXXXXXXXXXXXXXXXXXXXXXXXXXXXXXXXXXXXXXXXXXXXXXXXXXXXXXXXXXXXXXXXXXXXXXXXXXXXXXXXXXXXXXXXXXXXXXXXXXXXXXXXXXXXXXXXXXXXXXXXXXXXXXXXXXXXXXXXXXXXXXXXXXXXXXXXXXXXXXXXX
