------------------------------------------------------------------------------------------------------------------------------------------------------------------------------------------------
------------------------------------------------------------------------------------------------------------------------------------------------------------------------------------------------
------------------------------------------------------------------------------------------------------------------------------------------------------------------------------------------------
----------------------------------------------------------------SSSSSSSSSSSSSSSS--------------------------------SSSSSS----------------------------------------------------------SS--------------
------------------------------------------------------------------------------------------------------------------------------------------------------------------------------------------------
------------------------------------------------------------------------------------------------------------------------------------------------------------------------------------------------
--------%%%%%%%%--------------------Q-----------------SSSS----SS--------------------------------SSS@S----------o--------S-----------QQQSQS---SSS----------------oooo----oo-----o----------------
---------||||||-----------------------------------------------------------------S---------------------------------------------------------------------------------------------------------------
---------||||||-------------------------------o---------------------------------------------------------------o-#-------------------------------------------------------------------------------
---------||||||---------------------------------------------------------------------------------------------------------------------------------------------------------------------------------
------%%%%%%%%%%---------------------------SS@S--------------------------------------------------------------SS------------------------QQ----o----------------------------------------tt--------
-------||||||||-###---tt----------------------------tt-------------------TT------------------------------TT----------------------------------------------TT---------------------------tt-----TT-
-------||||||||-###---tt-----#----------------------tt---------------B---TT------------------------------TT----------------------------------------------TT---------------------------tt-----TT-
-------||||||||-###---tt-----g-----ygggg------------tt-------------------TT---g--------y-----ggg---k-ggg-TT----------k-------------k--------------ggg----TT---k-----------------------tt-----TT-
XXXXXXXXXXXXXXXXXXXXXXXXXXXXXXXXXXXXXXXXXXXXXXXXXXXXXXXXXXXXXXXXXXXXXXXXXXXXXXXXXXXXXXXXXXXXXXXXXXXXXXXXXXXXXXXXXXXXXXXXXXXXXXXXXXXXXXXXXXXXXXXXXXXXXXXXXXXXXXXXXXXXXXXXXXXXXXXXXXXXXXXXXXXXXXXX
XXXXXXXXXXXXXXXXXXXXXXXXXXXXXXXXXXXXXXXXXXXXXXXXXXXXXXXXXXXXXXXXXXXXXXXXXXXXXXXXXXXXXXXXXXXXXXXXXXXXXXXXXXXXXXXXXXXXXXXXXXXXXXXXXXXXXXXXXXXXXXXXXXXXXXXXXXXXXXXXXXXXXXXXXXXXXXXXXXXXXXXXXXXXXXXX
