--------------------------------------------------------------------------------------------------------------------------------------------------------------------------------
--------------------------------------------------------------------------------------------------------------------------------------------------------------------------------
--------------------------------------------------------------------------------------------------------------------------------------------------------------------------------
-------------------------------------------------------------------------------------#------------------------------------------------------------------------------------------
-----------------------------------k--------------------------------------------------------------------------------------------------------------------------------------------
---------------o------------------##----------------------------------------------##------------------------------##-----------------------------------------------#------------
----------------------------------------------------------------SS------------------------------%%%---------------------------------------------SS------------------------------
----------------------------------------oooo--------------o--------ooo---------------------------|---o-------------------oo-------------oooo------oooo-------------------SS-----
-------------------------------------------------------------------------------------------------|----------------------------------------------------------------------SSS-----
-----S-----------------------------------SS----------------------------------------------SSS-----|------------------------S--------------S------------------------------SSSS----
-----S------------TT--------TT-------------------##-----------TTTT--------T----------------------|--------------------------------------------TTTT-------TT---------------------
-------------#----TT--------TT---------TT-------#---TT--------TTTT----tt-TT----T----tt-TT--------|TT-----TT---------tt------------------------TTTT-------TT---TT-------TT-------
------------##----TT--------TT------tt-TT-----------TT--------TTTT----tt-TT----T----tt-TT-----#--|TT-----TT---------tt-TT--------------TT-----TTTTT-#-tt-TT---TT----tt-TT-------
--kk---k-k--##----TT--------TT------tt-TT-k---------TT--------TTTT----ttkTT----T----tt-TT-----#--|TT-----TT----k----tt-TT--------------TT-----TTTTT---ttkTT----T----tt-TT-------
XXXXXXXXXXXXXXXXXXXXXXXXXXXXXXXXXXXXXXXXXXXXXXXXXXXXXXXXXXXXXXXXXXXXXXXXXXXXXXXXXXXXXXXXXXXXXXXXXXXXXXXXXXXXXXXXXXXXXXXXXXXXXXXXXXXXXXXXXXXXXXXXXXXXXXXXXXXXXXXXXXXXXXXXXXXXXXXX
XXXXXXXXXXXXXXXXXXXXXXXXXXXXXXXXXXXXXXXXXXXXXXXXXXXXXXXXXXXXXXXXXXXXXXXXXXXXXXXXXXXXXXXXXXXXXXXXXXXXXXXXXXXXXXXXXXXXXXXXXXXXXXXXXXXXXXXXXXXXXXXXXXXXXXXXXXXXXXXXXXXXXXXXXXXXXXXX
