------------------------------------------------------------------------------------------------------------------------------------------------------------------------------------------------
------------------------------------------------------------------------------------------------------------------------------------------------------------------------------------------------
------------------------------------------------------------------------------------------------------------------------------------------------------------------------------------------------
----------------SSSSSSSSSS---SSS----------------SSSSSSSSSS---SSSSSSSSSSSSSS-------------------------------------SSSSSSSS----------------------------------------SSSSSSSSSSSSSSSSSSS-------------
-----------------------------------------------------------------------------------------------------------------------------------------------------------------S------------------------------
------------------------------------------------------------------------------------------------------------------------------------------------------------------------------------------------
--------%%%%%%%%--------SSSS-------------------o---------------S--------SS----------------------------------------------------------QQQQQSS--S@S---------------o-S--------------------SSS-------
---------||||||----------------------------------------------------------------------------------------------------------------------------------------------------------------------%%---------
---------||||||----------------------------------------------------------------------------------------------------------------------------------------------------------------------||---------
---------||||||-----------------o----------------------------------------------------------------------------------------------------------------------------------------------------||---------
------%%%%%%%%%%-------------##--------------------------------------------------------------------------TT--#-----------------------QQQQQ---Q---------------------------------------||---------
-------||||||||-o----------#-#---------------------------------------ttt---------------------------------TT--#----------TT---TT--------------------------TT--------------------------|tt--------
-------||||||||-%----------###-----------##--------------#-#---------ttt---------------------------------TT--#----------TT---TT--------------------------TT----------ttt-B-----------|tt--------
-------||||||||-|----------###-----k-ggg-##-------------####-#g------ttt-----gg----gg-------------k--k---TT--##---b--kkkTT---TT-------------------kgg----TT----------ttt-b---g--#----|tt---k-k--
XXXXXXXXXXXXXXXXXXXXXXXXXXXXXXX-XXXXXXXXXXXXXXXXXXXXXXXXXXXXXXXXXXXXXXXXXXXXXXXXXXXXXXXXXXXXXXXXXXXXXXXXXXXXXXXXXXXXXXXXXXXXXXXXXXXXXXXXXXXXXXXXXXXXXXXXXXXXXXXXXXXXXXXXXXXXXXXXXXXXXXXXXXXXXXXX
XXXXXXXXXXXXXXXXXXXXXXXXXXXXXXX-XXXXXXXXXXXXXXXXXXXXXXXXXXXXXXXXXXXXXXXXXXXXXXXXXXXXXXXXXXXXXXXXXXXXXXXXXXXXXXXXXXXXXXXXXXXXXXXXXXXXXXXXXXXXXXXXXXXXXXXXXXXXXXXXXXXXXXXXXXXXXXXXXXXXXXXXXXXXXXXX
