------------------------------------------------------------------------------------------------------------------------------------------------------------------------------------------------
------------------------------------------------------------------------------------------------------------------------------------------------------------------------------------------------
------------------------------------------------------------------------------------------------------------------------------------------------------------------------------------------------
----------------------------------------------------------------SSSSSSSSSSSSSSSS--------------------------------SSSSSSSSSSSSSSSSSSSSS-------------------------------------------SSSSSSSSSSS-----
----------------------------------------------------------------------------------------------------------------S-------------------------------------------------------------------------------
------------------------------------------------------------------------------------------------------------------------------------------------------------------------------------------------
--------%%%%%%%%---------------S------SSSSS----S--------------------------------------SSSS---S-S---------------U-------------SSS------SSSSSS---S-----QQQQ----SSS-----------------------SS-------
---------||||||---------------------------------------------------------------------------------------------------------------------------------------------------------------------------------
---------||||||---------------------------------------------------------------------------------------------------------------------------------------------------------------------------------
---------||||||-----------------------------------------------------------------------------------------------------------------------------------------------#---------------------------------
------%%%%%%%%%%-------------o---------------------------TT--------------------------------------------------o------------------------tt----------------------#----------T------------tt-----o--
-------||||||||--------K---------------------------------TT----------------------------t-----#-----------TT--------------B------------tt---------------------##---------TTT----------ttt-----tt-
-------||||||||--------b---------------------#-----------TT----------t----------------tt-----#-----------TT----------t---b-----------ttt--------------------####--------TTT---TT-----ttt--------
-------||||||||-g--k---b----k-----gy-kk------#-#--gk-----TT----------t---#----g---gg--tt-----#----ggggg--TT----------t---b#---y-y----ttt---ygy-----g--------####--k-----TTT---#T-----ttt----ggg-
XXXXXXXXXXXXXXXXXXXXXXXXXXXXXXXXXXXXXXXXXXXXXXXXXXXXXXXXXXXXXXXXXXXXXXXXXXXXXXXXXXXXXXXXXXXXXXXXXXXXXXXXXXXXXXXXXXXXXXXXXXXXXXXXXXXXXXXXXXXXXXXXXXXXXXXXXXXXXXXXXXXXXXXXXXXXXXXXXXXXXXXXXXXXXXXX
XXXXXXXXXXXXXXXXXXXXXXXXXXXXXXXXXXXXXXXXXXXXXXXXXXXXXXXXXXXXXXXXXXXXXXXXXXXXXXXXXXXXXXXXXXXXXXXXXXXXXXXXXXXXXXXXXXXXXXXXXXXXXXXXXXXXXXXXXXXXXXXXXXXXXXXXXXXXXXXXXXXXXXXXXXXXXXXXXXXXXXXXXXXXXXXX
