------------------------------------------------------------------------------------------------------------------------------------------------------------------------------------------------
------------------------------------------------------------------------------------------------------------------------------------------------------------------------------------------------
------------------------------------------------------------------------------------------------------------------------------------------------------------------------------------------------
---------------------------------S---------------S----------------------------------------------SSSSSSSS----------------------------------------SSSSSS-----------SSSSS--------------------------
-------------------------------------------------------------------------------------------------------------------------------o----------------------------------------------------------------
------------------------------------------------------------------------------------------------------------------------------------------------------------------------------------------------
--------%%%%%%%%oooo-SS-------S--------SS-----------------------oooo--SS-----SSS-------------SS-----------------oooo---SoS---SSS-SSSSS---------------------------o--------------SooSSSSSoS---SSS
---------||||||----------------------------------o----------------------------------------------------------------------------------------------------------------------------------------------
---------||||||---------------------------------------------------------------------------------------------------------------------------------------------------------------------------------
---------||||||-------------------------------------------------o-----------------------------------------------o-------------------------------------------------------------------------------
------%%%%%%%%%%----------------------SS------------------###-------Q-----#---------S--------------------------------o-------o-----------TT---So--------------------------------Q-QSQQSSS----SSS
-------||||||||----------TT-----------tt-----------------####------------##--------------------------------------------------------------TT------------------------------TT---------------------
-------||||||||----------TT----------tt------------------###------------###--------------------------tt--##------------------------------TT-----------tttt----TT---------TT---------------------
-------||||||||-----gggg###---k------tt----kgg-------g--####k--g----ggg####---------gg----g----------tt--##---##-----kkg----k------ggg---TT-------g---tttt----TT-----g---TT----g------g-#-k-----
XXXXXXXXXXXXXXXXXXXXXXXXXXXXXXXXXXXXXXXXXXXXXXXXXXXXXXXXXXXXX-XXXXXXXXXXXXXXXXXXXXXXXXXXXXXXXXXXXXXXXXXXXXXXXXXXXXXXXXXXXXXXXXXXXXXXXXXXXXXXXXXXXXXXXXXXXXXXXXXXXXXXXXXXXXXXX-XXXXXXXXXXXXX-XXXX
XXXXXXXXXXXXXXXXXXXXXXXXXXXXXXXXXXXXXXXXXXXXXXXXXXXXXXXXXXXXX-XXXXXXXXXXXXXXXXXXXXXXXXXXXXXXXXXXXXXXXXXXXXXXX-XXXXXXXXXXXXXXXXXXXXXXXXXXXXXXXXXXXXXXXXXXXXXXXXXXXXXXXXXXXXXXX-XXXXXXXXXXXXX-XXXX
