-----------------------------------------------------------------------------------%%-----------------------------------------------------------------------------------------------------------
-----------------------------------------------------------------------------------||-----------------------------------------------------------------------------------------------------------
-----------------------------------------------------------------------------------||-----------------------------------------------------------------------------------------------------------
-----------------------------------------------------------------------------------||-----------------------------------------------------------------------------------------------------------
-----------------------------------------------------------------------------------||------------------------------------------------------------------------------k----------------------------
------------------##--------------------------------------o----o-------------------||-----------------------------------------------------------------------------------------------------------
--------%%%%%%%%-----------------------------------oSSS---------%---------S---SS---||--------------------S----------------------------------------------------------------------%---------------
---------||||||----------ooo------------------------------------|---------------%--||----------------------------------------------------------U------------------------oooo----|---------------
---------||||||-------------------------------------------------|---------------|--||-------------------------------------------------------------------------------------------|---------------
---------||||||------------------------------------oooo---------|---------------|--||-----------------------y--------------------------------g----------------------------------|---------------
------%%%%%%%%%%-------TT-------------------------SSSSSo----##--|-----QQ---Q----|--||-------TT--------------##----2----------##--------------##---------------Q-----------------|TTT-----------Q
-------||||||||--------TT-----------------------------------##--|-TT------------|--||-------TT-------------###--------------###-------------###---TT----------------------------|TTT------------
-------||||||||--------TT-------------------##------------####--|-TT------------|--||-------TT--------B---####-------------####------------####---TT-------------------TT-------|TTTT-----------
-------||||||||--------TT---------------y---##----kk---kk#####--|-TT----------g-|-k||-----k-TT--------b---####---gg-----y-#####--gg-----y-#####---TT--gg-----gg--gg----TT-------|TTTT------gggg-
XXXXXXXXXXXXXXXXXXXXXXXXXXXXXXXXXXXXXXXXXXXXXXXXXXXXXXXXXXXXXXXX|XXXXXXXXXXXXXXXXXXXXXXXXXXXXXXXXXXXXXXXXXXXXXXXXXXXXXXXXXXXXXXX-XXXX-XXXXXXXXXXXXXXXXXXXXXXXXXXXXXXXXXXXXXXXXXXXXXXXXXXXXXXXXXX
XXXXXXXXXXXXXXXXXXXXXXXXXXXXXXXXXXXXXXXXXXXXXXXXXXXXXXXXXXXXXXXXXXXXXXXXXXXXXXXXXXXXXXXXXXXXXXXXXXXXXXXXXXXXXXXXXXXXXXXXXXXXXXXX-XXXX-XXXXXXXXXXXXXXXXXXXXXXXXXXXXXXXXXXXXXXXXXXXXXXXXXXXXXXXXXX
