--------------------------------------------------------------------------------------------------------------------------------------------------------------------------------
--------------------------------------------------------------------------------------------------------------------------------------------------------------------------------
--------------------------------------------------------------------------------------------------------------------------------------------------------------------------------
--------------------------------------------------------------------------------------------------------------------------------------------------------------------------------
--------------------------------------------------------------------------------------------------------------------------------------------------------------------------------
--------------------------------------------------------------------------------------------------------------------------------------------------------------------------------
-------------------------------------------------------------ooo---------SS-------------------------------------------U---------------------------------------------------------
---------------y--------------------%%%---------------%%----------------------------------------------SS---------%%-%-----------------------------------------------------------
--------------##---------------------|----------------||---------------------------------------------------------||-|-----------------------------------------------------------
-------------2##---------------------|----------------||---------------------------------------------------------||-|-----------------------------------------------------------
------------####---------------------|SS---------Q----||---------------------Q---------Q-------------------------||-|--S@-------------------------TT----------------------------
-----------#####--------------TT--TT-|------TT--------||------TT---------TT------------------------------TT------||-|-------TT-------------------TTT-----TT---------------------
----------######--------------TT--TT-|------TT--------||------TT------B--TT------------------------------TT------||-|-------TT-------------------TTT-----TT---------------------
---------#######-------k------TT--TT-|-ggg--TT-----g--||------TT------b--TT----g------gg-g-------------k-TT------g|g|--gggg-TT---------k---------TTT--g--TT----g-gg-------g-----
XXXXXXXXXXXXXXXXXXXXXXXXXXXXXXXXXXXXXXXXXXXXXXXXXXXXXXXXXXXXXXXXXXXXXXXXXXXXXXXXXXXXXXXXXXXXXXXXXXXXXXXXXXXXXXXXXXXXXXXXXXXXXXXXXXXXXXXXXXXXXXXXXXXXXXXXXXXXXXXXXXXXXXXXXXXXXXXX
XXXXXXXXXXXXXXXXXXXXXXXXXXXXXXXXXXXXXXXXXXXXXXXXXXXXXXXXXXXXXXXXXXXXXXXXXXXXXXXXXXXXXXXXXXXXXXXXXXXXXXXXXXXXXXXXXXXXXXXXXXXXXXXXXXXXXXXXXXXXXXXXXXXXXXXXXXXXXXXXXXXXXXXXXXXXXXXX
