------------------------------------------------------------------------------------------------------------------------------------------------------------------------------------------------
------------------------------------------------------------------------------------------------------------------------------------------------------------------------------------------------
------------------------------------------------------------------------------------------------------------------------------------------------------------------------------------------------
---------------------------------SSSSSSS----------------------------------------SSSSSSSS--------------------------------------------------------SSSSSSSSSS-----------------------S--------------
-------------------------------------------------------------------------------------------------------------------------------------------------------------------------------o----------------
---------------------------------------------------------oo-------------------------------------------------------------------------------------------------------------------------------------
--------%%%%%%%%------------------------------------------------------------------------------------SSSo---------oo---------------------------------------------------Sooo-----S----------------
---------||||||---------------------------------------------------------------------------------------------------------------------------------------------------------------------------------
---------||||||---------------------------------------------------------------------------------------------------------------------------------------------------------------------------------
---------||||||---------------------------------------------------------------------------------------------------------------------------------------------------------------------------------
------%%%%%%%%%%---------TT---------------------------------------------------------------------##--S--------o------------------------tt------------------#-------------------------------------
-------||||||||----------TT--------------TT------------------------------TT----------ttt----------------------------------------------tt------------------#-------------------------------------
-------||||||||-ooo------TT--------------TT------------------------------TT----------ttt------------------#---------tt----#-----------tt-----TT-----------#----------------------------TT-------
-------||||||||----------TT----o--k------TT-----------------------kggg---TT---k------ttt-----k-------gg---#-k-------tt----#-----------tt-----TT---k--k---##---#-----gg----k-k-----b----TT---#-g-
XXXXXXXXXXXXXXXX-%%%-----XX-----XXXXXXXXXXXXXXXXXXXXXXXXXXXXXXXXXXXXXXXXXXXXXXXXXXXXXXXXXXXXXXXXXXXXXXXXXXXXXXXXXXXXXXXXXXXXXXXXXXXXXXXXXXXXXXXXXXXXXXXXXXXXXXXXXXXXXXXXXXXXXXXXXXXXXXXXXXXXXXXX
XXXXXXXXXXXXXXXX--|-------------XXXXXXXXXXXXXXXXXXXXXXXXXXXXXXXXXXXXXXXXXXXXXXXXXXXXXXXXXXXXXXXXXXXXXXXXXXXXXXXXXXXXXXXXXXXXXXXXXXXXXXXXXXXXXXXXXXXXXXXXXXXXXXXXXXXXXXXXXXXXXXXXXXXXXXXXXXXXXXXX
