-------------------------------------------------------------------------------------------------%-----Q---------%---------------%--------------------------------------------------------------
-------------------------------------------------------------------------------------------------|---------------|---------------|--------------------------------------------------------------
-------------------------------------------------------------------------------------------------|---------------|---------------|--------------------------------------------------------------
---------------------S---------------------------------------------------------------------------|---------------|---------------|--------------------------------------------------------------
-------------------------------------------------g--------R------1--------o----------------------|---------------|---------------|--------------------------------------------------------------
--------------------------------%--------------U%%%%-------------%%------------------------------|--------------%%---------------|--------------------------------------------------------------
--------%%%%%%%%--SSSo----------|----------------||--------------||---U--------------------------|--------------||----r----------|----r---------------r---------------r---------------r---------
---------||||||----SS-----------|----------------||--------------%%%%%%----------%%%%%%----------|--%%%---------%%%%%%%%%-------%%%%%%%%%-------%%%%%%%%%%------%%%%%%%%%-------%%%%%%%%%%------
---------||||||----SS----TT--T--|----------------||---------------||||------------||||-----------|---|-----------|||||||---------|||||||---------||||||||--------|||||||---------||||||||-------
---------||||||-------------TT--|------r-----g---|g---------------||||------------||||-----------|---|-----------|||||||---------|||||||---------||||||||--------|||||||---------||||||||-------
------%%%%%%%%%%#---SU---TT--#--%%%%%-%%%%-------||----SS---------|Q||--@---------||||-----------|---|----------QQ|||||Q@--------||||||SU-------S|||||SSU---TT---|||||SS@--------|||||SSU-------
-------||||||||----------TT----#-|||---||----#---||---------------|-||------------||||-----------|---|------------|||||----------||||||-----TT---|||||--|---TT---|TT||------TT---|||||--|---TT--
-------||||||||----------TT----#%%||---||---##---||---------------|-||------------||||tt---------|---tt-----------|||||----------|T||||-----TT---|TT||--|---TT---|TT||------TT---|TT||--|---TT--
-------||||||||----------TT----#||g|---|gg--##--g||-----gggg------|-||---g--------||||tt-----ggg-|---tt-------g---|||||--gg------|T||||-gg--TT---|TT||-ggg--TT---|TT||-ggg--TT-k-|TT||-ggg--TT-k
XXXXXXXXXXXXXXXXX---XXXXXXXX---X||||---XXXXXXX--XXXXXXXXXXXXXXX-XXXXXXXXXXXXXXXXXXXXXXXXXXXXXXXXXXXXXXXXXXXXXXXXXXXXXXXXXXXXXXXXXXXXXXXXXXXXXXXXXXXXXXXXXXXXXXXXXXXXXXXXXXXXXXXXXXXXXXXXXXXXXXXX
XXXXXXXXXXXXXXXXX---XXXXXXXXXX-X||||---XXXXXXX--XXXXXXXXXXXXXXXXXXXXXXXXXXXXXXXXXXXXXXXXXXXXXXXXXXXXXXXXXXXXXXXXXXXXXXXXXXXXXXXXXXXXXXXXXXXXXXXXXXXXXXXXXXXXXXXXXXXXXXXXXXXXXXXXXXXXXXXXXXXXXXXX
