----------------------------------%---------------------------------------------------------------------------------------------------------------------------------------------
----------------------------------|---------------------------------------------------------------------------------------------------------------------------------------------
----------------------------------|---------------------------------------------------------------------------------------------------------------------------------------------
SSSSSSSSSSSSSSSS------------------|---------------------------------------------------------------------------------------------------------------------------------------------
----------------------------------|g--------------------------------------------------------------------------------------------------------------------------------------------
----------------------------------|---------------------------------------------------------------------------------------------------------------------------------------------
----------------------------------|-------------%------------------------------o------------------------------------------------%%%-------------%%------------------------------
--K-------------------------------|-------------|-----------------------------------------------o-------------------------------o|--------------||------------------------------
--SS--K---------%%%%%%%%%---------|-------------|------------------%%------------------------------------------------------------|--------------||------------------------------
--------------SS-|||||||----------|-------------|------------------||------------------------------------------------------------|--------------||------------------------------
%----------------|||||||----------|-------------|-TT---------------||------------------------#----TT--------------TT-------------TTT------------|TTT--------Q-----TT------------
|----------------|||||||-----#----|---------TT--|-TT---------------||-------------TT--------##----TT--------TT----TT-------------TTT------------|TTT--------------TT------------
%---------%%-----|||||||----##----|---------TT--|-TT---------------||-------------TT-------###----TT--------TT----TT-------------TTTT-----------|TTTT-------------TT------------
|---------||-----|||||||----##---gg-------k-TT--|-TT--------TT-k---||--------gg---TT---gg#####----TT-----g--TT-k--TT--------y----TTTT-----------|TTTT---------gg--TT---------ggg
%%%%%%%%%%%%%----X||||||--XXXXX-XXXXXXXXXXXXXXXXXXXXXXXXXXXXXXXXXXXXXXXXXXXXXXXXXXXXXXXXXXXXXXXXXXXXXXXXXXXXXXXX-XXXX--XXXXXXXXXXXXXXXXXXXXXXXXXXXXXXXXXXXXXXXXXXXXXXXXXXXXXXXXX
g|||||||||||g----X||||||--XXXXX-XXXXXXXXXXXXXXXXXXXXXXXXXXXXXXXXXXXXXXXXXXXXXXXXXXXXXXXXXXXXXXXXXXXXXXXXXXXXXXXXXXXXX-XXXXXXXXXXXXXXXXXXXXXXXXXXXXXXXXXXXXXXXXXXXXXXXXXXXXXXXXXX
