------------------------------------------------------------------------------------------------------------------------------------------------------------------------------------------------
------------------------------------------------------------------------------------------------------------------------------------------------------------------------------------------------
------------------------------------------------------------------------------------------------------------------------------------------------------------------------------------------------
----------------SSSS-----------S-----------------------------------------------------------------SSSS-------------------------------------------------------------------------------------------
-----------------------------------------------2------------------------------------------------------------------------------------------------------------------------------------------------
-------------------------------------------------------------------------------------------------------------------------------o----------------------------------------------------------------
--------%%%%%%%%%%%---------------------------------QQQQQ-----o-----QQQ--------U-o----Sooo-----o----------------------SS-------S---------------------QQQQ-----oo-----------------ooo------------
---------||||||--|----------------------------------------------------------------Soo---------------------------------------------------------------------------S-------------------------------
---------||||||--|---------%-------------------------------------------------oo--------------SSS------------------------------------------------------------------------------------------------
---------||||||--|---------|--------------------------------------------------------------------------------------------------------------------------------------------------------------------
------%%%%%%%%%%-|---------#--------------------##Q#----Q--------------------@S----------------------------------------------USo---------TT-##--####--Q#Q---------------------------------------
-------||||||||-o|---------#------TT-------------------------#------------K--------------------------------------------------------------TT-#---####-#-----------------------------------##-----
-------||||||||-%%-------###------TT----K--------------------#----------------------tt----------------tt------TT-------------#----B------TT-----#####------------------------------------##-----
-------||||||||-%|-------###------TT----g----gg----k---------#----gk-ggg--k-k-------tt------------b---tt------TT--gg---k----------b------TT-----#####kk-----k-----b----------ggg---k-k--###-----
XXXXXXXXXXXXXXXX||---XXXXXXXX--XXXXXXXXXXXXXXXXXXXXXXXXXXXXXXXXXXXXXXXXXXXXXXXXXXXXXXXXXXXXXXXXXXXXXXXXXXXXXXXXXXXXXXXXXXXXXXXXXXXXXXXXXXXXXXXXXXXXXXXXXXXXXXXXXXXXXXXXXXXXXXXXXXXXXXXXXXXXXXXXX
XXXXXXXXXXXXXXXX||---XXXXXXXX-XXXXXXXXXXXXXXXXXXXXXXXXXXXXXXXXXXXXXXXXXXXXXXXXXXXXXXXXXXXXXXXXXXXXXXXXXXXXXXXXXXXXXXXXXXXXXXXXXXXXXXXXXXXXXXXXXXXXXXXXXXXXXXXXXXXXXXXXXXXXXXXXXXXXXXXXXXXXXXXXXX
