------------------------------------------------------------------------------------------------------------------------------------------------------------------------------------------------
------------------------------------------------------------------------------------------------------------------------------------------------------------------------------------------------
------------------------------------------------------------------------------------------------------------------------------------------------------------------------------------------------
----------------------------------------------------------------SSSS-------------S------------------------------SSSSSSSS-------------------------S---------------S-SSS----------SSS-------------
-----------------------------------------------o---------------S--------------------------------------------------------------------------------------------------------------------------------
------------------------------------------------------------------------------------------------------------------------------------------------------------------------------------------------
--------%%%%%%%%---------------------QQSSSS--SSo----------------------------------------------------------------------SS--SSSSS------QQQoSS--SSS-----------------oo------------S----------------
---------||||||--------------------------------------------------------------------------------#-----------------#--------------------------------------------------------------#---------------
---------||||||------------------------------o-------------------------------------------------#--------------------------------------------------------------------------------S---------------
---------||||||---------------------------------------------------------------------#---------##------------------------------------------------------------------------------------------------
------%%%%%%%%%%------------SS-o-------Q----S@S-----------------------------------------------##---------------------------------------------o--------------------------------------------------
-------||||||||------------------------------------------------------------------------------###-----------------------tt--------------K----------------TT----------------#---------------------
-------||||||||------------------------------------------TT--TT------tt----------------TT---####-----------------------tt-------------------------B-----TT---TT-----tt---##---------------------
-------||||||||---g------------g--kk-kk-----k---g--------TT--TT------tt----------------TT--#####---k-kgg--#------------TT---k-----gy---k----k-----b-----TT---TT-----tt--###-------#----k----g-g-
XXXXXXXXXXXXXXXXXXXXXXXXXXXXXXXXXXXXXXXXXXXXXXXXXXXXXXXXXXXXXXXXXXXXXXXXXXXXXXXXXXXXXXXXXXXXXXXXXXXXXXXXXXXXXXXXXXXXXXXXXXXXXXXXXXXXXXXXXXXXXXXXXXXXXXXXXXXXXXXXXXXXXXXXXXXXXXXXXXXXXXXXXXXXXXXX
XXXXXXXXXXXXXXXXXXXXXXXXXXXXXXXXXXXXXXXXXXXXXXXXXXXXXXXXXXXXXXXXXXXXXXXXXXXXXXXXXXXXXXXXXXXXXXXXXXXXXXXXXXXXXXXXXXXXXXXXXXXXXXXXXXXXXXXXXXXXXXXXXXXXXXXXXXXXXXXXXXXXXXXXXXXXXXXXXXXXXXXXXXXXXXXX
