-------------------------------------------------------K-K--------------------------------------------------------------------------------------------------------------------------------------
------------------------------------------------------------------------------------------------------------------------------------------------------------------------------------------------
--------------------------------------------------------%---------------------------------------------------------------------------------------------------------------------------------------
--------------------------------------------------------|---------------------------------------------------------------------------------------------------------------------------------------
--------------------------------------------------------|---------------------------------------------------------------------------------------------------------------------------------------
------------------ooo-----------------------------------|------------------------------------ooo------------o--------------------------------------------o--------------------------------------
--------%%%%%%%%%%%%%%----------------------------------|----------SSSSS-----------------------------SQ--------------------------SSoS-------------------------------QQSSSSS--SSS----------------
---------||||||--||||-----------------------------------|----------------------------------------------------------------------------------------o----------------------------------------------
---------||||||--||||-----------------------------------|---------------------------------------------------------------------------------------------------------------------------------------
---------||||||--||||------------o----------------------|---------------------------------------------------------o-------------o---------------------------------------------------------------
------%%%%%%%%%%%||||----%%------SS------%%%---2--------|-------QSQo---SSSSSS@S-SSS-----%%%%%%%%-SS----S%SSS----------------------------------------------------Q-QQQQ----------------------##--
-------||||||||-|||||----||---------------|-------------|--------------------------------||||||---------|---------K------TT------------------------------B------------------------------TT--#---
-------||||||||-|||||----||------------TT-|-------------|--------------------------------||||||---------|----#----B------TT---------------#-------B------B----B-------------------B-----TT--#---
-------||||||||-|||||----||-------gg-g-TT-|-k-----------|----ooo------------------or-----||||||----k-k--|---#-k--ob----k-TT---yg---k----#-#-------bg---k-b----gg---kggg-----k-----g-----TT--#-g-
XXXXXXXXXXXXXXXX|||||--X-XXX%%--XXXXXXXXXXXXXXXX-%XXXXXXXXXX%%%%-XXXXXXXXXXXXXXXXX%XXXXXXXXXXXXX%%%XXXXXXXXXXXXXXXXXXXXXXXXXXXXXXXXXXXXXXXXXXXXXXXXXXXXXXXXXXXXXXXXXXXXXXXXXXXXXXXXXXXXXXXXXXXXX
XXXXXXXXXXXXXXXX|||||--X-XXX||--XXXXXXXXXXXXXXXX-|-XXXXXXXXX-||--XXXXXXXXXXXXXXXXXXXXXXXXXXXXXXXXXXXXXXXXXXXXXX-XXXXXXXXXXXXXXXXXXXXXXXXXXXXXXXXXXXXXXXXXXXXXXXXXXXXXXXXXXXXXXXXXXXXXXXXXXXXXXXX
