------------------------------------------------------------------------------------------------------------------------------------------------------------------------------------------------
------------------------------------------------------------------------------------------------------------------------------------------------------------------------------------------------
------------------------------------------------------------------------------------------------------------------------------------------------------------------------------------------------
----------------------------------------------------------------SSSSSSSSSSS-------------------------------------SSSSSSSS--------------------------------------------------------SS--------------
------------------------------------------------------------------------------------------------------------------------------------------------------------------------------------------------
------------------o-----------------------------------------------------------------------------------------------------------------------------------------------------------------------------
--------%%%%%%%%-%%--------------------------------------------o-----------------------o-------o-S-SS------------------------------------------------------------o------oo-----S----------------
---------||||||--||------------o---------------------------------------------------------------------------------------------------------------------------------------------------------------S
---------||||||--||-------------------------------------------S---------------------------------------------------------------S-----------------------------------------------------------------
---------||||||--|#-----------------------------------------------------------------------------------------------------------------------------------------------------------------------------
------%%%%%%%%%%-##-------------------------------------------------------------------------------Q---------------------------------------------------------------------------------------------
-------||||||||--#-----tt---------------------------------#----------------------------------#-----------------------------------------tt----------------TT-------------------------------------
-------||||||||--#-----tt----#-------B---------------#----#----------B--------TT-------------#-----------------------tt----------------tt----TT----------TT---------------#-----------tt--------
-------||||||||-##-----tt----#--k-kk-b---------g---k-g-g-##-k--------b--------TT-------g-----#-----kgggg-------##----tt---------g------tt----TT---gk-k-k-TT---g-----##--###-----------tt-----##g
XXXXXXXXXXXXXXXXXXX--XXXXXXXXXXXXXXXXXXXXXXXXXXXXXXXXXXXXXXXXXXXXXXXXXXXXXXXXXXXXXXXXXXXXXXXXXXXXXXXXXXXXXXXXXXXXXXXXXXXXXXXXXXXXXXXXXXXXXXXXXXXXXXXXXXXXXXXXXXXXXXXXXXXXXXXXXXXXXXXXXXXXXXXXXXX
XXXXXXXXXXXXXXXXXXX--XXXXXXXXXXXXXXXXXXXXXXXXXXXXXXXXXXXXXXXXXXXXXXXXXXXXXXXXXXXXXXXXXXXXXXXXXXXXXXXXXXXXXXXXXXXXXXXXXXXXXXXXXXXXXXXXXXXXXXXXXXXXXXXXXXXXXXXXXXXXXXXXXXXXXXXXXXXXXXXXXXXXXXXXXXX
