------------------------------------------------------------------------------------------------------------------------------------------------------------------------------------------------
------------------------------------------------------------------------------------------------------------------------------------------------------------------------------------------------
------------------------------------------------------------------------------------------------------------------------------------------------------------------------------------------------
----------------SSSSSSSS----------------------------------------SSSSSSSSSS--------------------------------------SSSSSSSSSS------SSSSSSSSSSS-------------------------------------SSSSSSSSSSSSSSS-
------------------------------------------------------------------------------------------------------------------------------------------------------------------------------------------------
-------------------------------------------------------------------------------------------------------------------------------------------------------------------------------o----------------
--------%%%%%%%%-------S-------------SSSSSS-SSSS-------------------------------------------------------------------------------S---------------------QQQQ-----------QQQSQS---SSS----------------
---------||||||-S----------------------------------------------------------------------------------------------------------------------------------------------o--------------------------------
---------||||||-S---T-----------------------------------------##--------------------------------------------------------------------------------------------------------------------------------
---------||||||-S---T-----------------------------------------##--------------------------------------------------------------------------------------------------------------------------------
------%%%%%%%%%%S--S#------------------------o---------------###------t----------------------#----------------------------------------t----------#-----t-----o------Q--SQ----U--------t---------
-------||||||||----------------------------------------t----####------tt---------------TT---###----------TT------------t--------------tt---------------t-----#-----------------------tt---------
-------||||||||----------#---#-------------------------t----####-----ttt---------------TT---#T#----------TT------------t--------------ttt----TT--------t-----#---------------#-------tt---------
-------||||||||-------#--#---##------k------k-----ggg--t---#####-----ttt------g-g-g---kkT---###---ggg----TT---yog------t----#---------ttt----TT--------t----k#----gggggg----k--------ttk------gg
XXXXXXXXXXXXXXXXXXXXXXXXXXXXXXXXXXXXXXXXXXXXXXXXXXXXXXXXXXXXXXXXXXXXXXXXXXXXXXXXXXXXXXXXXXXXXXXXXXXXXXXXXXXXXXXXXXXXXXXXXXXXXXXXXXXXXXXXXXXXXXXXXXXXXXXXXXXXXXXXXXXXXXXXXXXXXXXXXXXXXXXXXXXXXXXX
XXXXXXXXXXXXXXXXXXXXXXXXXXXXXXXXXXXXXXXXXXXXXXXXXXXXXXXXXXXXXXXXXXXXXXXXXXXXXXXXXXXXXXXXXXXXXXXXXXXXXXXXXXXXXXXXXXXXXXXXXXXXXXXXXXXXXXXXXXXXXXXXXXXXXXXXXXXXXXXXXXXXXXXXXXXXXXXXXXXXXXXXXXXXXXXX
