---------------------------------------------------------------------------------%---------------%----------------------------------------------------------------------------------------------
---------------------------------------------------------------------------------|---------------|----------------------------------------------------------------------------------------------
---------------------------------------------------------------------------------|---------------|----------------------------------------------------------------------------------------------
---------------------------------------------------------------------------------|---------------|----------------------------------------------------------------------------------------------
---------------------------------------------------------------------------------|---------------|----------------------------------------------------------------------------------------------
--------------------------------%%%---------------------------------------------%%--------------%%%------------------------------%-----------------------------------------------%--------------
--------%%%%%%%%------o----------|----r---------------r---------------r---------||----r--------o-|----r---------------r----------|----r---------------r---------------r----------|----r---------
---------||||||-%---------------%%%%%%%%%%------%%%%%%%%%%------%%%%%%%%%-------%%%%%%%%%-------%%%%%%%%%-------%%%%%%%%%%------%%%%%%%%%%------%%%%%%%%%-------%%%%%%%%%%------%%%%%%%%%-------
---------||||||-|---------U------||||||||--------||||||||--------|||||||---------|||||||---------|||||||---------||||||||--------||||||||--------|||||||---------||||||||--------|||||||--------
---------||||||-|----------------||||||||--------||||||||--------|||||||---------|||||||---------|||||||---------||||||||--------||||||||--------|||||||---------||||||||--------|||||||--------
------%%%%%%%%%%|-----------TT--QQS|||SSU--------|||||U||@QQ----SQ|||||SQQ-------|||||||--------QQS||||Q@-------S|||||SSS-------S|TT||SSo--------|TT||SSU-------S|TT||SSUS--TT---|TT|||S@-------
-------||||||||-|-----------TT-----|||--|---TT---||||||||---------|||||----------|TT||||-----------||||----------|||||------TT---|TT||--|---TT---|TT||------TT---|TT||--|---TT---|TT|||-----TT--
-------||||||||-|---TT------TT-----|||--|---TT---||||||||---------|||||----------|TT||||-----------||||----------|TT||------TT---|TT||--|---TT---|TT||------TT---|TT||--|---TT---|TT|||-----TT--
-------||||||||-|-k-TT--gg--TT---gggg|-ggg--TT-k-||gg|gg|----ggg--|g|||--gg---g--|TT||||-g---------g|||--gg------|TT||-ggg--TT-k-|TT||-ggg--TT---|TT||-ggg--TT-k-|TT||-ggg--TT-k-|TT|||ggg--TT-k
XXXXXXXXXXXXXXXXXXXXXXXXXXXXXXXXXXXXXXXXXXXXXXXXXXXXXXXXXXXXXXXXXXXXXXXXXXXXXXXXXXXXXXXXXXXXXXXXXXXXXXXXXXXXXXXXXXXXXXXXXXXXXXXXXXXXXXXXXXXXXXXXXXXXXXXXXXXXXXXXXXXXXXXXXXXXXXXXXXXXXXXXXXXXXXXX
XXXXXXXXXXXXXXXXXXXXXXXXXXXXXXXXXXXXXXXXXXXXXXXXXXXXXXXXXXXXXXXXXXXXXXXXXXXXXXXXXXXXXXXXXXXXXXXXXXXXXXXXXXXXXXXXXXXXXXXXXXXXXXXXXXXXXXXXXXXXXXXXXXXXXXXXXXXXXXXXXXXXXXXXXXXXXXXXXXXXXXXXXXXXXXXX
