------------------------------------------------------------------------------------------------------------------------------------------------------------------------------------------------
------------------------------------------------------------------------------------------------------------------------------------------------------------------------------------------------
------------------------------------------------------------------------------------------------------------------------------------------------------------------------------------------------
--------------------------------SSSSSSSSSSSS-------------------------------------S--------------S--SSS------------------------------------------SSSSSSSSSSS-------------------------------------
------------------------------------------------------------------------------------------------------------------------------------------------------------------------------------------------
------------------------------------------------------------------------------------------------------------------------------------------------------------------------------------------------
--------%%%%%%%%-----QSSSSSS----ooo----Soo---SSS------SSSo-----o---------------------------------o-----ooo-------ooSS--------S@S-----------------o---------------oooo-ooo-----SS----Q-----------
---------||||||------------------------------------------------------------------------------------------------------------------#--------------------------------------------------------------
---------||||||---------------------------------------------------------------------------------------------------------------------------------------------------------------------------------
---------||||||-----------------o---------S-----o----------------------------------------------------------------------------------------------------------------o------------------------------
------%%%%%%%%%%-------------U--S-----------------------------------------------------------------------------------Q---------------------------------------------------------------------%SS@So
-------||||||||----------------------------------------------------------TT-----------tt------------tt-------------------##--------------TT-------------------------------#---------------K-----
-------||||||||-------tt-----------------#-------------------------------TT-----------tt------------tt------------------###--------------TT----------tt------------------###--------------|-----
-------||||||||----k--tt-------g-----k---#-----------------k------g------TT---k--k----tt------------tt-------------gggg####-#-----ky-----TT---k------tt-------yg----oyg-####k-----gggggg--k---ko
XXXXXXXXXXXXXXXXXXXXXXXXXXXXXXXXXXXXXXXXXXXXXXXXXXXXXXXXXXXXXXXXXXXXXXXXXXXXXXXXXXXXXXXXXXXXXXXX-XXXXXXXXXXXXXXXXXXXXXXXXXXXXXXXXXXXXXXXXXXXXXXXXXXXXXXXXXXXXXXXXXXXXXXXXXXXXXXXXXXXXXXXXXXXXXXX
XXXXXXXXXXXXXXXXXXXXXXXXXXXXXXXXXXXXXXXXXXXXXXXXXXXXXXXXXXXXXXXXXXXXXXXXXXXXXXXXXXXXXXXXXXXXXXXXXXXXXXXXXXXXXXXXXXXXXXXXXXXXXXXXXXXXXXXXXXXXXXXXXXXXXXXXXXXXXXXXXXXXXXXXXXXXXXXXXXXXXXXXXXXXXXXX
