--------------------------S---------------------------------------------------------------S-----------------------------------------------------------------------------------------------------
-------------------------SS---------------------------------------------------------------------------------------------------------------------------------------------------------------------
------------------------------------------------------------------------------------------------------------------------------------------------------------------------------------------------
--------------------------------------------------------------------------------SSSSSSS-------------------------SSSSSSSSSSSSSS------------------SSS-----------------------------SSSSSSSSSSSSSSSS
--------------------------------------------------------------------------------------------------------------------------------------------------------------------------------S---------------
-----------------------------g------------------------------------------------------------oo----------------------------------------------------------------------------------------------------
--------%%%%%%%%-------------S--------------------------o------o----------------------------------------SSS--SSS-----------------oooQQQo-------------------------oo------------------------S---S
---------||||||-------------SS------------------------------------------------------------------------------------------------------------------------------------------------------------------
---------||||||--------U-----S------------------------------------------------------------------------------------------------------------------------------------------------------------------
---------||||||---------------------------------------------------------------------------------------------------------------------------------------------------------------------------------
------%%%%%%%%%%---o-----------S-----------------------------------------TT----------------------------------o----------------------------------------------------------------------------------
-------||||||||----------------S-------------------------TT--------------TT-----------------------------------------------#----------------------------------------------TT---------------------
-------||||||||----------------------S--------#----------TT--------------TT---TT------tt----------------------------------#---K------------------------tt-----o----------TT-----------tttt----TT
-------||||||||-------S-----------------------g----k-k---TT--------k-k---TT---TT------tt-----k----ggg-------------y-----###---#-----gg------------g----tt----ggg---------TT-----------tttt----TT
XXXXXXXXXXXXXXXX-XXXXXXXSSS-----XXXXXXXXXXXXXXXXXXXXXXXXXXXXXXXXXXXXXXXXXXXXXXXXXXXXXXXXXXXXXXXXXXXXXXXXXXXXXXXXXXXXXXXXXXXXXXXXXXXXXXXXXXXXXXXXXXXXXXXXXXXXXXXXXXXXXXXXXXXXXXXXXXXXXXXXXXXXXXXX
XXXXXXXXXXXXXXXX-XXXXXXg--------XXXXXXXXXXXXXXXXXXXXXXXXXXXXXXXXXXXXXXXXXXXXXXXXXXXXXXXXXXXXXXXXXXXXXXXXXXXXXXXXXXXXXXXXXXXXXXXXXXXXXXXXXXXXXXXXXXXXXXXXXXXXXXXXXXXXXXXXXXXXXXXXXXXXXXXXXXXXXXXX
