------------------------------------------------------------------------------------------------------------------------------------------------------------------------------------------------
------------------------------------------------------------------------------------------------------------------------------------------------------------------------------------------------
------------------------------------------------------------------------------------------------------------------------------------------------------------------------------------------------
--------------------------------SSS-------------SSSSSSSSSSSSSSS----------------------SSSSSS-----SSSSSSSSSS---SSS-SSSSSSSSS----------------------SSSSSSSSS-------SSSSSSSSSSSS--------------------
------------------------------------------------------------------------------------------------------------------------------------------------------------------------------------------------
------------------------------------------------------------------------------------------------------------------------------------------------------------------------------------------------
--------%%%%%%%%---------------------------------oo----SS----o-------------------SoS--SS-----SSS----------------oooo--Soo----SSSS-oS@SSSSSS--SSS----------------ooo-----oo----SS-ooo-----------o
---------||||||---------------------------------------------------------------------------------------------------------------------------------------------------------------------------------
---------||||||----------------------------------------------SS-------------------------------------------------------------------------------o-#-----------------------------------------------
---------||||||---------------------------------------------------o-------------o-------------------------------oo------------------------------------------------------------------------------
------%%%%%%%%%%-------------U-o-----------------------------------------TT-----S-------------------------------S------------SS-----Q-------S@SS--------------------------------#--SSS----#-----
-------||||||||-------------------------------------tt-------------------TT-----------------------------------------------------------------------------------TT-----tt------------------##-----
-------||||||||--------------------------##---------tt---##--------------TT-----------------------------------------------------------------------------------TT-----tt------------------##-----
-------||||||||----gg----------------k-k-##---------tt---###---------gg--TT---ko----gg---------------k---#----#---------g-#--------kgggg----------k----k-k----TT-----tt---------------gg###-#---
XXXXXXXXXXXXXXXXXXXXXXXXXXXXXXXXXXXXXXXXXXXXXXXXXXXXXXXXXXXXXXXXXXXXXXXXXXXXXXXXXXXXXXXXXXXXXXXXXXXXXXXXXXXXXXXXXXXXXXXXXXXXXXXXXXXXXXXXXXXXXXXXXXXXXXXXXXXXXXXXXXXXXXXXXXXXXXXXXXXXXXXXXXXXXXXX
XXXXXXXXXXXXXXXXXXXXXXXXXXXXXXXXXXXXXXXXXXXXXXXXXXXXXXXXXXXXXXXXXXXXXXXXXXXXXXXXXXXXXXXXXXXXXXXXXXXXXXXXXXXXXXXXXXXXXXXXXXXXXXXXXXXXXXXXXXXXXXXXXXXXXXXXXXXXXXXXXXXXXXXXXXXXXXXXXXXXXXXXXXXXXXXX
