----------------------------------------------------2----------------------------%---------------%-------------------------------%----------------------------------------------
---------------------------------------------------------------------------------|---------------|-------------------------------|----------------------------------------------
---------------------------------------------------------------------------------|---------------|-------------------------------|----------------------------------------------
-------------------------------------------------##------------------------------|---------------|-------------------------------|----------------------------------------------
-------------------------------------------------##k-----------------------------|---------------|-------------------------------|----------------------------------------------
---------------------------------------------------------------------------------|---------------|-------------------------------|----------------------------------------------
------r------o--------U---------------U-------------------------------r----------|----r----------|----r---------------r----------|----r---------------r---------------r---------
------%%S---------------------------o-%---------%-%%%%%%--------%%%%%%%%%-------%%%%%%%%%--------|%%%%%%%%------%%%%%%%%%%------%%%%%%%%%%------%%%%%%%%%%------%%%%%%%%%%------
------||------------------------------|---------|--||||---U------|||||||---------|||||||---------|-||||||--------||||||||--------||||||||--------||||||||--------||||||||-------
------||-------o----------------------|---------|--||||----------|||||||---------|||||||---------|-||||||--------||||||||--------||||||||--------||||||||--------||||||||-------
------||-------%-------SSS------------|---------|--||||-----TT---|TT||SS--------QQ||||QQ@--------|-||||||-------S|||||SS@S-------|||||SSUS-------|T|||SSU-------S|||||SSU-------
------||-------|----------------T-----|--TT-----|--||||-----TT---|TT||------TT----||||-----------|-||||||--------|TT||------TT---|||||--|---TT---|TT||--|---TT---|TT||--|---TT--
------||--T----|------------TT--T-----|--TT-----|--||||-----TT---|TT||------TT----||||-----------|TT|||||TT------|TT||------TT---|TT||--|---TT---|TT||--|---TT---|TT||--|---TT--
------|k-T-----|ggg-----ggg-TT--T----y|g-TT----g|--||||---k-TT---|TT||-gg---TT-k--|g||---g-------|TT|||g|TT------|TT||-ggg--TT-k-|TT||-ggg--TT-k-|TT||-ggg--TT-k-|TT||-ggg--TT-k
XXXXXXXXXXX----|XXXXXXXXXXXXXXXXXXXXXXXXXXX---XXXXXXXXXXXXXXXXXXXXXXXXXXXXXXXXXXXXXXXXXXXXXXXXXXXXXXXXXXXXXXXXXXXXXXXXXXXXXXXXXXXXXXXXXXXXXXXXXXXXXXXXXXXXXXXXXXXXXXXXXXXXXXXXXX
XXXXXXXXXXX----|XXXXXXXXXXXXXXXXXXXXXXXXXXXX--XXXXXXXXXXXXXXXXXXXXXXXXXXXXXXXXXXXXXXXXXXXXXXXXXXXXXXXXXXXXXXXXXXXXXXXXXXXXXXXXXXXXXXXXXXXXXXXXXXXXXXXXXXXXXXXXXXXXXXXXXXXXXXXXXX
