------------------------------------------------------------------------------------------------------------------------------------------------------------------------------------------------
------------------------------------------------------------------------------------------------------S-----------------------------------------------------------------------------------------
------------------------------------------------------------------------------------------------------------------------------------------------------------------------------------------------
----------------------------------------------------------------SSSSSSSSS----SSS------------------------------------------------SSSSSSSSSSSSSSSS--------------------------------SSSSSSSSSSSSSSSS
--------------------------------------------------------------------------------------------------------------------------------------------------------------------------------SS--------------
------------------------------------------------------------------------------------------------------------------------------------------------------------------------------------------------
--------%%%%%%%%----------------------------------------------------------------------S---------ooo---SSSS---So--oo-----------------------------SSSS@SSSSS---SSS--oo--SS------So----------------
---------||||||------------------o---------------o-------------o---------------------------------------o---ooo----------------------------------------------------------------------------------
---------||||||---------------------------------------------------------------------------------S----------------------------------------------------------------------------oo-----------------
---------||||||------------------k--------------------------------------------------------------S----------------o------------------------------------------------------------------------------
------%%%%%%%%%%--------------------------#-#-#-------------------------------------------------S-----------------------------------------------Q-Q-S--SS----SSS-------------US-----------------
-------||||||||--------------------------##-#-------------------------------------------#--------------------------------TT---------------------------------------------------------------------
-------||||||||-------------------------#####--#--TT--------------------------TT-------##--------------------------------TT-------------TT---TT-----------------------------------------------TT
-------||||||||---------------gg--yg-#--#####-##--TT---------------------g----TT-------##------------y-------------kgggg###-----k-------TT---TT----ggg---------------kk-----k-k---g--k--------TT
XXXXXXXXXXXXXXXXXXXXXXXXXXXXXXXXXXXXXXXXXXXXX-XXXXXXXXXXXXXXXXXXXXXXXXXXXXXXX-XXXXXXXXXXXXXXXXXX-XXXXXXXXX--XXXXXXXXXXXXXXXXXXXXXXXXXXXXXXXXXXXXXXXXXXXXXXXXXXXXXXXXXXXXXXXXXXXXXXXXXXXXXXXXXXXX
XXXXXXXXXXXXXXXXXXXXXXXXXXXXXXXXXXXXXXXXXXXXX-XXXXXXXXXXXXXXXXXXXXXXXXXXXXXXX-XXXXXXXXXXXXXXXXXXXXXXXXXXXX--XXXXXXXXXXXXXXXXXXXXXXXXXXXXXXXXXXXXXXXXXXXXXXXXXXXXXXXXXXXXXXXXXXXXXXXXXXXXXXXXXXXX
