------------------------------------------------------------------------------------------------------------------------------------------------------------------------------------------------
------------------------------------------------------------------------------------------------------------------------------------------------------------------------------------------------
------------------------------------------------------------------------------------------------------------------------------------------------------------------------------------------------
------------------------------------------------SSSSSSSSSSSSSSSS----------------SSSSSSSSSSS-----SSSSSSSSSSSSSSSS-SSSSSSSSSSSSS------------------SSSSSSSSS------SSSSSSSSSSSSSSSSS----------------
------------------------------------------------S--------------------------------------------------------------------------------------------------------------------S--------------------------
------------------------------------------------------------------------------------------------------------------------------------------------------------------------------------------------
--------%%%%%%%%---------------------------------oo--------------ooo--SS------SS--------------------------------oooo----------ooSSSQS---------oS----------------oooo-----o---SSSSSoo----------oo
---------||||||---------------------------------------------------------------------------------------------------------------------------------------------------------------------------------
---------||||||----------------------------------------------------------------------------------------------------------------S-------------oo-S------------------------------S----------------
---------||||||-------------------------------------------------o-----------------------------------------------o-----------------------------------------------oo------------------------------
------%%%%%%%%%%-------------o----------------------------------------------------------------------------------S--------###----#-----------S@SS----------------S---------------#---------------
-------||||||||-----------------------------------------------------------#---#----------------------S-------------------##---------------------------------------------------------------------
-------||||||||----------------------tt-------------tt---###-------------####-#---------------TT-----S---o----TT-------#####--------------------------tttt----TT----SS---#----------------------
-------||||||||--ggg-------ggg-------tt-------g-----tt---###--------ggg-###-#-##--k--k--------TT---------##---TT------######-------kgggg--k-----k-----tttt----TT----tt--####--------gggg#-------
XXXXXXXXXXXXXXXXXXXXXXXXXXXXXXXXXXXXXXXXXXXXXXXXXXXXXXXXXXXXXXXXXXXXXXXXXXXXXXXXXXXXXXXXXXXXXXXXXXXXXXXXXXXXXXXXXXXXXXXXXXXXXXXXXXXXXXXXXXXXXXXXXXXXXXXXXXXXXXXXXXXXXXXXXXXXXXXXXXXXXXXXXXXXXXXX
XXXXXXXXXXXXXXXXXXXXXXXXXXXXXXXXXXXXXXXXXXXXXXXXXXXXXXXXXXXXX-oXXXXXXXXXXXXXXXXXXXXXXXXXXXXXXXXXXXXXXXXXXXXXXXXXXXXXXXXXXXXXXXXXXXXXXXXXXXXXXXXXXXXXXXXXXXXXXXXXXXXXXXXXXXXXXXXXXXXXXXXXXXXXXXXX
