------------------------------------------------------------------------------------------------------------------------------------------------------------------------------------------------
------------------------------------------------------------------------------------------------------------------------------------------------------------------------------------------------
------------------------------------------------------------------------------------------------------------------------------------------------------------------------------------------------
------------------------------------------------------------------------------------------------------------------------------------------------SSSS--------------------------------------------
---------------------------------------------------------------o---------------------------------------------------------------#----------------------------------------------------------------
-------------------------------------------------------------------------------------------------------------------------oo------------------------------------------------------------------ooo
--------%%%%%%%%------------------------------------------------------------------------oo------------------------------------------Q----------U---------------------QSSSS---SS-----------------
---------||||||------------o-------------------------------------#-----------------------------------------------#------------------------------------------------------------------------------
---------||||||---------------------------------------------------------------------------------------------------------------------------------------------------------------------------------
---------||||||----------SSS-----------------------------------------------------------------------------------------------------------------------------o--------------------------------------
------%%%%%%%%%%---------#----------------------------tt------------------------------------#----------------o-------------------------------U------------------------QQQ----o------------------
-------||||||||---------##----------------------------tt-----------------TT----------------##--------------------------tt--------------------------------B--------------------------------------
-------||||||||-------####----------------b-----------tt----------B------TT---------------###---------tt---------------tt----TT----------------------B---B----B------------------------TT-------
-------||||||||-------###--------------b--b-----------tt-----g-g--g------TT-----g-ggg-----###---------tt--------g------tt----TT----kgggg--b----------b---b----gg------------------gggg-TT---k---
XXXXXXXXXXXXXXXX-XXXXXLS@X---XXXXXXXXXXXXXXXXXXXXXXXXXXXXXXXXXXXXXXXXXXXXXXXXXXXXXXXXXXXXXXXXXXXXXXXXXXXXXXXXXXXXXXXXXXXXXXXXXXXXXXXXXXXXXXXXXXXXXXXXXXXXXXXXXXXXXXXXXXXXXXXXXXXXXXXXXXXXXXXXXXX
XXXXXXXXXXXXXXXXXXXXXXXXXX---XXXXXXXXXXXXXXXXXXXXXXXXXXXXXXXXXXXXXXXXXXXXXXXXXXXXXXXXXXXXXXXXXXXXXXXXXXXXXXXXXXXXXXXXXXXXXXXXXXXXXXXXXXXXXXXXXXXXXXXXXXXXXXXXXXXXXXXXXXXXXXXXXXXXXXXXXXXXXXXXXXX
