------------------------------------------------------------------------------------------------------------------------------------------------------------------------------------------------
------------------------------------------------------------------------------------------------------------------------------------------------------------------------------------------------
------------------------------------------------------------------------------------------------------------------------------------------------------------------------------------------------
----------------------------------------------------------------SSSSSSS---------------------------------------------------------SSSSSSSS------------------------SSSSSSSSSSSSSSSS----------------
--------------------------------------------------------------------------------------------------------------------------------------------------------------o---------------------------------
------------------------------------------------------------------------------------------------------------------------------------------------------------------------------------------------
--------%%%%%%%%-------Q------------------------------QQQ------o-------------------------------------------------ooo-----------o--------------------QSQSSSS--S@S-----------------oo-------------
---------||||||---------------------------------------------------------------------------------------------------------------------------------------------------------------------------------
---------||||||-----------------------------------------------------------------------------------------------------------------S---------------------------------------------------------------
---------||||||--------g#--------------------------------------------------##-------------------------------------------------------------------------------------------------------------------
------%%%%%%%%%%-##----##-------------------------Q-----------------------#####------------------------tt--------------------#------------------------SQQS--SUS--------------------------TT-----
-------||||||||--##----##-------------------------------------------------####------------#------------tt-----------------#---------------------------------------------TT---------------TT-----
-------||||||||--###---#--------------tt--------------------------------TT####-----------##------------tt----------------##-----------tt--------------------------B-----TT---TT----------TT-----
-------||||||||-####---#----k-----k---tt-----ggg--gy------y-k-----g--#--TT#####-----ggg--##-----g------tt----g-----k-k--###-----k-----tt-----gg------kk---------k-b-----TT---TT------k--###-----
XXXXXXXXXXXXXXXXXXXXXXXXXXXXXXXXXXXXXXXXXXXXXXXXXXXXXXXXXXXXXXXXXXXXXXXXXXXXXXX-XXXXXXXXXXXXXXXXXXXXXXXXXXXXXXXXXXXXXXXXXXXXXXXXXXXXXXXXXXXXXXXXXXXXXXXXXXXXXXXXXXXXXXXXXXXXXXXXXXXXXXXXXXXXXXXX
XXXXXXXXXXXXXXXXXXXXXXXXXXXXXXXXXXXXXXXXXXXXXXXXXXXXXXXXXXXXXXXXXXXXXXXXXXXXXXXXXXXXXXXXXXXXXXXXXXXXXXXXXXXXXXXXXXXXXXXXXXXXXXXXXXXXXXXXXXXXXXXXXXXXXXXXXXXXXXXXXXXXXXXXXXXXXXXXXXXXXXXXXXXXXXXX
