------------------------------------------------------------------------------------------------------------------------------------------------------------------------------------------------
------------------------------------------------------------------------------------------------------------------------------------------------------------------------------------------------
------------------------------------------------------------------------------------------------------------------------------------------------------------------------------------------------
--------------------------------SSSSSSS---------------------------------------------------------SS------------------------------SSSSSSSSSS------------------------------------------------------
--------------------------------------------------------------------------------------------------------------------------------------------------------------oo--------------------------------
----------------------------------------------------------------------------------------------------------oo-------------------------------o-----------------------------------o----------------
--------%%%%%%%%---------------------------------------------------------------------------------------------------------------o------------------------------------------------------SSo------S
---------||||||--------o------------------------------------------------------yo-----------------------------------------------------------------------------------------------o----------------
---------||||||------------------SSS----------------------------------------------------------------o-------------------------------------------------------------------------------------------
---------||||||----------------------T---------------------------------------##---------------------##------------------------------------------------------------------------------------------
------%%%%%%%%%%---------S%------------------------------------------------####------##--------------2-------------------##--#--------tt-----o-----------TT----------------------------------o--
-------||||||||-----------|------------------------------------o----------#####-----------------T--------B---------------##-##--------tt-----------------TT------------TT-----------------------
-------||||||||-----------|--------------TT---TT------------------------#######-----------------TT-----TTT----T---------#######------ttt-----------------TT------------TT----#T-----------------
-------||||||||-----------|--------------TT---TT--kg--------------g----#######-----------------#TTt----kTT----#T-----g-####--##-g----ttt----gkg----k-k--###-----g-g----TT---g#gg-----k----#-----
XXXXXXXXXXXXXXXX%%%%XXXXXXXX-%%%XXXXXXXXXXXXXXXXXXXXXXXXXXXXXX--XXXXXXXXXXXXXXXXXXXXXXXXXXXXXXXXXXXXXXXXXXXXXXXXXXXXXXXXXXX-XXXXXXXXXXXXXXXXXXXXXXXXXXXXXXXXXXXXXXXXXXXXXXXXXXXXXXXXXXXXXXXXXXXX
XXXXXXXXXXXXXXXXXXXXXXXXXXXX--|XXXXXXXXXXXXXXXXXXXXXXXXXXXXXXX--XXXXXXXXXXXXX-XXXXXXXXXXXXXXXXXXXXXXXXXXXXXXXXXXXXXXXXXXXXX-XXXXXXXXXXXXXXXXXXXXXXXXXXXXXXXXXXXXXXXXXXXXXXXXXXXXXXXXXXXXXXXXXXXX
