------------------------------------------------------------------------------------------------------------------------------------------------------------------------------------------------
------------------------------------------------------------------------------------------------------------------------------------------------------------------------------------------------
------------------------------------------------------------------------------------------------------------------------------------------------------------------------------------------------
------------------------------------------------SSSSSSSSSSSSSSSS------------------------------------------S-----SSSSSSSSSSSSSSSS----------------SSSSSSS---------SSSSSSSSSSSSSS--SSSSSSSS-----SSS
------------------------------------------------S---------------------------------------------------------------S-------------------------------------------------------------------------------
---------------------------------------------------------------S--------------------------------------------------------------------------------------------------------------------------------
--------%%%%%%%%--------SS---------------o-----------------S--SS-----------------------S-------o--o----------------------------S-----SQSQS-----------------------oo-----oo----------------------
---------||||||----------------------------------------------------------------------------------------------------------------------------------o----------------------------------------------
---------||||||-------------------------------------------------------------------------------------------------S-------------------------------------------------------------------------------
---------||||||--------------------------------------------##-------------------o------------##------------##----------------------------------------------####---------------------------------
------%%%%%%%%%%-------------S----------------------------###----------S-----o--------------####---------TT##--------------------------------o------------#####---------------------------------
-------||||||||------------------------------------------####----------S-------------------####----------TT##--------------------------------------------######---------------------------------
-------||||||||---------------------tt-------------------###-----------S---------------###-####----------TT----------tt-------TT------------------------#######-----------#-------B-----tt----TT
-------||||||||----------------k--k-tt----#----------y-g####k-----gg--------gggg-----####-#####------k--###---#-k----tt-------TT--gggg-------g-g-------########------g---##-----k-b-----tt----TT
XXXXXXXXXXXXXXXXXXXX-XXXXXXXXXXXXXXXXXXXXXXXXXXXXXXXXXXXXXXXXXXXXXXXXXXXXXXXXXXXXXXXXXXXXXXXXXXXXXXXXXXXXXXXXXXXXXXXXXXXXXXXXXXXXXXXXXXXXXXXXXXXXXXXXXXXXXXXXXX-XXXXXXXXXXXXXXXXXXXXXXXXXXXXXXXX
XXXXXXXXXXXXXXXXXXXX--XXXXXXXXXXXXXXXXXXXXXXXXXXXXXXXXXXXXXXXXXXXXXXXXXXXXXXXXXXXXXXXXXXXXXXXXXXXXXXXXXXXXXXXXXXXXXXXXXXXXXXXXXXXXXXXXXXXXXXXXXXXXXXXXXXXXXXXXX-XXXXXXXXXXXXXXXXXXXXXXXXXXXXXXXX
