------------------------------------------------------------------------------------------------------------------------------------------------------------------------------------------------
------------------------------------------------------------------------------------------------------------------------------------------------------------------------------------------------
------------------------------------------------------------------------------------------------------------------------------------------------------------------------------------------------
--------------------------------SSSSSS----SS-SSS--------------------------------SSSSSSSSS---------------------------------------SSSSSSSSS-------------------------------------------------------
------------------------------------------------------------------------------------------------------------------------------------------------------------------------------------------------
-----------------------------------------------------------------------------------------------------------------------------------------------------------------------------------------------o
--------%%%%%%%%-------------oo------------SS----------------------------------S-oo------o-------------QoS-----S-------------------------------S--------------------------------------SSS-------
---------||||||----------------------------------------------------------------------------------------------------------------#----------------------------------------------------------------
---------||||||-------T--------S-----------------------------------------------------------------------------------------------#----------------------------------------------------------------
---------||||||-------T-----oooo----------------------------------------------------------------------------------------------##----------------------------------------------------------------
------%%%%%%%%%%----SS@--------------------------TT---------------------------------tt----##-----------------o----------------##------------#------------------------------------------------o--
-------||||||||-----------------t------t---------TT---------------------------------tt---###-----------------#---------t-----###-----------##-------------#-------------------------------------
-------||||||||-----------U-----t------tt------#-T----------------------------------tt---###----------------##---------t----####-----ttt--###--------t---TT------------TT----TT-------------#---
-------||||||||-----------U-----Tt----ttt----g##TTT--k----------------t--#---#g-----tt--####---#--gy---k----#---g-gg---t----####-----ttt--###-#------t---TT-----g-g----TT---#TT----y--------#---
XXXXXXXXXXXXXXXXXXXXXXXXXXXXXXXXXXXXXXXX%XXXXXXXXXXXXXXXXXXXXXXXXXXXXXXXXXXXXXXXXXXXXXXXXXXXXXXXXXXXXXXXXXXXXXXXXXXXXXXXXXXXXXXXXXXXXXXXXXXXXXXXXXXXXXXXXXXXXXXXXXXXXXXXXXXXXXXXXXXXXXXXXXXXXXXX
XXXXXXXXXXXXXXXXXXXXXXXXXXXXXXXXXXXXXXXXXXXXXXXXXXXXXXXXXXXXXXXXXXXXXXXXXXXXXXXXXXXXXXXXXXXXXXXXXXXXXXXXXXXXXXXXXXXXXXXXXXXXXXXXXXXXXXXXXXXXXXXXXXXXXXXXXXXXXXXXXXXXXXXXXXXXXXXXXXXXXXXXXXXXXXXX
