------------------------------------------------------------------------------------------------------------------------------------------------------------------------------------------------
------------------------------------------------------------------------------------------------------------------------------------------------------------------------------------------------
------------------------------------------------------------------------------------------------------------------------------------------------------------------------------------------------
--------------------------------SSSS------------SSSSSSSSSSSSS-----------------------------------SSSSSSSSSSSSSSSS--------------------------------SSSS------------SSSSSSSSSS----------------------
-------------------------o----------------------------------------------------------------------SS----------------------------------------------------------------------------------------------
------------------------------------------------------------------------------------------------------------------------------------------------------------------------------------------------
--------%%%%%%%%---2QSSS@S---SSS------------------o-----oo-----o----------------------------------------SS------oooo-SSSSS---SSS---------------------------------oo----ooo------oooo---------2--
---------||||||---------------------------------------------------------------------------------------------------------------------------------------------------------------------------------
---------||||||---------------------------------------------------------------------------------------------------------------------------------S-----------------------------------------------
---------||||||---------------------------------o---------------------------------------------------------------o---------------------------------------------------------------g---------------
------%%%%%%%%%%SSQQ---SSSSSSSS---------------------------------------------------------------------------------S------------------------------o------------------------------------Q-----------
-------||||||||------------------------------------------------------------------------------------------------------------------------------------------TT-------------------------------------
-------||||||||-------------------------------TT---------##----------------------------------------------#----------------#--------------TT--------------TT---TT--------------------------------
-------||||||||----g-------------------k-k----TT--------###-------ggg-------------gy-----------------k---#----gg----ggg-###-k-----gg-----TT-------k------TT---TT----k-------k-------ggg---k-----
XXXXXXXXXXXXXXXX-XXXXXXXXX--XXXXXXXXXXXXXXXXXXXXXXXXXXXXXXXXXXXXXXXXXXXXXXXXXXXXXXXXXXXXXXXXXXXXXXXXXXXXXXXXXXXXXXXXXXXXXXXXXXXXXXXXXXXXXXXXXXXXXXXXXXXXXXXXXXXXXXXXXXXXXXXXXXXXXXXXXXXXXXXXXXXX
XXXXXXXXXXXXXXXX-XXXXXXXXX---XXXXXXXXXXXXXXXXXXXXXXXXXXXXXXXXXXXXXXXXXXXXXXXXXXXXXXXXXXXXXXXXXXXXXXXXXXXXXXXXXXXXXXXXXXXXXXXXXXXXXXXXXXXXXXXXXXXXXXXXXXXXXXXXXXXXXXXXXXXXXXXXXXXXXXXXXXXXXXXXXXX
