------------------------------------------------------------------------------------------------------------------------------------------------------------------------------------------------
------------------------------------------------------------------------------------------------------------------------------------------------------------------------------------------------
---------------------------2--------------------------------------------------------------------------------------------------------------------------------------------------------------------
-------------------------------------#---------------------------------------------------------------------------------------------------------------#------------------------------------------
-----------------------------------g----------------------------------------------#k#-------------------------------------------------------------gg#-------------------------------------------
----------------------------------##------------------------------##--------------##------------------------------##------------------------------##--------------------------------------------
--------%%%%%%%%--------------------------------------S-----------------------------------------SS------------------------------------------SSS----------------o----------------SSS-------------
---------||||||--------------------------o--------------------------------o-------------ooo------------------------------SS------------------S---------------------------oo-------ooooo---------
---------||||||---------------------------------------------------------------------------------------------------------SS----------------------------------------------------------------------
---------||||||-------------U------------SS----------------------------------------------S------------------------------SSSS--------------------------------------------------------------------
------%%%%%%%%%%-----------SQQ---------------------------TT----------------------------------------------TT-----------------------------------TT--------------------------------TT-------TT-----
-------||||||||---------------------tt-TT----------------TT----T-----t-TT--tt----------------------------TT---------tt-TT----------------TT---TT----tt------------------------TTTT----tt-TT----T
-------||||||||------U--------------tt-TT--tt------------TT----T----tt-TT--tt-------tt-TT-------T--------TT----T----tt-TT----------------TT---TT----tt-TT--tt-----------------TTTT----tt-TT----T
-------||||||||--------------gggg---tt-TT--tt------ggg---TT----T----tt-TT--tt-------tt-TT-k--k--T----y---TT----T----tt-TT-----#----------TT---TTg---tt-TT--tt-----------------TTTTT---ttkTT----T
XXXXXXXXXXXXXXXXXXXXXXXXXXXXXXXXXXXXXXXXXXXXXXXXXXXXXXXXXXXXXXXXXXXXXXXXXXXXXXXXXXXXXXXXXXXXXXXXXXXXXXXXXXXXXXXXXXXXXXXXXXXXXXXXXXXXXXXXXXXXXXXXXXXXXXXXXXXXXXXXXXXXXXXXXXXXXXXXTXXXXXXXXXXXX-XX
XXXXXXXXXXXXXXXXXXXXXXXXXXXXXXXXXXXXXXXXXXXXXXXXXXXXXXXXXXXXXXXXXXXXXXXXXXXXXXXXXXXXXXXXXXXXXXXXXXXXXXXXXXXXXXXXXXXXXXXXXXXXXXXXXXXXXXXXXXXXXXXXXXXXXXXXXXXXXXXXXXXXXXXXXXXXXXXXTXXXXXXXXXXXXXXX
