------------------------------------------------------------------------------------------------------------------------------------------------------------------------------------------------
------------------------------------------------------------------------------------------------------------------------------------------------------------------------------------------------
------------------------------------------------------------------------------------------------------------------------------------------------------------------------------------------------
----------------SSSSSSSSSSSSSSSS--------------------------------------------------------------------------------------------------------------------------------SSSSSSS-------------------------
----------------SS------------------------------------------------------------------------------------------------------------------------------------------------------------------------------
------------------------------------------------------------------------------------------------------------------------------------------------------------------------------------------------
--------%%%%%%%%-So---------------------------------QQQ------------------------------------------SSSSS-----------%%----------------QQQQQQo-----S-----------------------------------U-----------o
---------||||||--------------------------------------------------------------------------------------------------||----------------------------o------------------------------------------------
---------||||||------------#-SSS---------------------------------------------------------------------------------||--------------------------------------------------------------------------oo-
---------||||||-o---------##-------------------------------------------------------------------------------------||-----------------------------------------------------------------------------
------%%%%%%%%%%S--------###---------2----------###------------------------------------------@S--------------SS--||--------------#---QQQQQ---o----------------------------------------------S@S-
-------||||||||-------y-####-------------------------------------------------------------------------------------||----------------------------------------------------------TT-----------------
-------||||||||------#######------------TT------------------------------B----------------------------------------||-----------@---------------------------#-----------tt-----TT-----------------
-------||||||||-----########------------TT-----#---kgggg----kkk-k-y-----b----ggg--ggg----------------------------|k----------g#g--o---------k-----ggok--------g-------tt-----TT----k------------
XXXXXXXXXXXXXXXXXXXXXXXXXXXXXXXXXXXXXXXXXXXXXXXXXXXXXXXXXXXXXXXXXXXXXXXXXXXXXXXXXXXXXXXXXXXXXXXXXXXXXXXXXXXXXXXXXXXXXXXXXXXXXXXXXXXXXXXXXXXXXXXXXXXXXXXXXXXXXXXXXXXXXXXXXXXXXXXXXXXXXXXXXXXXXXXX
XXXXXXXXXXXXXXXXXXXXXXXXXXXXXXXXXXXXXXXXXXXXX-XXXXXXXXXXXXXXXXXXXXXXXXXXXXXXXXXXXXXXXXXXXXXXXXXXXXXXXXXXXXXXXXXXXXXXXXXXXXXXXXXXXXXXXXXXXXXXXXXXXXXXXXXXXXXXXXXXXXXXXXXXXXXXXXXXXXXXXXXXXXXXXXXX
