-----------------------------------------------------------------------------------------------------------------------------------------%%-----------------------------------------------------
-----------------------------------------------------------------------------------------------------------------------------------------||-----------------------------------------------------
------------------------------------------------------------------------------------------------t----------------------------------------||-----------------------------------------------------
----------------------S-------------------------------------------------------------------------t----------------------------------------||-----------------------------------------------------
-----------------------------------------o-------------------------g----------------------------t----------------------------------------||--------k--------------------------------------------
-------------------------------o---------------o------------------##---------------------------------------------------------------------||-------##--------------------------------------------
--------%%%%%%%%---SSSS-o--oS@SS--------------S-------S-----------------------------------------SSS---------Q---SS-------S------%--------||---------------------------------SSoo%%%-------------
---------||||||---------------------------------------SS----------------ooo-------------oooo--------oo--------------------------|--------|oo-------------ooo---------------------|---o----------
---------||||||---SS------------------------------------------------------------------------------------------------------------|--------||--------------------------------------|--------------
---------||||||-----oo--------------------o---o---------------------------------------------------------------------------------S--------||---------------S----------------------|--------------
------%%%%%%%%%%#--SS%%%%-%%%%%-----------%%%%%%------------------S-----------------------------TT---------------------------Q---TTT-----||-TT-----------------------------------TTT------------
-------||||||||-------||---|||-------------||||----------TT----------t-----------------TT-------TT----tt----------TT-------------TTTT--#-||-TT---------TT-------T-------------TT-TTT-----TT-----
-------||||||||-------||---|||-------------||||----------TT---------tt-TT--------------TT-------TT----tt-##-------TT--t----------TTTT--##||-TT---------TT-------T-------------TT-TTTT-t--TT-----
-------||||||||-------||---|||-------------||||----------TT-----g---tt-TT--------------TT-------TT----tt-##----y--TT--t------ggg-TTTT--##||-TT-k-------TT-k-----T---------T---TT-TTT--tt-TT---gg
XXXXXXXXXXXXXXXX--%%%-||---|||---XXX-----XXX||XXXXXXXXXXXXXXXXXXXXXXXXXXXXXXXXXXXXXXXXXXXXXXXXXXXXXXXXXXXXXXXXXXXXXXXXXXXXXXXXXXXXXXXXXXXXXXXXXXXXXXXXXXXXXXXXXXXXXXXXXXXXXXXXXXXXXXXXXXXXXXXXXX
XXXXXXXXXXXXXXXXg-g|--||---|||---XXX-----XXX|XXXXXXXXXXXXXXXXXXXXXXXXXXXXXXXXXXXXXXXXXXXXXXXXXXXXXXXXXXXXXXXXXXXXXXXXXXXXXXXXXXXXXXXXXXXXXXXXXXXXXXXXXXXXXXXXXXXXXXXXXXXXXXXXXXXXXXXXXXXXXXXXXXX
