------------------------------------------------------------------------------------------------------------------------------------------------------------------------------------------------
------------------------------------------------------------------------------------------------------------------------------------------------------------------------------------------------
------------------------------------------------------------------------------------------------------------------------------------------------------------------------------------------------
--------------------------------SSSSSSSSSSSSSSSS----------------SSSSSSSSS----S----------------------------------SSSSSSSSSS----SSSSSS-------------#------------------------------SSSSSSSS--------
------------------------------------------------------------------------------------------------------------------------------------------------------------------------------------------------
------------------------------------------------------------------------------------------oo-o--------------------------------------------------------------------------------------------------
--------%%%%%%%%-----------------------------------------------------------------------------------------------U----------------------------------------------------QQQQQS-----S----------------
---------||||||------------------------------------------------#---------------------------------------------------------------------------------#----------------------------------------------
---------||||||------------------------------------------------#--------------------------------------------------------------------------------------------------------------------------------
---------||||||------------------------------------------------#---------------------------------o---------------------------------------------------------##----o------------------------------
------%%%%%%%%%%SS-----------@S--------------------------------#-----------------------------#------------------------------------------------------------###---###----#Q----o------------------
-------||||||||-----------------------------------------------##----------------------------###----------------------------------------tt-----------------###---------------#-------------------
-------||||||||-----------------------tt----------------------##---------------------------####--------------------------#---#---------tt----------------####---------------#-------------------
-------||||||||----kgg----------------tt-----ggg--gg---g------##-%-----k-------g-------k---####---ggggg---k-----------####---gg--------tt---kk----k--k--####k------y-gg-----#-----------------g-
XXXXXXXXXXXXXXXXXXXXXXXXXXXXXXXXXXXXXXXXXXXXXXXXXXXXXXXXXXXXXXXXXXXXXXXXXXXXXXXXXXXXXXXXXXXXXXX-XXXXXXXXXXXXXXXXXXXXXXXXXXXXXXXXXXXXXXXXXXXXXXXXXXXXXXXXXXXXXXXXXXXXXXXXXXXXXXXXXXXXXXXXXXXXXXXX
XXXXXXXXXXXXXXXXXXXXXXXXXXXXXXXXXXXXXXXXXXXXXXXXXXXXXXXXXXXXXXXXXXXXXXXXXXXXXXXXXXXXXXXXXXXXXXXXXXXXXXXXXXXXXXXXXXXXXXXXXXXXXXXXXXXXXXXXXXXXXXXXXXXXXXXXXXXXXXXXXXXXXXXXXXXXXXXXXXXXXXXXXXXXXXXX
