------------------------------------------------------------------------------------------------------------------------------------------------------------------------------------------------
------------------------------------------------------------------------------------------------------------------------------------------------------------------------------------------------
------------------------------------------------------------------------------------------------------------------------------------------------------------------------------------------------
--------------------------------SSSSSSSS----------------------------------------SSSSSSSSSSSS---S----------------SSSSSSSSS-----------------------SSSSSSSSSSSSSSSS----------------SSSSSSSS--------
--------------------------------------------------------------------------------SS-------------------------------------------------------------oS-----------------------------------------------
---------------------------------------------------------------------------------S--------------------------------------------------------------------------------------------------------------
--------%%%%%%%%S-------------SS--------S------o-----------------oo----Soo----SS----------SS-----oo------------------------------ooo--SSoS---SoS----------------oooo---ooo---SoS----------------
---------||||||---------------------------------------------------------------------------------------------------------------------------------------------------------------------------------
---------||||||-------------------------------S-------------------------------------------------------------------------------------------------------------------------------------------------
---------||||||--------------------------------------------------oo-------------------------------------------------------------o-------------------------------o--------------o----------------
------%%%%%%%%%%----------------------tt-----o-----------------------------------------------------------------------------------------------US-----------------S----o-------SS-----------------
-------||||||||-----------------------tt-----------------------------------------------------------------TT-------------------------------------------------------------------------------------
-------||||||||--------TT-------------tt---------------------------------#------------tt-----------------TT--------------#----------------------------------------------------------------------
-------||||||||---ggg--TT-----#-#-----tt---k-------ggg--------kg-----yg-##------------tt-----kkg-----k--###---#------g---#----g-----okk-----k---k--------------------k------k-------------k---k-
XXXXXXXXXXXXXXXXXXXXXXXXXXXXXXXXXXXXXXXXXXXXXXXXXXXXXXXXXXXXXXXXXXXXXXXXXXXXXXXXXXXXXXXXXXXXXXXXXXXXXXXXXXXXXXXXXXXXXXXXXXXXXXXXXXXXXXXXXXXXXXXXXXXXXXXXXXXXXXXXXXXXXXXXXXXXXXXXXXXXXXXXXXXXXXXX
XXXXXXXXXXXXXXXXXXXXXXXXXXXXXXXXXXXXXXXXXXXXXXXXXXXXXXXXXXXXXXXXXXXXXXXXXXXXXXXXXXXXXXXXXXXXXXXXXXXXXXXXXXXXXXXXXXXXXXXXXXXXXXXXXXXXXXXXXXXXXXXXXXXXXXXXXXXXXXXXXXXXXXXXXXXXXXXXXXXXXXXXXXXXXXXX
