------------------------------------------------------------------------------------------------------------------------------------------------------------------------------------------------
------------------------------------------------------------------------------------------------------------------------------------------------------------------------------------------------
------------------------------------------------------------------------------------------------------------------------------------------------------------------------------------------------
----------------SSSSSSSS----SSSSSSSSSSSSSS---------------------------------------------------------------------------------------S------------------------------SSSSSSSS-------S----------------
------------------------------------------------------------------------------------------------------------------------------------------------------------------------------------------------
------------------------------------------------------------------------------------------------------------------------------------------------------------------------------------------------
--------%%%%%%%%-----------------------SS-----------QQQQQSS----------------------oo-QQQSoS---SoS---------------------SSSSS----SS-----------------oo--SSS-------------------------o---SSS-------S
---------||||||---------------------------------------------------------------------------------------------------------------------------------------------------------------------------------
---------||||||---------------------------------------------------------------------------------------------------------------------------------------------------------------------------------
---------||||||----------------------------------------g----------------------------------------------------------------------------------------------------------------------------------------
------%%%%%%%%%%%---------------------t--------------S@SQS--SQS-------------------------------S------2----------------S---------------------#---------------------------------------------------
-------||||||||-|-------------------ttt----------------------------------B---#----------------------------------------------------------TT--##--------------------------------------------------
-------||||||||-|---------------%---ttt--#------------------------B-----TT--#TT---------##--------------TT------------------------B-----TT--TTT-------------------t-----------------------------
-------||||||||-|--------------t|---ttt------------k--------k-----b-----TT--###----k-k--##k-----T-g-----TT-----#-----kg-----------b----kTt--TTT-------g---------%%t----------ggg---ggg----------
XXXXXXXXXXXXXXXX|--XXXXXXXXXX%%%XXXXXXXXXXXXXXXXXXXXXXXXXXXXXXXXXXXXXXXXXXXXXXX-XXXXXXXXXXXXXXXXXXXXXXXXXXXXXXXXXXXXXXXXXXXXXXXXXXXXXXXXXXXXXXXXXXXXXXXXXXXXXXXXXXXXXXXXXXXXXXXXXXXXXXXXXXXXXXXX
XXXXXXXXXXXXXXXX|--XXXXXXXXXX-|XXXXXXXXXXXXXXXXXXXXXXXXXXXXXXXXXXXXXXXXXXXXXXXX-XXXXXXXXXXXXXXXXXXXXXXXXXXXXXXXXXXXXXXXXXXXXXXXXXXXXXXXXXXXXXXXXXXXXXXXXXXXXXXXXXXXXXXXXXXXXXXXXXXXXXXXXXXXXXXXX
