------------------------------------------------------------------------------------------------------------------------------------------------------------------------------------------------
------------------------------------------------------------------------------------------------------------------------------------------------------------------------------------------------
------------------------------------------------------------------------------------------------------------------------------------------------------------------------------------------------
----------------------------------------------------------------SSSSSSSSSSSSSSS-SSSSSSSS------------------------SSSSSSSSSS----SS----------------SSSS----------------------------SSSSSSSS--------
---------------------------------------------------------------------S--------------------------------------------------------------------------------------------------------------------------
------------------------------------------------------------------------------------------------------------------------------------------------------------------------------------------------
--------%%%%%%%%------------------------SS-----S-----------------oo----SoSo--SSS----------------SSSSSSSSSSS--SSS--------SS------oooo---ooo---SSS----------------oooo---ooo----SS----------------
---------||||||---------------------------------------oo----------------------------------------------------------------------------------------------------------------------------------------
---------||||||---------------------------------S-------------------------------------------------------------------------------------------------------------------------------#---------------
---------||||||-----------------oo---------------------------------------------------------------g------------------------------o-------------------------------oo-----------------------o------
------%%%%%%%%%%-------------------------------S-------------------------------------2----------SSSS@SSS----S@SS----------------S-------------------------#-------------------------------------
-------||||||||------------------------------------------------------------------------------------------------------------------------------------------##-------------------------------------
-------||||||||--------------TT------------------------------------------###------------TT----#-------------------------------TT------------------------###-----------------------------------TT
-------||||||||---g----k-k---TT---ggg------#--------###------oo---------####---##-------TT---##----gggy---k----------k--------TT-----k----#-------g----####---k----k-kg---g-k-----------------TT
XXXXXXXXXXXXXXXXXXXXXXXXXXXXXXXXXXXXXXXXXXXXXXXXXXXXXXXXXXXXXXSXXXXXXXXXXXXXXXXXXXXXXXXXXXXXXXXXXXXXXXXXXXXXXXXXXXXXXXXXXXXXXXXXXXXXXXXXXXXXXXXXXXXXXXXXXXXXXXXXXXXXXXXXXXXXXXXXXXXXXXXXXXXXXXXX
XXXXXXXXXXXXXXXXXXXXXXXXXXXXXXXXXXXXXXXXXXXXXXXXXXXXXXXXXXXXXXo-XXXXXXXXXXXXXXXXXXXXXXXXXXXXXXXXXXXXXXXXXXXXXXXXXXXXXXXXXXXXXXXXXXXXXXXXXXXXXXXXXXXXXXXXXXXXXXXXXXXXXXXXXXXXXXXXXXXXXXXXXXXXXXXX
