------------------------------------------------------------------------------------------------------------------------------------------------------------------------------------------------
------------------------------------------------------------------------------------------------------------------------------------------------------------------------------------------------
------------------------------------------------------------------------------------------------------------------------------------------------------------------------------------------------
--------------------S---SS----------------------------------------------------------------------------------------------------------------------------------------------------------------------
------------------------------------------------------------------------------------------------------------------------------------------------------------------------------------------------
------------------------------------------------------------------------------o-------------------------------o-------------------##------------------------------------------------------------
--------%%%%%%%%oSS-oo--oo----2%--------------------------------SSS-S--------------------S------SSSSSS-------------------S-----o-------------SS-SS-------------------------------SS----------ooo
---------||||||--------------U-|----------o---------------o------------------------------------------------------------------------------o---------------------------------------------oo-------
---------||||||----------------|--------------------------------------------------------------------------------------------------------SS------------------------------------------------------
---------||||||-------------U--|--------------------------------------------------------------------------------------------------------SSS------------------------------S----------------------
------%%%%%%%%%%---------USSS--|--------------SQ--S---------------TT-----TT-------S----------------------TT--------------------Q--S------SS--------------TT-------------------------------------
-------||||||||----------------|-------TT-----------K--TT---------TT-----TT------------------------------TT----T----tt-----------------------------------TT------------TT----------------TT----T
-------||||||||----------------|-------TT--------------TT---------TT-----TT---------tt-------------------TT----T----tt-----B-----------------------------TT---------tt-TT----------------TT----T
-------||||||||------U-------g-k--k----TT--g-----------TT-k-y-----TT-----TT---------tt---------------y---TT----Tg---tt-----b--g-----------k----------yg--TT---------tt-TT------------g---TT----T
XXXXXXXXXXXXXXXXXXXXXXXXXXXXXXXXXXXXXXXXXXXXXXXXXXXXXXXXXXXXXXXXXXXXXXXXXXXXXXXXXXXXXXXXXXXXXXXXXXXXXXXXXXXXXXXXXXXXXXXXXXXXXXXXXXXXXXXXXXXXXXXXXXXXXXXXXXXXXXXXXXXXXXXXXXXXXXXXXXXXXXXX-XXXXXXX
XXXXXXXXXXXXXXXXXXXXXXXXXXXXXXXXXXXXXXXXXXXXXXXXXXXXXXXXXXXXXXXXXXXXXXXXXXXXXXXXXXXXXXXXXXXXXXXXXXXXXXXXXXXXXXXXXXXXXXXXXXXXXXXXXXXXXXXXXXXXXXXXXXXXXXXXXXXXXXXXXXXXXXXXXXXXXXXXXXXXXXXXXXXXXXXX
