------------------------------------------------------------------------------------------------------------------------------------------------------------------------------------------------
------------------------------------------------------------------------------------------------------------------------------------------------------------------------------------------------
------------------------------------------------------------------------------------------------------------------------------------------------------------------------------------------------
----------------SSSSSSSSSSSSSSSS--------------------------------S----SS--------------------------S------------------------------SSSSSSSSSSS-----------------------------------------------------
----------------------SS----------------------------------------------------------------------o-------------------------------------------------------------------------------------------------
---------------------SS-------SS----------------------------------------------------------------------------------------------------------------------------------------------------------------
--------%%%%%%%%SSSSSSSS-----SSS------------------ooooSSoS----SS-----------------o----SSSS---Soo--------------------QS---------o----------------------SSSS-----------------------oo------------o
---------||||||----------------------------------------------------------------------------------------------------------------#----------------------o---------S-------------------------------
---------||||||-S-------------SS-------------------------------S--------------------------------------------------------------##--------------------------------S---o---------------------------
---------||||||-Sogggooo---S-SSS---------------------------------------------------------------------------------------------###----------------------------------------------------------------
------%%%%%%%%%%SSSS#SSS-----SSS-------------o-----------------------------------------------S-------------------------------##--------------------------------------2--------------------------
-------||||||||--------K-------------tt----------------------------------##----------------------------TTT---------------TT--##----------------------------------------TT----------------TT-----
-------||||||||----------------------tt---------------------------TT----###---TT-----------------------TTT---TT----------TT--##---------tt----TT-----------------------TT-----g----------TT-----
-------||||||||--------------#-------tt---#-y-------gg------k-----TT----###---TT----g-k---------g-b----TTT---TT----kgggg-TT--###--g-----tt----TT---------------g--g----TT---####-----k--###-----
XXXXXXXXXXXXXXXXXXXXXXXXXXXXXXXXXXXXXXXXXXXXXXXXXXXXXXXXXXXXXXXXXXXXXXXXXXXXX-XXXXXXXXXXXXXXXXXXXXXXXXXXXXXXXXXXXXXXXXXXXXXXXXXXXXXXXXXXXXXXXXXXXXXXXXXXXXXXXXXXXXXXXXXXXXXXXXXXXXXXXXXXXXXXXXXX
XXXXXXXXXXXXXXXXXXXXXXXXXXXXXXXXXXXXXXXXXXXXXXXXXXXXXXXXXXXXXXXXXXXXXXXXXXXXX-XXXXXXXXXXXXXXXXXXXXXXXXXXXXXXXXXXXXXXXXXXXXXXXXXXXXXXXXXXXXXXXXXXXXXXXXXXXXXXXXXXXXXXXXXXXXXXXXXXXXXXXXXXXXXXXXXX
