------------------------------------------------------------------------------------------------------------------------------------------------------------------------------------------------
-----------------------------------------------------------------K-----------------------------------------------------------------------------------------------K------------------------------
------------------------------------------------------------------------------------------------------------------------------------------------------------------------------------------------
----------------S----------------------------------------------------------------------------------SSSSS----------------------------------------SSSSSS------------------------------------------
-------------------------------------------------------------------------------o----------------------------------------------------------------------------------------------------------------
-------------------------------------------------------------------------o----------------------------------------------------------------------------------------------------------------------
--------%%%%%%%%------SSSS------------------------------------------------------------SSSSS-----oooo--SSoo---So--S-----------2------------------ooo----SS--------------------S-----------------U
---------||||||----------------------------------o---------------#--------------------oo--------------------------------------------------------------------------------------------------------
---------||||||--------------------------------------------------------------------------------------------------------------U---------------------------------------------------------------o--
---------||||||-----------------------------------------------------------------------------------------------------------------------------------------------------g---------------------------
------%%%%%%%%%%-----------------------------------------------------------------------------o--S----------------------------US------------------------------------SS#S----------------------U--
-------||||||||---------------------------#--------------TT-------TT-----TT---TT-----------------------------------------TT---------------------------------------------------------------------
-------||||||||------tt------------------##--------------TT-------TT-----TT---TT-----------------------------------------TT-------------------TT-------------------------TT---------------------
-------||||||||------tt------kk---kg-----##g------g------TT---k---TT-----TT---TT------g------kkg-----k------------ggggy--TT-------g------k----TT-----g---##-k---------k--TT-------ggg-----k-k---
XXXXXXXXXXXXXXXXXXXXXXXXXXXXXXXXXXXXXXXXXXXXXXXXXXXXXXXXXXXXXXXXXXXXXXXXXXXXXXXXXXXXXXXXXXXXXXXXXXXXXXXXXXXXXXXXXXXXXXXXXXXXXXXXXXXXXXXXXXXXXXXXXXXXXXXXXXXXXXXXXXXXXXXXXXXXXXXXXXXXXXXXXXXXXXXX
XXXXXXXXXXXXXXXXXXXXXXXXXXXXXXXXXXXXXXXXXXXXXXXXXXXXXXXXXXXXXXXXXXXXXXXXXXXXXXXXXXXXXXXXXXXXXXXXXXXXXXXXXXXXXXXXXXXXXXXXXXXXXXXXXXXXXXXXXXXXXXXXXXXXXXXXXXXXXXXXXXXXXXXXXXXXXXXXXXXXXXXXXXXXXXXX
