------------------------------------------------------------------------------------------------------------------------------------------------------------------------------------------------
------------------------------------------------------------------------------------------------------------------------------------------------------------------------------------------------
------------------------------------------------------------------------------------------------------------------------------------------------------------------------------------------------
------------------------------------------------------------------------------------------------------------------------------------------------------------------------------------------------
------------------------------o-----------------------------------------------------------------------------------------------------------------------------------------------------------------
------------------------------------------------------------------------------------------------------------------------------------------------------------------------------------------------
--------%%%%%%%%--S-SSSSSSSS--SS---------------------SSSSS----------SUSS-S------------------------SSSSSSS------------------------------------------SSS--------------------------SS----S-----SSS-
---------||||||-------------------------------------------------------------------------------------------------------------------------------------------------------------------SS------------
---------||||||------S-SSSS------------------------------------------------------------S--------------------------------------------------------------------------------SS----------------------
---------||||||-------------------gg----------------------o------------------------o---SSSS--------o--------------------SSS--------------SS-----------------------------SSS---------------------
------%%%%%%%%%%----------SSSS-S--QQ----@---------SS----------#--------------#----SSS--------------Q------------------------------S-------------------------------S-----------------------------
-------||||||||------------------------------#---------------##-------------##------------------------------------------------TT-------------------------TT----T----------------T--------TT---TT
-------||||||||----S------------------------##--------------###-----------#-##--------------##---------------#----------------TT-------------------------TT----T----tt-TT-------T--------TT---TT
-------||||||||------k------------------K--###----y--k--g--####-------g--##-##----kkk---kk--##-----gggg--k--##----------T-kkk-TT---------------------y---TT----T----tt-TT-------T--------TT---TT
XXXXXXXXXXXXXXXXXXXXXXXXXXXXXXXXXXXXXXXXXXXXXXXXXXXXXXXXXXXXXXXXXXXXXXXXXXXXXXXXXXXXXXXXXXXXXXXXXXXXXXXXXXXXXXXXXXXXXXXXXXXXXXXXXXXXXXXXXXXXXXXXXXXXXXXXXXXXXXXXXXXXXXXXXXXXXXXXXXXXXXXXXXXXXXXX
XXXXXXXXXXXXXXXXXXXXXXXXXXXXXXXXXXXXXXXXXXXXXXXXXXXXXXXXXXXXXXXXXXXXXXXXXXXXXXXXXXXXXXXXXXXXXXXXXXXXXXXXXXXXXXXXXXXXXXXXXXXXXXXXXXXXXXXXXXXXXXXXXXXXXXXXXXXXXXXXXXXXXXXXXXXXXXXXXXXXXXXXXXXXXXXX
