------------------------------------------------------------------------------------------------------------------------------------------------------------------------------------------------
------------------------------------------------------------------------------------------------------------------------------------------------------------------------------------------------
------------------------------------------------------------------------------------------------------------------------------------------------------------------------------------------------
-------------------------------------------------SSS-SSS-------------------------SSSS-----------------------------------------------------------SSSSSSSS----------------------------------------
------------------------------------------------------------------------------------------------------------------------------------------------------------------------------------------------
-------------------------------o--------------------------------------------------------------------------------------------------------------------------o-------------------------------------
--------%%%%%%%%SSSSSSSSSSS--SSS-o----SSSS---SS--------------------------------o----------------------ooo------------------------ooo---------ooo--------SSS---------QQQQQSS--SSS----------------
---------||||||---------------------------------------------------------------------------------------------------------------------------------------------------------------------------------
---------||||||-----------------------------------------------S-----------------------------------------------------o------------------------ooo------------------------------------------------
---------||||||-oooo------------------------------------------------------------------------------------------------------------o----------------------t----------------------------------------
------%%%%%%%%%%SSSSSSSS----SSSS#-----t------------------------------------------------------------------------------2--------------------------------tt-----oo--------QQQ-----------2----------
-------||||||||-----------------------t----------------##-----------------#-------------TT------------tt-----------------TT--------------------------ttt-----t%-------------------------TTT-----
-------||||||||-----------------------t--------------###-----TT------B---##-------B----TTT---TT-------tt-----------------TT---U----------##----------ttt------T--------------#----------TTT-----
-------||||||||----k-ggg--k-k-------ttt------k------####-----TT---kggt---##------Tb---kkTT---TT-#-----tt----kk-----------TT---gT---k-ygg###----------ttt----ggg--------------#-#-gg-----TTT--g-g
XXXXXXXXXXXXXXXXXXXXXXXXXXXXXXXXXXXXXXXXXXXXXXXXXXXXXXXXXXXXXXXXXXXXXXXXXXXXXXXXXXXXXXXXXXXXXXXXXXXXXXXXXXXXXXXXXXXXXXXXXXXXXXXXXXXXXXXXXXXXXXXXXXXXXXXXXXXXXXXXXXXXXXXXXXXXXXXXXXXXXXXXXXXXXXXX
XXXXXXXXXXXXXXXXXXXXXXXXXXXXXXXXXXXXXXXXXXXXXXXXXXXXXXXXXXXXXXXXXXXXXXXXXXXXXXXXXXXXXXXXXXXXXXXXXXXXXXXXXXXXXXXXXXXXXXXXXXXXXXXXXXXXXXXXXXXXXXXXXXXXXXXXXXXXXXXXXXXXXXXXXXXXXXXXXXXXXXXXXXXXXXXX
