--------------------------------------------------------------------------------------------------------------------------------------------------------------------------------
--------------------------------------------------------------------------------------------------------------------------------------------------------------------------------
--------------------------------------------------------------------------------------------------------------------------------------------------------------------------------
--------------------------------------------------------------------------------------------------------------------------------------------------------------------------------
-----------------------------------------------U--------------------------------------------------------------------------------------------------------------------------------
----------------------------------------------------------------------------------------------------------------------------ooo-------------------------------------------------
--------------------SSSSSSS------------------------------------------------------------------------SSSSSSS------SS--SSS------------------------S-------------S---SS------S------
-------------------------------------------------------------------------S------------------------------------------------------------------------------------------oo----------
-----------------------------------------------------------------------SSS--------------------------------------------------------------SS--------------------------------------
ooo------SUR--S#--------------------------------------------------------SSSS-----------------------o------o------------------------------SS-------------------------------------
----%---------##---S--------##----------------#-------------------S-------------------------------SS---------------------TT-------S-------S--QQ---S-------------TT--------------
----|--------##------------###---K-----------##--------------#------K----------------------------------------------------TT------------------------------TT----TTT-------TT----T
----|-------###-----------####---------T----###-------------##---------TT-----#------------------------------------------TT---------tt-------------------TT----TTT----tt-TT----T
----|------####---kg---y-#####---------T---####--k---------####---K----TT---#k#--------------k----y-k---y------------y---TT---------tt-----y-------------TT----TTT----tt-TT----T
---%|-----XXXXXXXXXXXXXXXXXXXXXXXXXXXXXXXXXXXXXXXXXXXXXXXXXXXXXXXXXXXXXXXXXXXXXXXXXXXXXXXXXXXXXXXXXXXXXXXXXXXXXXXXXXXXXXXXXXXXXXXXXXXXXXXXXXXXXXXXXXXXXXXXXXXXXXXXXXXXXXXXXXXXXX
---||-----XXXXXXXXXXXXXXXXXXXXXXXXXXXXXXXXXXXXXXXXXXXXXXXXXXXXXXXXXXXXXXXXXXXXXXXXXXXXXXXXXXXXXXXXXXXXXXXXXXXXXXXXXXXXXXXXXXXXXXXXXXXXXXXXXXXXXXXXXXXXXXXXXXXXXXXXXXXXXXXXXXXXXX
