------------------------------------------------------------------------------------------------------------------------------------------------------------------------------------------------
------------------------------------------------------------------------------------------------------------------------------------------------------------------------------------------------
------------------------------------------------------------------------------------------------------------------------------------------------------------------------------------------------
----------------SSS---------------------------------------------SSSSSSSSS----------------------------------------SS-------------SSSSSSSSSSS---SS--------------------------------SSSSSSSSSS------
--------------------------------------------------------------------------------------------------------------------------------S---------------------------------------------------------------
------------------------------------------------------------------------------------------------------------------------------------------------------------------------------------------------
--------%%%%%%%%--------S---------------o------S-----------------------SS-------ooo---SS-----SSSSoo----SS------------------------------S-----S--@SS@QSSSSS---SSS--------------------------------
---------||||||---------------------------------------------------------------------------------------------------------------------------------------------------------------------------------
---------||||||-----------------------------------------------------------------------------------------------------------------------------------------------o---------------------------------
---------||||||-----------------oo------------------------------------------------------------#-S------------------------------------------------------g----------------------------------------
------%%%%%%%%%%----------------S------------------------------------------------------------###-------------US---------------------------------QSQQQ--SS---SSSS--------------------------------
-------||||||||-------------------------------------------2---------------------------------###--------------------------TT----------tt---------------------------------------------------------
-------||||||||----------------------------------------------------------------------------####--------------------------TT---TT-----tt-------------------------------------------------------TT
-------||||||||------k------------ggg------g-g-g--g------------g-----k--------------gg----#####----k--------k-----k--g-y-TT---TT-----tt------kg----k-gy---k-k-----gggggg----k-----g-----------TT
XXXXXXXXXXXXXXXXXXXXXXXXXXXXXXXXXXXXXXXXXXXXXXXXXXXXXXXXXXXXXXXX-XXXXXXXXXXXXXXXXXXXXXXXXXXXXXXXXXXXXXXXXXXXXXXXXXXXXXXXXXXXXXXXXXXXXXXXXXXXXXXXXXXXXXXXXXXXXXXXXXXXXXXXXXXXXXXXXXXXXXXXXXXXXXXX
XXXXXXXXXXXXXXXXXXXXXXXXXXXXXXXXXXXXXXXXXXXXXXXXXXXXXXXXXXXXXXXXX-XXXXXXXXXXXXXXXXXXXXXXXXXXXXXXXXXXXXXXXXXXXXXXXXXXXXXXXXXXXXXXXXXXXXXXXXXXXXXXXXXXXXXXXXXXXXXXXXXXXXXXXXXXXXXXXXXXXXXXXXXXXXXX
