------------------------------------------------------------------------------------------------------------------------------------------------------------------------------------------------
------------------------------------------------------------------------------------------------------------------------------------------------------------------------------------------------
------------------------------------------------------------------------------------------------------------------------------------------------------------------------------------------------
----------------------------------------------------------------------------------------------------------------SSSSSSSS--------------------------------------------------------S-SS------------
------------------------------------------------------------------------------------------------------------------------------------------------------------------------------------------------
------------------------------------------------------------------------o-----------------------------------------------------------------------------------------------------------------------
--------%%%%%%%%--------------SS------SSSSS----o-----SQSS--------------------------------------------------------So---Soo-----o---------------------QQQ--------o------------------------S-------
---------||||||---------------------------------------#-----------------------------------------------------------------------------------------------------------------------------%%----------
---------||||||--------------------------------------------------------------------------------------------------------------Soo------------------------------S---------------------||----------
---------||||||-----o-----------oo--------------------------------------------------------------------------------------------------------------------------------------------------||----------
------%%%%%%%%%%----S-----------------------------------Q------------------------------------U-------------------------------SSS----------------###----------------------##-#-------||t---------
-------||||||||------------------------------------------------------------------------TT----#-----------TT--------------------------------------------------------------T#-#-------|tt---------
-------||||||||---------------------------#----------------------------------TT--------TT---###---B------TT---TT------------------B-----t-----o--------------------------T#---------|tt---------
-------||||||||-----------#-k-----ggggk---b-----------------------k----y-----TT-----g--TT---###---b------TT---TT#----k------------t----ktt---ggg#--k--ky-----k-------k--###---------|tt-------kg
XXXXXXXXXXXXXXXXXXXXXXXXXXXXXXXXXXXXXXXXXXXXXXXXXXXXXXXXXXXXXXXXXXXXXXXXXXXXXXXXXXXXXXXXXXXXXXXXXXXXXXXXXXXXXXXXXXXXXXXXXXXXXXXXXXXXXXXXXXXXXXXXXXXXXXXXXXXXXXXXXXXXXXXXXXXXXXXXXXXXXXXXXXXXXXXX
XXXXXXXXXXXXXXXXXXXXXXXXXXXXXXXXXXXXXXXXXXXXXXXXXXXXXXXXXXX-XXXXXXXXXXXXXXXXXXXXXXXXXXXXXXXXXXXXXXXXXXXXXXXXXXXXXXXXXXXXXXXXXXXXXXXXXXXXXXXXXXXXXXXXXXXXXXXXXXXXXXXXXXXXXXXXXXXXXXXXXXXXXXXXXXXX
