------------------------------------------------------------------------------------------------------------------------------------------------------------------------------------------------
------------------------------------------------------------------------------------------------------------------------------------------------------------------------------------------------
------------------------------------------------------------------------------------------------------------------------------------------------------------------------------------------------
---------------------------------SS---------------------------------------------SSSSSSSS--------SSSSSSSSSSSSSSSS----------------SSSSSSS---------------------------------------------------------
--------------------------------------------------------------------------------------------------------------------------------------------------------------o---------------------------------
------------------------------------------------------------------------------------------------------------------------------------------oo----------------------------------------------------
--------%%%%%%%%------------------------------------QSQSSS-----------------------oo----Soo-----S-----------------ooo-----------o--------------------QQQQQS----@S-----------------oo------------o
---------||||||--------------------------------------------------#------------------------------------------------------------------------------------------------------------------------------
---------||||||---------------------------------------------------------------------------------------------------------------------------------------------------------------------------------
---------||||||-------------------------------------------------------------------------------------------------o-------------------------------------------------------------------------------
------%%%%%%%%%%---------------------------------------------S----------TTT-#-------ttt----------------------------------------------------------------QQ------------2--------------------------
-------||||||||--------TT-----TT------tt--------------------------TT----TTT-#-------ttt----------------tt------------------------------TT---TTT-------------------------TT---------------TT-----
-------||||||||---TT---TT-----TT------tt--------------------------TT----TTT-#TT-----ttt----------------tt-----o------------------------TT---TTT-------------------B-----TT---TT------2---TT-----
-------||||||||---TT---TT-----TT------tt-----ggg---k--k-----------TT----TTT-#TT-----ttt-----k-k--------tt-----g----kgg----k-----g-b----TT---TTT-------k---------g-b-----TT---TT---------###-----
XXXXXXXXXXXXXXXXXXXXXXXXXXXXX--XXXXXXXXXXXXXXXXXXXXXXXXXXXXXXXXXXXXXXXXXXXXXXXXXXXXXXXXXXXXXXXXXXXXXXXXXXXXXXXXXXXXXXXXXXXXXXXXXXXXXXXXXXXXXXXXXXXXXXXXXXXXXXXXXXXXXXXXXXXXXXXXXXXXXXXXXXXXXXXXX
XXXXXXXXXXXXXXXXXXXXXXXXXXXXX--XXXXXXXXXXXXXXXXXXXXXXXXXXXXXXXXXXXXXXXXXXXXXXX-XXXXXXXXXXXXXXXXXXXXXXXXXXXXXXXXXXXXXXXXXXXXXXXXXXXXXXXXXXXXXXXXXXXXXXXXXXXXXXXXXXXXXXXXXXXXXXXXXXXXXXXXXXXXXXXXX
