------------------------------------------------------------------------------------------------------------------------------------------------------------------------------------------------
------------------------------------------------------------------------------------------------------------------------------------------------------------------------------------------------
------------------------------------------------------------------------------------------------------------------------------------------------------------------------------------------------
----------------------------------------------------------------SSSSSSSSSS------SSSSSSSSSSSSSSSS-----SSSS-----------------------SSSSSSSSSSS--------SSSSS-------------------------SSSSS----------
----------------------------------------------------------------SS---S----------S---------------------------------------------------------------------------------------------------------------
------------------------------------------------------------------------------------------------------------------------------------------------------------------------------------------------
--------%%%%%%%%-----------------------------------------------U-----------------------SSo------ooo-----------SS---------------S----------------ooo----Soo-----SSSSSSSSSo----SSS-oo-------------
---------||||||---------------------------------------------------------------------------------------------------------------------------------------------------------------------------------
---------||||||----------------------------------------------o----------------------------------------------------------------------------------------------------------------------------------
---------||||||--oo------------------------------o--------------------------------------SS-------o--------------ooo-----------------------------oo--------------oooo----------------------------
------%%%%%%%%%%------------#--------------------S----------S@S-------------------------------------------#-----SSS---------------------------------------------SSSS---------SSS----------------
-------||||||||-------------#-------------K--------------------------------------------------------------##------------------------------------------tt----------------------------------TT-----
-------||||||||-----------#---##----------#-------------------------tt--------------tt-------------------##-------------------------------#---TT-----tt----------------------------------TT-----
-------||||||||------k-y--#---##-----k-k--#-------gggy----kgk-------tt--------ko----tt--------g-----g---###-------gggg------gggg-------y--#---TT-----tt--#-gg--------ggg----k------k-k---TT-----
XXXXXXXXXXXXXXXXXXXXXXXXXXXXXXXXXXXXXXXXXXXXXXXXXXXXXXXXXXXXXXXX-XXXXXXXXXXXXXXXXXXXXXXXXXXXXXXXXXXXXXXXXXXXXXXXXXXXXXXXXXXXXXXXXXXXXXXXXXXXXXXXXXXXXXXXXXXXXXXXXXXXXXXXXXXXXXXXXXXXXXXXXXXXXXXX
XXXXXXXXXXXXXXXXXXXXXXXXXXXXXXXXXXXXXXXXXXXXXXXXXXXXXXXXXXXXXXXXXXXXXXXXXXXXXXXXXXXXXXXXXXXXXXXXXXXXXXXXXXXXXXXXXXXXXXXXXXXXXXXXXXXXXXXXXXXXX-XXXXXXXXXXXXXXXXXXXXXXXXXXXXXXXXXXXXXXXXXXXXXXXXXX
