------------------------------------------------------------------------------------------------------------------------------------------------------------------------------------------------
------------------------------------------------------------------------------------------------------------------------------------------------------------------------------------------------
------------------------------------------------------------------------------------------------------------------------------------------------------------------------------------------------
------------------------------------------------------------------------------------------------------------------------------------------------SSSSSSSSS---------------------------------------
------------------------------------------------------------------------------------------------------------------------------------------------------------------------------------------------
-------------------------------------------------------------------------------------------------------------------------------o--------------------------oo------------------------------------
--------%%%%%%%%%------------------------------o-------------------------------------------------------Qo----------------------S---o-----------o----------SS--------QQQQSSS--SSS----------------
---------||||||-|--------------#--------------------%%%-----------------------------------------------------------------------------------------------------------------------------------------
---------||||||-|-------------##---------------------|--------------------------------------------------------------#---------------------------------------------------------------------------
---------||||||-|------------###---------------------|--------------------------------------------------------------#---------------------------------------------------------------------------
------%%%%%%%%%%|------------###---------------------|tt-------------------------------------#--#---####-----o----------------------------------------tt-----TT-----QQQQQQ---o-------2----------
-------||||||||-|------------###---------------------|tt------------------------------------##-------------------------------------------TT-----------tt-----TT-------------------------TT------
-------||||||||-|----------#####-----B---TT----------|tt-----TT----------TT---#--------TT--###--#----------------------------##----------TT----------tt------TT-------------------#-----TT----U-
-------||||||||-|----------#####-----b---TT----------|tt-----TT---gg-----TT--##---g----TT--####-##----------------g---------###g---k--gg-TT----------tt------TT-------------------g-----TT----gg
XXXXXXXXXXXXXXXX%%%XXXXXXXXXXXXXXXXXXXXXXXXXXXXXXXXXXXXXXXXXXXXXXXXXXXXXXXXXXXXXXXXXXXXXXXXXXXXXXXXXXXXXXXXXXXXXXXXXXXXXXXXXXXXXXXXXXXXXXXXXXXXXXXXXXXXXXXXXXXXXXXXXXXXXXXXXXXXXXXXXXXXXXXXXXXXX
XXXXXXXXXXXXXXXXX|--XXXXXXXXXXXoXXXXXXXXXXXXXXXXXXXXXXXXXXXXXXXXXXXXXXXXXXXXXXXXXXXXXXXXXXXXXXXXXXXXXXXXXXXXXXXXXXXXXXXXXXXXXXXXXXXXXXXXXXXXXXXXXXXXXXXXXXXXXXXXXXXXXXXXXXXXXXXXXXXXXXXXXXXXXXXX
