------------------------------------------------------------------------------------------------------------------------------------------------------------------------------------------------
--------------------------S---------------------------------------------------------------------------------------------------------------------------------------------------------------------
------------------------------------------------------------------------------------------------------------------------------------------------------------------------------------------------
----------------SS---ooo-oSo-SSS--------------------------------SSSSSSSSSSSSSSSS--------------------------------------------------------------------------------SSSSSSSS------------------------
---------------------%%%-------S----------------------------------------------------------------------------------------------------------------------------------------------------------------
----------------------|----------------------------------------------------o--------------------------------------------------------------------------------------------------------------------
--------%%%%%%%%------|---oooo-------------------oo----SS------S-----------S-------------------------------------ooo--SSoo----oo-------------------------------U--------------------QQSSSS---S@S
---------||||||-------|-------------------------------------------------------------------------------------------------------------------------------------------------------------------------
---------||||||-------|---SSSS-S-----------------------------------------------------------------------------------------------------------------------------oo---------------------------------
---------||||||-------So--SSSSS--o--------------------------------------------------------------------------------------------------------------o-----------------------------------------------
------%%%%%%%%%%----------SSSSS------------------------------oS-------t---------#----------------------------------------------------------------------------@S-----------------------QQQ----Q--
-------||||||||--------------------------T-----------t----------------tt---------------------------------TT----------t-----------------tt----##--------------------------B----------------------
-------||||||||-------------------------TT-----------t---------------ttt-----TT--------------------------TT---------tt-----------------tt----##----------------------B--tt---TT--###------------
-------||||||||------------------ot----ktt---g-g----gt----------k----ttt-----kT---gg---------#kg--gggg---TT---ko----tt----------g------tt---###---gggggg--k---kg-----b-ktt---TT--###--k---------
XXXXXXXXXXXXXXXX-----%-----X----XXXXXXXXXXXXXXXXXXXXXXXXXXXXXXXXXXXXXXXXXXXXXXXXXXXXXXXXXXXXXXXXXXXXXXXXXXXXXXXXXXXXXXXXXXXXXXXXXXXXXXXXXXXXXXXXXXXXXXXXXXXXXXXXXXXXXXXXXXXXXXXXXXXXXXXXXXXXXXXX
XXXXXXXXXXXXXXXX-----|---------XXXXXXXXXXXXXXXXXXXXXXXXXXXXXXXXXXXXXXXXXXXXXXXXXXXXXXXXXXXXXXXXXXXXXXXXXXXXXXXXXXXXXXXXXXXXXXXXXXXXXXXXXXXXXXXXXXXXXXXXXXXXXXXXXXXXXXXXXXXXXXXXXXXXXXXXXXXXXXXXX
