------------------------------------------------------------------------------------------------------------------------------------------------------------------------------------------------
------------------------------------------------------------------------------------------------------------------------------------------------------------------------------------------------
------------------------------------------------------------------------------------------------------------------------------------------------------------------------------------------------
------------------------------------------------------------------------------------------------------------------------------------------------------------------------------------------------
------------------------------------------------------------------------------------------------------------------------------------------------------------------------------------------------
-----------------------------------------------------------------------------------#--------------------------------------------------------------##--------------------------------------------
--------%%%%%%%%---------------o-------------------SSSSS-------%--------------------------------%%--------------SSS-S----S--------------------------------------SS-----------------------------o
---------||||||------------------------------------------------|--------------------------------||-------------------------------------------------###----o-------------------------------------
---------||||||-------------------------------------SS---------|--------------------------------||----------------------------------------------------------------------------------------------
---------||||||---------------------------S1-------------------|--------------------------S-----||----------------------------------------------------------------------------------------------
------%%%%%%%%%%QQ------QQQQ------------------#----------------|--------------------------------||TT---------------------TT---------------------------------------------------------------------
-------||||||||------------------------------##----------------#-----------------------TT-------||TT---------------------TT----------------------------------------------TT-------TT------------
-------||||||||-----------------------------###----#-----##----#-------TT-----------tt-TT-------||TT------------------B--TT----------t-----------------------------------TT-------TT---##-------
-------||||||||------------g------K--------####----#-----##----#-------TT-----------tt-TT-------||TT---#--------------b-kTT----g-----t------y------------------------y---TT------kTT---##----k--
XXXXXXXXXXXXXXXXXXXXXXXXXXXXXXXXXXXXXXXXXXXXXXXXXXXXXXXXXXXXXXXXXXXXXXXXXXXXXXXXXXXXXXXXXXXXXXXXXXXXXXXXXXXXXXXXXXXXXXXXXXXXXXXXXXXXXXXXXXXXXXXXXXXXXXXXXXXXXXXXXXXXXXXXXXXXXXXXXXXXXXXXXXXXXXXX
XXXXXXXXXXXXXXXXXXXXXXXXXXXXXXXXXXXXXXXXXXXXXXXXXXXXXXXXXXXXXXXXXXXXXXXXXXXXXXXXXXXXXXXXXXXXXXXXXXXXXXXXXXXXXXXXXXXXXXXXXXXXXXXXXXXXXXXXXXXXXXXXXXXXXXXXXXXXXXXXXXXXXXXXXXXXXXXXXXXXXXXXXXXXXXXX
