------------------------------------------------------------------------------------------------------------------------------------------------------------------------------------------------
------------------------------------------------------------------------------------------------------------------------------------------------------------------------------------------------
------------------------------------------------------------------------------------------------------------------------------------------------------------------------------------------------
----------------------------------------------------------------SSSSSSSS-------------------------S-----------------SS----SSS----SSSSSSSS-------------------------S---------------SSSSSS---------
------------------------------------------------------------------------------------------------------------------------------------------------------------------------------------------------
------------------------------------------------------------------------------------------------------------------------------------------------------------------------------------------------
--------%%%%%%%%------QQQ------o-----------------ooo-----------o-----------------o----SSSS-----------------------ooo-----------o------------------Q-QSQSSSS--SSS----------------ooo----Soo------
---------||||||---------------------------------------------------------------------------------------------------------------------------------------------------------------------------------
---------||||||--------------o----------------------------------------------------------------------------------------------------------------------------------------------------------------S-
---------||||||---------------------------------o-----------------------------------------------------------------------------------------------------------------------------------------------
------%%%%%%%%%%-------------S----------------------------------------tt---------------------y--------------------------------------------------Q-QQQ-SUS----US---------------------------------
-------||||||||-------------------------------------------------------tt---------------------##---------TT----------------#-----------tt---------------------------------TT---------------------
-------||||||||-------------------B-----------------------B----------tt------TT--------------##---B-----TT---TT-----------#-----------tt---------------------------------TT---U-----tt----------
-------||||||||------kkk-------g--b--k-------gg----kggg--#b-------k--tt------TT-------------###---b-----TT---TT------k---##-------g---tt----ggg----k------------%%k----k-TT--grg----tt----------
XXXXXXXXXXXXXXXXXXXXXXXXXXXXXXXXXXXXXXXXXXXXXXXXXXXXXXXXXXXXXXXXXXXXXXXXXXXXXXXXXXXXXXXXXXXXXXXXXXXXXXXXXXXXXXXXXXXXXXXXXXXXXXXXXXXXXXXXXXXXXXXXXXXXXXXXXXX-XXXXXXXXXXXXXXXXXXXXXXXXXXXXXXXXXXXX
XXXXXXXXXXXXXXXXXXXXXXXXXXXXXXXXXXXXXXXXXXXXXXXXXXXXXXXXXXXXXXXXXXXXXXXXXXXXXXXXXXXXXXXXXXXXXXXXXXXXXXXXXXXXXXXXXXXXXXXXXXXXXXXXXXXXXXXXXXXXXXXXXXXXXXXXXXX-XXXXXXXXXXXXXXXXXXXXXXXXXXXXXXXXXXXX
