------------------------------------------------------------------------------------------------------------------------------------------------------------------------------------------------
------------------------------------------------------------------------------------------------------------------------------------------------------------------------------------------------
------------------------------------------------------------------------------------------------------------------------------------------------------------------------------------------------
--------------------------------------------------------------------------------SSSS----------------------------SSSSSSS---------SSSSSSS-----------------------------------------SSSSSSSS--------
------------------------------------------------------------------------------------------------------------------------------------------------------------------------------------------------
-----------------o-------oooo-------------------------------------------------------------------------------------------------------------------------------------------------------------------
--------%%%%%%%%-----------%%---------------------------oo-----o--------------------------------------SSSSS----S------------------------SS---------------------o---------------o----------------
---------||||||------------||--------------------------------------------------------------------------------------------------------------------------------------------------#----------------
---------||||||------------||--------------------------------------------------------------------------------------------------------------------------------###-------------###----------------
---------||||||------------||------------------------------------------------##------------------------------------------------------------------------------###-----------#####----------------
------%%%%%%%%%%-T-----t---||-----------------------------------------------###--#--------------------------SSSS----------------------tt--------------------####---------TT#####------tt--------
-------||||||||-T------t---||-----------------------------------------tt---####--##----t--------------------------------TTT----------ttt---------------t----###----------TT#####------tt--------
-------||||||||-TT-----tt--||#---------------------------------------ttt---####-TTT----T--------------------------B-----TTT----------ttt-------------------####----------TT#####-----ttt--------
-------||||||||-Tt-----tt--||2---------------g-g--g--k----#----------ttt--#####-TTT---kk----kkk---gggk------------b-----TTT---#------ttt-----yg--------k--#####---g-----########-----ttt----ggg-
XXXXXXXXXXXXXXXXXXX---XXXXXXXX--X%%XXXXXXXXXXXXXXXXXXXXXXXXXXXXXXXXXXXXXXXXXXXX-XXXXXXXXXXXXXXXXXXXXXXXXXXXXXXXXXXXXXXXXXXXXXXXXXXXXXXXXXXXXXXXXXXXXXXXXXXXXXXX-XXXXXXXXXXXXXXX-XXXXXXXXXXXXXXXX
XXXXXXXXXXXXXXXXXXX---XXXXXXXX--XXXXXXXXXXXXXXXXXXXXXXXXXXXXXXXXXXXXXXXXXXXXXXXXXXXXXXXXXXXXXXXXXXXXXXXXXXXXXXXXXXXXXXXXXXXXXXXXXXXXXXXXXXXXXXXXXXXXXXXXXXXXXXX-XXXXXXXXXXXXXXX-XXXXXXXXXXXXXXXX
