------------------------------------------------------------------------------------------------------------------------------------------------------------------------------------------------
------------------------------------------------------------------------------------------------------------------------------------------------------------------------------------------------
------------------------------------------------------------------------------------------------------------------------------------------------------------------------------------------------
------------------------------------------------SSSS------------------------------------------------------------SS--------------------------------------------------------------SSSSSSSSSSSSSSSS
------------------------------------------------------------------------------------------------------------------------------------------------------------------------------------------------
-------------------------------------------------------------------------------------------------------ooo--------------------------------------------------------------------------------------
--------%%%%%%%%---------------oSSS---SSo----SSS--------------------------------------ooo------o---------------------------------------------------------------------QQSSSSSSSSS----------------
---------||||||----------------------------------------------------------------------------------#-------------o-#------------------------------------------------------------------------------
---------||||||-----------------------------------------------------------------------------------------------#-S#------------------------------------------------------------------------------
---------||||||-----------------oo--------------------------------------------------------------------------#-#-----------------------------------------------#---------------------------------
------%%%%%%%%%%######----------S-----------SoS--------tt----o----------------------------------------------#-#---------------------------------------------###--------------o------------#-----
-------||||||||---#------------------------------------tt------------------------------------------------####-#---------------------------------------------###---------------------------#-----
-------||||||||----------------------------------------tt---------------TT---TT------tt------------------######-------tt--------------------------#-----TT-####-------------------B------##-----
-------||||||||----k-----------g-----kk---------ggg----tt--ggk----g-----TT---TT------tt-----kk----g------######-------tt----k-------g-g-----k-----g-----TT-####----k--------k-----b-----###---#-
XXXXXXXXXXXXXXXXXXXXXXXXXXXXXXXXXXXXXXXXXXXXXXXXXXXXXXXXXXXXXXXXXXXXXXXXXXXXXXXXXXXXXXXXXXXXXXXXXXXXXXXXXXXXXXXXXXXXXXXXXXXXXXXXXXXXXXXXXXXXXXXXXXXXXXXXXXXXXXXXXXXXXXXXXXXXXXXXXXXXXXXXXXXXXXXX
XXXXXXXXXXXXXXXXXXXXXXXXXXXXXXXXXXXXXXXXXXXXXXXXXXXXXXXXXXXXXXXXXXXXXXXXXXXXXXXXXXXXXXXXXXXXXXXXXXXXXXXXXXXXXXXXXXXXXXXXXXXXXXXXXXXXXXXXXXXXXXXXXXXXXXXXXXXXXXXXXXXXXXXXXXXXXXXXXXXXXXXXXXXXXXXX
