------------------------------------------------------------------------------------------------------------------------------------------------------------------------------------------------
------------------------------------------------------------------------------------------------------------------------------------------------------------------------------------------------
----------------o-------------------------------------------------------------------------------------------------------------------------------------------------------------------------------
----------------SSSSS-SSSSSSSSSS----------------------------------------------------------------------------------------------------------------------------------------------------------------
------------------------------------------------------------------------------------------------------------------------------------------------------------------------------------------------
---------------------------------------------------------------------------------------------------------------------------------------------------------------------------oooo-----------------
--------%%%%%%%%-----------------------SSS------------@-----------------------------------------------------------------------------------------------------------------------------------------
---------||||||---------------------------------------------------------------------------------------------------------------------------o-----------------------------------------------------
---------||||||-%%%%----------------------------------------------------------------------------------------------------------------------------------------------------------------------------
---------||||||--||-----------S-----------------------------------------------------------------------------------------------------------------------------------------------------------------
------%%%%%%%%%%-||-----------%%--SQ-SSSo------------------------------------------Q--------------SS------------------Q-----------------------------QQ-------T--------------------SSS-------TT--
-------||||||||--||-----------||------------##--------------TT-------------------------------------------------------------------------TT-------------------TT-----------TT-----------------TT--
-------||||||||--||-----------||------------##--------------TT--T---------------------------##-----------------------------------------TT-------------------TT-----------TT-----------------TT--
-------||||||||--||-----------||-ggg---ggg#-##---------ggk--TT-kT------g-k---------ggg-g-k--##---------kkk-------------g-g--g--k-------TT----------ggg-k----TT-------y-k-TT-------k-k---y-#-TT--
XXXXXXXXXXXXXXXX-X|X-----%%%%%||XXXXXXXXXXXXXXXXXXXXXXXXXXXXXXXXXXXXXXXXXXXXXXXXXXXXXXXXXXXXXXXXXXXXXXXXXXXXXXXXXXXXXXXXXXXXXXXXXXXXXXXXXXXXXXXXXXXXXXXXXXXXXXXXXXXXXXXXXXXXXXXXXXXXXXXXXXXXXXXX
XXXXXXXXXXXXXXXX-XXX------g||-||XXXXXXXXXXXXXXXXXXXXXXXXXXXXXXXXXXXXXXXXXXXXXXXXXXXXXXXXXXXXXXXXXXXXXXXXXXXXXXXXXXXXXXXXXXXXXXXXXXXXXXXXXXXXXXXXXXXXXXXXXXXXXXXXXXXXXXXXXXXXXXXXXXXXXXXXXXXXXXXX
