------------------------------------------------------------------------------------------------------------------------------------------------------------------------------------------------
------------------------------------------------------------------------------------------------------------------------------------------------------------------------------------------------
------------------------------------------------------------------------------------------------------------------------------------------------------------------------------------------------
------------------------------------------------SSSSSSSS----------------------------------------SSSSSSSSSSSS---SSSSSSSSSSSSSSSSS--------------------------------SSSSSSSSSSSS--------------------
-----------------------------------------------------------------------------------------------------------------S------------------------------------------------------------------------------
---------------------------------------------------------------------------------------------------------------------------------------------------------------o--------------------------------
--------%%%%%%%%-------------------------------o-------SS----------------------------------------------------------------------------------------------------------------------------oQoo------S
---------||||||-------------------------------------%%%%-----SS--------------------------------------------------------------------------------#------------------------------------------------
---------||||||--------------------------------------||---------------------------------------------------------------------------------------##------------------------------------------------
---------||||||--------------------------------------||---------S----------------------------------------------------------------------------###--------------#---------------------------------
------%%%%%%%%%%-------------------------------------||--------------------------------------------------------------------#----------------####----------#-###---------------------------------
-------||||||||--------------#-----------TT-----o---tt|----#---------------------------TT----------------------#---------###-----------t----####---------TT-#-#-----------------------tt--------
-------||||||||--------------##----------TT-----%--%tt|--#-#-#-------##------T---------TTT---TT------t---###---#-----t-#####--TT-------tt--#####---------TT####------t---TT---#-------tt--------
-------||||||||--------k-----##---gk-ggg-TT-----|--|-t|--###--------##t----#-#g---t----TTt---TT------t---###--##-----t######--#Tg------tt--#####---g-g---TT#####-----t---TT---g------ttt-----#--
XXXXXXXXXXXXXXXXXXXXXXXXXXXXXXXXXXXXXXXXXXXXXXXXX-X|XXXXXXXXXXXXXXXXXXXXXXXXXXXXXXXXXXXXXXXXXXXXXXXXXXXXXXXXX-XXXXXXXXXXXXXXXXXXXXXXXXXXXXXXXXXXXXXXXXXXXXXXXXXXXXXXXXXXXXXXXXXXXXXXXXXXXXXXXXXX
XXXXXXXXXXXXXXXXXXXXXXXXXXXXXXXXXXXXXXXXXXXXXXXXX-X|XXXXXXXXXXXXXXXXXXXXXXXXXXXXXXXXXXXXXXXXXXXXXXXXXXXXXXXXXXXXXXXXXXXXXXXXXXXXXXXXXXXXXXXXXXX-XXXXXXXXXXXXXXXXXXXXXXXXXXXXXXXXXXXXXXXXXXXXXXXX
