------------------------------------------------------------------------------------------------------------------------------------------------------------------------------------------------
------------------------------------------------------------------------------------------------------------------------------------------------------------------------------------------------
------------------------------------------------------------------------------------------------------------------------------------------------------------------------------------------------
--------------------------------SSS---------------------------------------------SSSSSSSS-------------------------SSSSSSS------------------------SSSSSSSSS-----------------------SSSSSSSSS-------
------------------------------------------------------------------------------------------------------------------------------------------------------------------------------------------------
------------------------------------------------------------------------------------------------------------------------------------------------------------------------------------------------
--------%%%%%%%%---------o---------------------------------------oo-----------------------------oooo----oo----SSooo----SSo-------o------------------------------SooSSSSSoS---SSS----------------
---------||||||------------------------------------------------------------------o--------------------------------------------------------------------------------------------------------------
---------||||||---------------------------------------------------------------------------------------------------------------------------------------------------------------------------------
---------||||||--------------------------------------------------o------------------------------ooo------------------------------oo-----------------------------oo------------------------------
------%%%%%%%%%%-------------------------------------2--------------------------------------------------------------------------------------oo-------------------S-----------oS-----------------
-------||||||||------------------------tt---------------------------------#-#---------K------------------------------#---------------------##---------------------------------------------------
-------||||||||------------------------tt----------------TT---TT---------##-------------TT----TT---------------------#---------------------##--------tt-------TT---------------------tt---------
-------||||||||----kgkk-----k-k--------tt--kkk----g----k-TT---TT---ggggg###-------k-----TT----TT-----kog-------------#------k-----ggg--k--###--------tt--g----TT---kokk---k-k--------tt---------
XXXXXXXXXXXXXXXXXXXXXXXXXXXXXXXXXXXXXXXXXXXXXXXXXXXXXXXXXXXXXXXXXXXXXXXXXXXXXXXXXXXXXXXXXXXXXXXXXXXXXXXXXXXXXXXXXXXXXXXXXXXXXXXXXXXXXXXXXXXXXXXXXXXXXXXXXXXXXXXXXXXXXXXXXXXXXXXXXXXXXXXXXXXXXXXX
XXXXXXXXXXXXXXXXXXXXXXXXXXXXXXXXXXXXXXXXXXXXXXXXXXXXXXXXXXXXXXXXXXXXXXXXXXXXXXXXXXXXXXXXXXXXXXXXXXXXXXXXXXXXXXXXXXXXXXXXXXXXXXXXXXXXXXXXXXXXXXXXXXXXXXXXXXXXXXXXXXXXXXXXXXXXXXXXXXXXXXXXXXXXXXXX
