------------------------------S-----------------------------------------------------------------------------------------------------------------------------------------------------------------
------------------------------------------------------------------------------------------------------------------------------------------------------------------------------------------------
------------------------------------------------------------------------------------------------------------------------------------------------------------------------------------------------
-------------------------------------------------#--------------SSSSSSSSS---------------------------------------SSSSSSSSS-------SSSSSSSSS-----------------------SSSSSS----------SSSSSSSSSSS-----
-------------------------------------------------------------------------------------------------------------------------------------------------------o-o--------------------------------------
------------------------------------------------------------------------------------------------------------------------------------------------------------------------------------------------
--------%%%%%%%%------SSoS----S-------SSS-------------------------------SS--------------------------QSSSSS---SSS--------------------------------S-@QQSSSSS---S----------------------------------
---------||||||----------------------------------o-----------------%%---------------------------------------------------------------------------------------------------------------------------
---------||||||----------------------------------------------------||---------------TT----------------------------------------------------------------------------------------------------------
---------||||||----------------------------------------------------||---------------TT----------------------------------------------------------------------------------------------------------
------%%%%%%%%%%-----o-------o---------------U---------------------||---------------##-------o---------------U----------------------------#-----QSQQSSSSSS---USS--------------------------------
-------||||||||------------------------------------------TT--------||---------------------------------------------------------------------#------------------------------------------tt---------
-------||||||||------------------------------------------TT----@---||----------------------------------------------------##--------------##------------------------------------------tt---------
-------||||||||------kk-----k-----gggg-------------------TT----#---||-g-------gg-------k------k--------------------------##---##----k----##---k----k------k----------k--------k------tt-------g-
XXXXXXXXXXXXXXXXXXXXXXXXXXXXXXXXXXXXXXXXXXXXXXXXXXXXXXXXXXXXXXXXXXXXXXXXXXXXXXXXXXXXXXXXXXXXXXXXXXXXXXXXXXXXXXXXXXXXXXXXXXXXX-XXXXXXXXXXXXXXXXXXXXXXXXXXXXX-XXXXXXXXXXXXXXXXXXXXXXXXXXXXXXXXXXXX
XXXXXXXXXXXXXXXXXXXXXXXXXXXXXXXXXXXXXXXXXXXXXXXXXXXXXXXXXXXXXXXXXXXXXXXXXXXXXXXXXXXXXXXXXXXXXXXXXXXXXXXXXXXXXXXXXXXXXXXXXXXXX-XXXXXXXXXXXXXXXXXXXXXXXXXXXXX-XXXXXXXXXXXXXXXXXXXXXXXXXXXXXXXXXXXX
