------------------------------------------------------------------------------------------------------------------------------------------------------------------------------------------------
------------------------------------------------------------------------------------------------------------------------------------------------------------------------------------------------
------------------------------------------------------------------------------------------------------------------------------------------------------------------------------------------------
-------------------------------------------------------------------------------------------------S------------------------S-----SSS------------------------------S------------------------------
------------------------------------------------------------------------------------------------------------------------------------------------------------------------------------------------
----------------------------oo------------------------------------------------------------------------------------------------------------------------------------------------------------------
--------%%%%%%%%---------------------------------oo---SSSo-----o----------------------SS-------S------------------------------------------------Q---QSQSSS---SSS-----------------Soo-----------o
---------||||||--------------------------------#-----------------------------------------------------------------------------------------------o------------------------------------------------
---------||||||------------------------------------------------------------------------------------------------------------------------------------------------------------------------------ooo
---------||||||------------o---------------------------------------------------------------------------------------------------------------------------o------------------------o---------------
------%%%%%%%%%%------SS%%%S------------------#--------------------------------------------------------tt---##----------------------------------Q-QQQ-SSQ----U-------------------------------S--
-------||||||||----------|---o----------------#--------------------------B----------------#------------tt---##-----------TT------------#------#-------------------------------------------------
-------||||||||----------|---%---------------##-----tt-------------------B---------------##------------tt--####----------TT------------#-----##-------------------B-----TT---K-----------##-----
-------||||||||----------|---|----g---------g##g----tt-------------------b----g-----gy---##-----g------tt--####---kk-kgg-TT---ko-------#---####----k--------------b-----TT---gg----k-k-g-##-----
XXXXXXXXXXXXXXXX--%%%%---|---|--XXXXXXXXXXXXXXXXXXXXXXXXXXXXXXXXXXXXXXXXXXXXXXXXXXXXXXXXXXXXXXXXXXXXXXXXXXXXXXXXXXXXXXXXXXXXXXXXXXXXXXXXXXXXXXXXXXXXXXXXXXXXXXXXXXXXXXXXXXXXXXXXXXXXXXXXXXXXXXXX
XXXXXXXXXXXXXXXX---||----|---|--XXXXXXXXXXXXXXXXXXXXXXXXXXXXXXXXXXXXXXXXXXXXXXXXXXXXXXXXXXXXXXXXXXXXXXXXXXXXXXXXXXXXXXXXXXXXXXXXXXXXXXXXXXXXXXXXXXXXXXXXXXXXXXXXXXXXXXXXXXXXXXXXXXXXXXXXXXXXXXXX
