------------------------------------------------------------------------------------------------------------------------------------------------------------------------------------------------
------------------------------------------------------------------------------------------------------------------------------------------------------------------------------------------------
------------------------------------------------------------------------------------------------------------------------------------------------------------------------------------------------
-----------------S---SSS------------------------------------------------------------------------SSS---------------------------------------------------------------------------------------------
------------------------------------------------------------------------------------------------------------------------------------------------------------------------------------------------
--------------------------------------------------------------oo--------------------------------------------------------------------------------------------------------------------------------
--------%%%%%%%%---------------o------------------SSS--------SSS------o------------------------------------------------------------------------S----QQQQ-------------------------------SS------o
---------||||||----------------#----------------------------------------------------------------------------------------------------------------------------------------------------------------
---------||||||--------------###----------------------------------------------------------------------------------------------------------------------------------------------------------------
---------||||||------------#####------------------oog----------o-----------------------------------------------------------------------------------------------------------##-------------------
------%%%%%%%%%%-----------#####-----------------SSSSS-------SSS---------------------------------------------------------------------------------------tt-----------------#####-----------------
-------||||||||-----------######-------TT------o---------------------------------------Q---------------S----#------------TT------------------##--------tt-----------------###------------##-----
-------||||||||----------#######--TT---TT-----------------#----------------#---------------------------S---##------------TT-----------tt-----##--------tt----------------####-------tt---##-----
-------||||||||------k--########--TT---TT-------------gg--#---k---#--k-----g-----------------g-g-gy--------##-----kk-k--###-----------tt----####-------tt------------k--#####-#-----tt---##---o-
XXXXXXXXXXXXXXXXXXXXXXXXXXXXXXXXXXXXXXXXXXXXX---XXXXXXXXXXXXXXXXXXXXXXXXXXXXXXXXXXXXXXXXXXXXXXXXXXXXXXXXXXXXXXXXXXXXXXXXXXXXXXXXXXXXXXXXXXXXXXXXXXXXXXXXXXXXXXXXXXXXXXXXXXXXXXX-XXXXXXXXXXXXXXXX
XXXXXXXXXXXXXXXXXXXXXXXXXXXXXXX-XXXXXXXXXXXX----XXXXXXXXXXXXXXXXXXXXXXXXXXXXXXXXXXXXXXXXXXXXXXXXXXXXXXXXXXXXXXXXX-XXXXXXXXXXXXXXXXXXXXXXXXXXXXXXXXXXXXXXXXXXXXXXXXXXXXXXXXXXXXX-XXXXXXXXXXXXXXXX
