------------------------------------------------------------------------------------------------------------------------------------------------------------------------------------------------
------------------------------------------------------------------------------------------------------------------------------------------------------------------------------------------------
------------------------------------------------------------------------------------------------------------------------------------------------------------------------------------------------
------------------------------------------------SSSSSSSSSSSSSSSS--------SSSS----SSSSSSSS-------S----------------SSSS----------------------------SSSSSSSSSSSSSSSS----------------SSSSSSS---------
------------------------------------------------S-----------------------------------------------------------------------------------------------------------------------------------------------
------------------------------------------------------------------------------------------------------------------------------------------------------------------------------------------------
--------%%%%%%%%---------------------QQQQS-----o----------------oooo----oo---ooo--------------------QQQQQ------o------------------o------o------------------------------------------------------
---------||||||---------------------------------------------------------------------------------------------------------------------------------------------------------------------------------
---------||||||-----------------------------------------------------------------#---------------------------------------------------------------------------------------------------------------
---------||||||----------------o----------------------------------------------------------------------------------------------------------------------------------------------------------------
------%%%%%%%%%%---------------T-------------o-----------------------o--------------------------####o--------U---------------------------------------------------------------#------------------
-------||||||||-T--------b----TT-------------------------------------------------------t------T-------------------------t-------------------------------TT-------------------##--------tt-------
-------||||||||-T-------TT----TT---------------------t---K---TTT-----t---##-----------ttt----TTT-----------------------ttt-----------t------------B-----TT---TT-----------#--##--------tt-----T-
-------||||||||-T---ggk-TT--k-TT--kk-kgg----k--------tt--#---TTT----tt--###-----------ttt----TTT---k--------k---T------ttt---##-----tt----k-----k-b----kTT---TT-----------#--##-g-g----tt-----#-
XXXXXXXXXXXXXXXXXXXXXXXXXXXXXXXXXXXXXXXXXXXXXXXXXXXXXXXXXXXXXXXXXXXXXXXXXXXXXXXXXXXXXXXXXXXXXXXXXXXXXXXXXXXXXXXXXXXXXXXX%XXXXXXXXXXXXXXXXXXXXXXXXXXXXXXXXXXXXXXXXXXXXXXXXXXXXXXXXXXXXXXXXXXXXXXX
XXXXXXXXXXXXXXXXXXXXXXXXXXXXXXXXXXXXXXXXXXXXXXXXXXXXXXXXXXXXXXXXXXXXXXXXXXXXXXXXXXXXXXXXXXXXXXXXXXXXXXXXXXXXXXXXXXXXXXXXXXXXXXXXXXXXXXXXXXXXXXXXXXXXXXXXXXXXXXXXXXXXXXXXXXXXXXXXXXXXXXXXXXXXXXXX
