------------------------------------------------------------------------------------------------------------------------------------------------------------------------------------------------
------------------------------------------------------------------------------------------------------------------------------------------------------------------------------------------------
------------------------------------------------------------------------------------------------------------------------------------------------------------------------------------------------
---------------------------------SSSSSSSS-------SSSSSSSSSSS---------------------SSSSSSS---------SSSSSSSS------------------------------------------------------------------------SSSS---S--------
-------------------------------------------------------------------------------------------------------------------------------------------------------------------------------o----------------
------------------------------------------------------------------------------------------------------------------------------------------------------------------------------------------------
--------%%%%%%%%------SSS-------ooo-----oo-----S-oo-----------------------------------oo---------o--------------------------------------------------------------oooo-----o-----S-------------SSS
---------||||||---------------------------------------------------------------------------------------------------------------------------------------------------------------------------------
---------||||||---------------------------------------------------------------------------------------------------------------------------------------------------------------------------------
---------||||||-----------------ooo-------------ooo----------------------------------------------ooo-------------ooo---------------------------------------------o------------------------------
------%%%%%%%%%%--------------------------##------------------------------------------tt------------------#------------------------------------------------------------------------SSS------#---
-------||||||||--------------------------###----------------------------------K-------tt------------------#---------------#--------------TT---------------#---------------#---------------#-#-#-
-------||||||||----------#---------------###-------------TT---------------------------tt-----------------##---------------#--------------TT--------------##--------------##---------------#-#-##
-------||||||||------g---#-----------k-g####k--------g---TT--------k--------kkk-------tt----gk-------kgg-##---------gggg-##--------------TT--g-------k---##----------g-g###-k-------ggg---#-#-##
XXXXXXXXXXXXXXXXXXXXXXXXXXXXXXXXXXXXXXXXXXXXXXXXXXXXXXXXXXXXXXXXXXXXXXXXXXXXXXXXXXXXXXXXXXXXXXXXXXXXXXXXXXXXX-XXXXXXXXXXXXXXXXXXXXXXXXXXXXXXXXXXXXXXXXXXXXXXXXXXXXXXXXXXXXXXXXXXXXXXXXXXXXXXXXXX
XXXXXXXXXXXXXXXXXXXXXXXXXXXXXXXXXXXXXXXXXXXXXXXXXXXXXXXXXXXXXXXXXXXXXXXXXXXXXXXXXXXXXXXXXXXXXXXXXXXXXXXXXXXXX-XXXXXXXXXXXXXXXXXXXXXXXXXXXXXXXXXXXXXXXXXXXXXXXXXXXXXXXXXXXXXXXXXXXXXXXXXXXXXXXXXX
