------------------------------------------------------------------------------------------------------------------------------------------------------------------------------------------------
------------------------------------------------------------------------------------------------------------------------------------------------------------------------------------------------
------------------------------------------------------------------------------------------------------------------------------------------------------------------------------------------------
------------------------------------------------------------------------------------------------------------------------------------------------------------------------------------------------
-----------------------------------g---------------k-------------------------------k------------------------------------------------------------------------------------------------------------
-----------------------------------#--------------##--------------------------o---------------------------------------------------------------------------------------------------------------o-
--------%%%%%%%%S---------o---SS----------------------------------------------------------------------------------------------------------------%%%--------------------------------SSSS---------
---------||||||---------------------------oo--------------o------------o-------------------------------------------oo-------------%%%%%----------|----------------------------------------------
---------||||||---------------------------------------------------------------------------U----------------------------------------|||-----------|----------------------------------------------
---------||||||--------------------------------------------------------------------------------------------------------------------|||-----------|----------------------------------------------
------%%%%%%%%%%------QQ-o--------------------------------------------------------------------------------------TT-------TT--------|||-S----TT---|TT--------TT--------------------SSSS------TT--
-------||||||||---TT-----------------------------------------------------TT-----------------TT------------------TT-------TT---TT---|||------TT---TTT-----TT-TT--------------TT--------------TT--
-------||||||||---TT-------------------TT-----#---------------T---TT-----TT-----------------TT------------------TT-------TT---TT---|||------TT---TTTT----TT-TT---------TT---TT--------------TT--
-------||||||||--kTT-------------------TT--k--#-----------k---T---TT--gg-TT----k--ggg---g---TT----gg---k--------TT---y---TT---TT---|||-ggk--TT---TTTT--k-TT-TT-k-ggg---TT-k-TT-----gk--k----TT--
XXXXXXXXXXXXXXXXXXXXXXXX----XXXXXXXXXXXXXXXXXXXXXXXXXXXXXXXXXXXX-XXXXXXXXXXXXXXXXXXXXXXXXXXXXXXXXXXXXXXXXXXXXXXXXXXXXXXXXXXXXXXXXXXXXXXXXXXXXXXXXXXXXXXXXXXXXXXXXXXXXXXXXXXXXXXXXXXXXXXXXXXXXXXX
XXXXXXXXXXXXXXXXXXXXXXXXX---XXXXXXXXXXXXXXXXXXXXXXXXXXXXXXXXXXXXXXXXXXXXXXXXXXXXXXXXXXXXXXXXXXXXXXXXXXXXXXXXXXXXXXXXXXXXXXXXXXXXXXXXXXXXXXXXXXXXXXXXXXXXXXXXXXXXXXXXXXXXXXXXXXXXXXXXXXXXXXXXXXXX
