------------------------------------------------------------------------------------------------------------------------------------------------------------------------------------------------
------------------------------------------------------------------------------------------------------------------------------------------------------------------------------------------------
------------------------------------------------------------------------------------------------------------------------------------------------------------------------------------------------
--------------------------------------------------SS----------------------------SSSSSSSSSSSS-S----------------------------------SSSSSSSSSSSS----------------------------------------------------
------------------------------------------------------------------------------------------------------------------------------------------------------------------------------------------------
------------------------oo---------------------------------------------------------------------------------oo---------------------------------------------------------------o-------------------
--------%%%%%%%%--------------------QSQQo-------------------------------oo----SS-----------------------o-------------------------oo-----o------S------------------------------------------------
---------||||||----------------------------------------------------------------------------------------------------------------------------------#----------------------------------------------
---------||||||---------------------------------------------------------------------------------------------------------------------------------------------------------------------------------
---------||||||------------------o----------------------------------------------------------------------------------------------oo--------------------------------------------------------------
------%%%%%%%%%%--TT----------------Q--------------------------------o---------------------------------------------------TT---------------#-#---------------------------------------------------
-------||||||||---TT----TT-----------------------------------------------------------tt----------------------------------TT--------------##-#--------------------------tt----#----------TT------
-------||||||||---TT----TT-------------------#---------------------------------------tt---------------tt-----#----B------TT--------------##----------tt----------------tt----#----B-----TT------
-------||||||||---TT----TT------------g------#-------k---------#----k-k-----k--------tt--#----g-------tt-----#----b------TT---g------k--###-------#--tt----------------tt----#----b-----TT----#-
XXXXXXXXXXXXXXXXXXXX--XXXXXXXXXXXXXXXXXXXXXXXXXXXXXXXXXXXXXXXXXXXXXXXXXXXXXXXXXXXXXXXXXXXXXXXXXXXXXXXXXXXXXXXXXXXXXXXXXXXXXXXXXXXXXXXXXXXXXXXXXXXXXXXXXXXXXXXXXXXXXXXXXXXXXXXXXXXXXXXXXXXXXXXXXX
XXXXXXXXXXXXXXXXXXXXXXXXXXXXXX-XXXXXXXXXXXXXXXXXXXXXXXXXXXXXXXXXXXXXXXXXXXXXXXXXXXXXXXXXXXXXXXXXXXXXXXXXXXXXXXXXXXXXXXXXXXXXXXXXXXXXXXXXXXXXXXXXXXXXXXXXXXXXXXXXXXXXXXXXXXXXXXX-XXXXXXXXXXXXXXXX
