------------------------------------------------------------------------------------------------------------------------------------------------------------------------------------------------
------------------------------------------------------------------------------------------------------------------------------------------------------------------------------------------------
------------------------------------------------------------------------------------------------------------------------------------------------------------------------------------------------
--------------------------------SSSSSSSSSSS-----SSSSSSSSSSS-------------------------------------SSSSSSSSS-------SSSSSSSSS-----------------------SSSSSSS---------SSSSSSSSSSSSSSSS-----SSSSSS-----
----------------------------------------------------------------------------------------------------------------SS------------------------------------------------------------------------------
-----------------------------------------------------------------------------------------------------------------S------------------------------------------------------------------------------
--------%%%%%%%%-oo------------S---------------S------------------------oo-------ooSSSSSS----SSS----------------ooo-------------SSSSSSS--S---SSS-------------------------o------SSoSSSS------SSS
---------||||||--------------------------------------------------------------------------------------------------------o------------------------------------------------------------------------
---------||||||-------------------------------------------------------------------------------------------------------------------------------------------------S-------------------------------
---------||||||-ooo-------------------------------------------------------------------------------------------------------------oo----------------------------------------------ooooo---------oo
------%%%%%%%%%%------------------------------------------#---------------#-#-------S---------S---------------------------------SSSSS-------SSSS--------------------------------SSSSS---------SS
-------||||||||----------------------tt------------------##--------------##-#---------------------------------------tt-------------------------------------------------------------------##-----
-------||||||||----------------------tt--#---------------##---TT---------####----------------------------##---------tt-----------------------------------TT---TT------------------------###-----
-------||||||||-----gg----#---##-----tt--#----g------g-####---TT--------#####-#-----gg------------k------##---g-----tt---##g-------kggg---k-k------------TT---TT--------------g-------g####-----
XXXXXXXXXXXXXXXXXXXXXXXXXXXXXXXXXXXXXXXXXXXXXXXXXXXXXXXXXXXXXXXXXXXXXXXXXXXXXXXXXXXXXXXXXXXXXXXXXXXXXXXXXXXXXXXXXXXXXXXXXXXXXXXXXXXXXXXXXXXXXXXXXXXXXXXXXXXXXXXXXXXXXXXXXXXXXXXXXXXXXXXXXXX-XXXX
XXXXXXXXXXXXXXXXXXXXXXXXXXXXXXXXXXXXXXXXXXXXXXXXXXXXXXXXXXXXXXXXXXXXXXXXXXXXXXXXXXXXXXXXXXXXXXXXXXXXXXXXXXXXXXXXXXXXXXXXXXXXXXXXXXXXXXXXXXXXXXXXXXXXXXXXXXXXXXXXXXXXXXXXXXXXXXXXXXXXXXXXXXX-XXXX
