---------------------------------------------------------------------------------%%---------------------------------------------------------------------------------------------
-------------------------------------------------------------K-------------------||---------------------------------------------------------------------------------------------
--------------------------------------------------------------Q------------------||---------------------------------------------------------------------------------------------
--------------------SSSSSSSSSSSS-------------------------------------------------||---------------------------------------------------------------------------------------------
-----------S----SSSSSSS-SSSSSSS----------------------o----R---------------o------||--------------------------------------------------------------------------------K------------
------S---------SS--SSSSSSSSSSSS----------------%%----------------------U--------||----------------------------------k----------------------------------------------------------
-----SSSSS----SS----SSSSSSSSSSSS------U---------||--------------------SSS--------||--------------------------------SSSS-SS-----------------------S----S-------------------------
-----S-S---S----------------SSS----%%%%%--------||-------------------------------||---------------------------------------------------------------------------------------------
---SS----SSSSS--------------------U-|||---------||-------------------------------||--------------------------------------------------------------------------------------S------
--SSSSSoSSS-SSS----ooooo---ooooS----|||---------||-go--og----gg------------------||--------------------------------o--------------------SSS------------------------------SS-----
----SSSSSS---SSS-SSSSSS---SSSSS%----|||---------||-Q----2------------------------||---------------S---------------SS--------------SS-----S--------------------------------------
-------S-----------------------|----|||-----TT--||-----------#-----------------T-||------TT---------TT--------------K------------------------------------TT----T-------TT-------
------SSSSSS-------------SS-SSSS----|||-----TT--||----------##-----------------T-||------TT----T----TT----------------------##------------------T--------TT----T-------TT-------
-----------------------k------------|||k-T--TT-k|g------gk-###-------y---k-----T-||----k-TT----T----TT-kkk--------K---------##----------y-k--k--T---ggg-kTT----T--K----TT-------
-------SSS-----X------XXXXXXXXXXXXXXXXXXXXXXXXXXXXX-----XXXXXXXXXXXXXXXXXXXXXXXXXXXXXXXXXXXXXXXXXXXXXXXXXXXXXXXXXXXXXXXXXXXXXXXXXXXXXXXXXXXXXXXXXXXXXXXXXXXXXXXXXXXXXXXXXXXXXXXX
g--------------X------XXXXXXXXXXXXXXXXXXXXXXXXXXXXX----XXXXXXXXXXXXXXXXXXXXXXXXXXXXXXXXXXXXXXXXXXXXXXXXXXXXXXXXXXXXXXXXXXXXXXXXXXXXXXXXXXXXXXXXXXXXXXXXXXXXXXXXXXXXXXXXXXXXXXXXX
