----------------------------------------------------------------------------------------------------------%-------------------------------------------------------------------------------------
----------------------------------------------------------------------------------------------------------|-------------------------------------------------------------------------------------
----------------------------------------------------------------------------------------------------------|-------------------------------------------------------------------------------------
----------------------------------------------------------------------------------------------------------|-------------------------------------------------------------------------------------
-----------------------------------k----------------------------------------------------------------------|-------------------------------------------------------------------------------------
----------------------------------##--------------##------------------------------------------------------|------------------------#------------------------------------------------------------
--------%%%%%%%%---------------Q-----------------------------------------------o%%--------------SS--------|----o-------------------------------o-------------------------------oSSSSS-----------
---------||||||-------------------------------------#---------------------------||------------------------|--------------S----------------o---------oo-------------------oo---------------------
---------||||||-----------------------------------------------------------------||------------------------|-------------SS----------------------------------------------------------------------
---------||||||--------------------------SS-------------------------------------||------------------------|-------------SSSS--------------------------------------------------------------------
------%%%%%%%%%%--2-------------------------------S----------------QQ-----------||------------------------|-------------------#-----------------TT---------------------------------------TT-----
-------||||||||-----tt--------------tt--------#-----tt-------------------------T||TT----------------------|------------TT-----#----------------TTT----tt------------tt-------------------TT-----
-------||||||||-----tt--------------tt-TT-----#-----tt-------------------------T||TT----------------------|---------tt-TT-----#---------------TTTT----tt-TT---------tt-TT----------------TT-----
-------||||||||-g---tt--y-----------tt-TT---#-#-----tt--y-k----------gg--------T||TT-----------g----y-----|----g----tt-TT----k#---------------TTTT----tt--T----g----tt-TT------------y--kTT----g
XXXXXXXXXXXXXXXXXXXXXXXXXXXXXXXXXXXXXXXXXXXXXXXXXXXXXXXXXXXXXXXXXXXXXXXXXXXXXXXXXXXXXXXXXXXXXXXXXXXXXXXXXXXXXXXXXXXXXXXXXXXXXXXXXXXXXXXXXXXXXXXXXXXXXXXXXXXXXXXXXXXXXXXXXXXXXXXXXXXXXXXXXXXXXXXX
XXXXXXXXXXXXXXXXXXXXXXXXXXXXXXXXXXXXXXXXXXXXXXXXXXXXXXXXXXXXXXXXXXXXXXXXXXXXXXXXXXXXXXXXXXXXXXXXXXXXXXXXXXXXXXXXXXXXXXXXXXXXXXXXXXXXXXXXXXXXXXXXXXXXXXXXXXXXXXXXXXXXXXXXXXXXXXXXXXXXXXXXXXXXXXXX
