------------------------------------------------------------------------------------------------------------------------------------------------------------------------------------------------
------------------------------------------------------------------------------------------------------------------------------------------------------------------------------------------------
------------------------------------------------------------------------------------------------------------------------------------------------------------------------------------------------
----------------S-------------------------------SSSSSSSSS-------SSSSSSSSSS----------------------SSSSSSSSSSS-----SSSSSSSSSSSSSSSS--------------------------------SSSSSSSSSSSSSSSSSSSSSSSSSSSSSSSS
----------------------------------------------------------------------------------------------------------------SS-------------S------------------------------o---------------------------------
----------------------------------------------------------------------------------------------------------------SS-------------S----------------------------------------------------------------
--------%%%%%%%%--------------------QQSSSS-----------------------------SSS-----------SSSSS---------------------------------S--SS-ooS-----------S--SS@S@SSSS--S@S-o----------------------------SS
---------||||||-S--%%%%%------------------------------------------------------------------------------------------------------------------------------------------------------------------------
---------||||||-----|||---------------------------------------------------------------------------------------------------------------------------------------o---------------------------------
---------||||||-----|||------------------------------------------------------------------------------------#------------------------------------------------------------------------------------
------%%%%%%%%%%----|||----------------------@S-----------------------------------------------------------###--------------------------------SSo----QQ-------US---------------------------#####-
-------||||||||-o---|||-----------------------------------------------------------------------------------###----------------------------------------------------------------------------#######
-------||||||||-%---|||------#-----------------------------------------------------------------------tt--####-----------------#-----------------------------------------------TT---------#######
-------||||||||-|---||k------#----gggg----------%%k----k------g-----------#---------ggg--------------tt-#####----------k-g---##----gggg---k--------k-kk-----k------------g----TT--------########
XXXXXXXXXXXXXXXXX-X-XXXXXXXXXXXXXXXXXXXXXXXXXXXXXXXXXXXXXXXXXXXXXXXXXXXXXXXXXXXXXXXXXXXXXXXXXXXXXXXXXXXXXXXXXXXXXXXXXXXXXXXXXXXXXXXXXXXXXXXXXXXXXXXXXXXXXXXXXXXXXXXXXXXXXXXXXXXXXXXXXXXXXXXXXXXX
XXXXXXXXXXXXXXXXX-X-XXXXXXXXXXX-XXXXXXXXXXXXXXXXXXXXXXXXXXXXXXXXXXXXXXXXXXXXXXXXXXXXXXXXXXXXXXXXXXXXXXXXXXXXXXXXXXXXXXXXXXXXXXXXXXXXXXXXXXXXXXXXXXXXXXXXXXXXXXXXXXXXXXXXXXXXXXXXXXXXXXXXXXXXXXXX
