------------------------------------------------------------------------------------------------------------------------------------------------------------------------------------------------
------------------------------------------------------------------------------------------------------------------------------------------------------------------------------------------------
------------------------------------------------------------------------------------------------------------------------------------------------------------------------------------------------
------------------------------------------------------------------------------------------------------------------------------------------------------------------------------------------------
------------------------------------------------------------------------------------------------------------------------------------------------------------------------------------------------
---------------------------------------------------------oo-------------------------------------------------------------------------------------------------------------------------------------
--------%%%%%%%%-----SSS--------------------------------------------Q---------------------------oo------oo--------o------o----o---------QS----------------------oooo--Sooo---SoS----S-----------
---------||||||------------------------o---------#------------oo-------------------------------o------------------------------------------------------------------------------------------------
---------||||||---------------------------------------------------------------o------------------------------------------------------o-------oo-------------------------------------------------
---------||||||----------------------------------------------------------------------------------------------------------------------------------------------------------------o----------------
------%%%%%%%%%%-------------------------------------------------------------US------------------------------------------##----------S@----SS@S-----------------S----o-------US-----S--------USo
-------||||||||----------------------------------------------------------------------------------------------------------##------------------------------TT-------------------------------------
-------||||||||-------------------------------------------------------------------------TT---------------##-------------###------------------------------TT-------------------------------------
-------||||||||----kgg---------g--#---------------g----g----kk----gggggg--k-k-----k-----TT----##---------##-k-------k--####--------k------k-k-----k--gg--TT---##-----yo-#-----------ggg---g---k-
XXXXXXXXXXXXXXXXXXXXXXXXXXXXXXXXXXXXXXXXXXXXXXXXXXXXXXXXXXXXXXXXXXXXXXXXXXXXXXXXXXXXXXXXXXXXXXXXXXXXXXXXXXXXXXXXXXXXXXXXXXXXXXXXXXXXXXXXXXXXXXXXXXXXXXXXXXXXXXXXXXXXXXXXXXXXXXXXXXXXXXXXXXXXXXXX
XXXXXXXXXXXXXXXXXXXXXXXXXXXXXXXXXXXXXXXXXXXXXXXXXXXXXXXXXXXXXXXXXXXXXXXXXXXXXXXXXXXXXXXXXXXXXXXXXXXXXXXXXXXXXXXXXXXXXXXXXXXXXXXXXXXXXXXXXXXXXXXXXXXXXXXXXXXXXXXXXXXXXXXXXXXXXXXXXXXXXXXXXXXXXXXX
