------------------------------------------------------------------------------------------------------------------------------------------------------------------------------------------------
------------------------------------------------------------------------------------------------------------------------------------------------------------------------------------------------
------------------------------------------------------------------------------------------------------------------------------------------------------------------------------------------------
------------------------------------------------SSSSSSSS----------------------------------------SS----------------------------------------------------------------------------------------------
------------------------------------------------------------------------------------------------------------------------------------------------------------------------------------------------
---------------------------------------------------------------------------------------------------------------------------ooo---------------------------------o--------------------------------
--------%%%%%%%%------------------------------------SSS----------ooo-----------------------------SSS---------o------------------------------%%%-----QQ---------S--------------------------------
---------||||||----------------------------------------------------------------------------------------------------------------#-------------|--------------------------------------------------
---------||||||-------------------------------##-------------------------------------------------------------SS---------------##-------------|-----------------------------------------TT-------
---------||||||-----#-----------------------####-------------------------------------------------------------S----------------##-------o-oooo|-----------------------------------------TT-------
------%%%%%%%%%%--#------------------------#####----S-------------------------------------------S------------SS---------------##%------%%%%%%|-----------------------------------------TT-------
-------||||||||----------------------------#####-----------------------------------------------------------------------------###|-------||||-|-----------------------------------------TT-------
-------||||||||--------#-----#--#---------######---------TT-----------------------------------------------------------------####|-------||||-|----------------------------------TT-----TT-------
-------||||||||-##-----#-----#--#----k----######-----ggk-TT-k-------------------------------kkk------k----------------------#-##|-------||||-|----gy------k-k--------------kg---TT-----TT--kk---
XXXXXXXXXXXXXXXXXXX-XXXXXXXXXXXXXXXXXXXXXXXXXXXXXXXXXXXXXXXXXXXX--XXXXXXXXXXXXXXXXXXXXXXXXXXXXXXX-XXXXXXXXXXXXXXXXXXXXXXXXXXXXXX|%%%%%%%%|||-%%%XXXXXXXXXXXXXXXXXXXXXXXXXXXXXXXXXXXXXXXXXXXXXXXX
XXXXXXXXXXXXXXXXXXX--XXXXXXXXXXXXXXXXXXXXXXXXXXXXXXXXXXXXXXXXXXX--XXXXXXXXXXXXXXXXXXXXXXXXXXXXXX--XXXXXXXXXXXXXXXXXXXXXXXXXXXXXX|-||||||-|||--|-XXXXXXXXXXXXXXXXXXXXXXXXXXXXXXXXXXXXXXXXXXXXXXXX
