----------------------------------------------------------------------------------------------------------------------------------------------------------------
----------------------------------------------------------------------------------------------------------------------------------------------------------------
----------------------------------------------------------------------------------------------------------------------------------------------------------------
-------------------SSSSSSSSSSSSSSSSSSSSSSSSSSSSS----------------------------------------------------------------------------------------------------------------
---------------------SS------S--SSSSSS--------K-----------------------------------------------------------------------------------------------------------------
---------------------SS-----SSS-SSSSSS----------------------------------------------------------------------------------------------------------------o---------
--###-----------------------SS--------------------------------------------------------r-------------------------SS--------------------U-------------------------
----------------------------SS------------------------------------------------------%%%%--------SSS-----------------------------%%------------------------------
-------------------------------------------------------------------------------------||---------S--------------------#----------||------------------------------
------------------o-------S-o---S--SSS---------S-------------------------------------||-----------------------------##----------||------------------------------
-------#------T-SSS-------SSSSS-----SSS----------------------------------------------||---------#---TT---TT--------###---TT-----|Q-----S@S----------------------
--------------T---------------------SSS--------#-----------------K----------------TT-||-------------TT---TT-------#-#----TT-----|-----------TT--#---TT---------T
--------------T-----TT----------SSSSS-S-SSS----#-------TT-------------------------TT-||---------#---TT---TT------##-#----TT-----|-----------TT------TT---TT----T
--k-----------T-----TT---y---------------------#-------TT---------K---------------TT-||g-g------#---TT---TT-----###-###--TT-----|gggg----gg-TT-k#---TT---TT----T
XXXXXXXXXXXXXXXXX---XXXXXXXXX-XX--%------------XXXXXXXXXXXXXXXXXXXXXXXXXXXXXXXXXXXXXXXXXXXXXXXXXXXXXXXXXXXXXXXXXXXXXXXXXXXXXXXXX|XXXXXXXXXXXXXXXXXX-XXXXXXXXXXXX
XXXXXXXXXXXXXXXXX---XXXXXXXXXXXXg-|------------XXXXXXXXXXXXXXXXXXXXXXXXXXXXXXXXXXXXXXXXXXXXXXXXXXXXXXXXXXXXXXXXXXXXXXXXXXXXXXXXXXXXXXXXXXXXXXXXXXXX-XXXXXXXXXXXX
