--------------------------------------------------------------------------------------------------------S------------------------------S--------------------------------------------------------
-----------------------------------------------------------------------------------------------------SSSSS--------------------------------------------------------------------------------------
------------------------------------------------------------------------------------------------------------------------------------------------------------------------------------------------
------------------------------------------------SSSSSSSSSSSSSSSS-----------------------------------------------------------------------------------------------#--------------------------------
-------------------------------------------------------------------------------------------------------g----------------------------------------------------------------------------------------
---------------------------------------------------------------------------------------------g---------S--S-------------------------------------------------------------------------------------
--------%%%%%%%%o----------------------SoSS----S-----------#-------------------------SS------S---------S-------------------------------------------------------------------@S---------oSS-------
---------||||||-------------------------------------------##---------------------------------------------------------------------------o---------------------%%%--------------------------------
---------||||||-------------------------------------------##--------------%%----------------------------------------------------------------------------------|---------------------------------
---------||||||-------------------------------------------##--------------||-------------------o------------SSSS------------------------------------%%%%%-----|--------#------------------------
------%%%%%%%%%%-----------------------------o----------------------------||-----SSSSS---------S------U#S--------------------------------------------|||------|-------##----SS------------------
-------||||||||----------------------------------TT-------------TT--------||---------S---------------------------------------------------------------|||------|---------------------------------
-------||||||||----------------------------------TT---####------TT--------||--------SS-----------------------------------K--------------------%---o--|||-K----|---------------------------------
-------||||||||------k------k------------------#-TT---####------TT-------g||--------S-------k--------------------------------ooo--o-----------|-%%%%-|||-#----|----------------------kkk----k---
XXXXXXXXXXXXXXXXXXXXXXXXXXXXXXXX--XX--XXXXXXXXXXXXXXXXXXXXX-XXXXXX----XXXXXXXXXXXXXXXXXXX-XXXXXX--XX--------SS----XXX----S%--%%%X%XX---------%%%-||--|||%XXX%%%%--%%%%-----XXX-XXXXXXXXXXXXXXXXX
XXXXXXXXXXXXXXXXXXXXXXXXXXXXXXXX--XX--XXXXXXXXXXXXXXXXXXXXX-XXXXXX----XXXXXXXXXXXXXXXXXXX-XXXXXX--XX-----------X---XX-----|---|-X|XX----------|--||--||||XXX-||----||------X-X-XXXXXXXXXXXXXXXXX
