--------------------------------------------------------------------------------------------------------------------------------------------------------------S---------------------------------
-----------------K------------------------------------------------------------------------------------------------------------------------------------------------------------------------S-----
------------------------------------------------------------------------------------------------------------------------------------------------------------------------------------------------
---------------------------------#---------------#------------------------------------------------------------------------------SSSSSSSSSSSS--SS------------------------------------------------
-------------------------------------------------------------------------------------------------------------------------------------------------------------------------------o----------------
------------------------------------------------------------------------------------------------------------------------------------------------------------------------------------------------
--------%%%%%%%%--------------------------------------------------------------------------------------------------------------------------------oSoSSSSSSS---SSS-----2--------------------------
---------||||||--------------------------------o-o-------------#------------------------------------------------------TT---ooooo-----------#----------------------------------------------------
---------||||||-------------------------------#--------------###-----------------------K------------------------------TT-------------------#-SSS------------------------------------------------
---------||||||-------------------------------#-------------####------------------------------------------------------##--------------------------------------------------o--------------------o
------%%%%%%%%%%---------TT---S-----#--------##------------#####-----------------------2------------------%%%SS--------------------------#------S------------SSS---------S-----------S----------
-------||||||||----------TT-----------------###------------####--------------#--TT------------K------------|---------------------------###------------------------------------------------------
-------||||||||----------TT----------------####--------TT######--------#-----#--TT-------------------------|-------------------------#####-#----------------------------------------------------
-------||||||||------k---TT-----#------k---####--------TT######-k-----##-----#--TT---kkk----k-----g--------|-------r-----------------#####-#-k-------k----------------------oo------------kg----
XXXXXXXXXXXXXXXXXXXXXXX-XXXXXXXXXXXXXXXXXXXXXXXXXXXXXXXXXXXXXXX-XXXXXXXXXXXXXXXXXXXXXXXXXXXXXXXXXXXXXXXXXXXXXXXXXX%%%%%%-%%%----XXXXXXXXXXXXXXXXXXXXXXXXXXXXXXXX--XXXXXXXX------XXXXXXXXXXXXXXXX
XXXXXXXXXXXXXXXXXXXXXXX-XXXXXXXXXXXXXXXXXXXXXXXXXXXXXXXXXXXXXXX-XXXXXXXXXXXXXXXXXXXXXXXXXXXXXXXXXXXXXXXXXXXXXXXXX--||||---|-----XXXXXXXXXXXXXXXXXXXXXXXXXXXXXXXX--XXX-XXXX------XXXXXXXXXXXXXXXX
