---------------------------------------------------------SS-------------------------------------------------------------------------------------------------------------------------------------
---------------------------------------------------------SSS------------------------------------------------------------------------------------------------------------------------------------
------------------------------------------------------------------------------------------------------------------------------------------------------------------------------------------------
----------------------------------------------------------SSSSSS--------------------------------SSSSSSSS-SSS------------------------------------------------------------------------------------
---------------------------------------------------------------S--------------------------------------------------------------------------------------------------------------------------------
-----------------------------------------o---------------o--------------------------------------------------------------------------------------------------------------------------------------
--------%%%%%%%%----QQQQ------------------------------------------------------------QSQSQSS----------------------------------------------------------------------------S@SS----o------SSSS---SS-
---------||||||--------------------------------#-------------S-----------------------------------------------------------------------------------------------------------------#---------------o
---------||||||----------------------------------------------S----------------------------------------------------------------------------------------------------------------------------------
---------||||||-------------------------------------g-------------------------------------------------------------------------------------------------------------------------S-----------------
------%%%%%%%%%%-##---------S@S-TT-------TT--------SSSS--SS------------TT--------SS--SSSQ----USS--------------------------------###---#-----S----------##-------------QQ---------------QSS%SS---
-------||||||||--##-------------TT-------TT-----SSSS-----SS------------TT-----TT-----------------#-----------------------#------#-#--------------------#-----#-----------------o----------|---o-
-------||||||||--TT-------------TT-------TT-----SS---------------------TT-----TT-----------------#-----tt----------------#--------#--------------------#-----#---------------###----------|-----
-------||||||||--TT--k-g--------TT----kk-TT--####SS----------oo------##TT--k--TT---k--------k----#-----tt--#y------------#-----o#-#k-----------------###-----##---------------##---r------|-----
XXXXXXXXXXXXXXXXXXXXXXXXXXXXXXXXXXXXXXXXXXXXXXXXXXXXXX---X-X-XXXXXXXXXXXXXXXXXXXXXXXXXXXXXXXXXXXXXXXXXXXXXXXXXXX-----X---XX--%%%XXXX-----XXXXXXXXXXXXXXXXXXXXXXX--XX----XX--XXXX--%%%%XXXX|---XX
XXXXXXXXXXXXXXXXXXXXXXXXXXXXXXXXXXXXXXXXXXXXXXXXXXXXXX---X-X-XXXXXXXXXXXXXXXXXXXXXXXXXXXXXXXXXXXXXXXXXXXXXXXXXXX-----X-X-X----|-XXXX-----XXXXXXXXXXXXXXXXXXXXXXX--XX----XX--XXXX---||-XXXX|---XX
