------------------------------------------------------------------------------------------------------------------------------------------------------------------------------------------------
------------------------------------------------------------------------------------------------------------------------------------------------------------------------------------------------
------------------------------------------------------------------------------------------------------------------------------------------------------------------------------------------------
----------------#-------------------------------SSSSSSSSSSSSSSS-------------------------------------------------SSSSSSSSSSSSSSSS-------SSSSSSSSS--------------------------------#---------------
-----------------------------------------------------------------------------------------------------------------S---S--------------------------------------------------------------------------
---------------------------------------------------------------------------------------------------------------------S--------------------------------------------------------------------------
--------%%%%%%%%---------oo----------------------ooo---------oo--------------------------------------------------SSSSSS------SS---------------------------------------------------------o-------
---------||||||------------------o--------#----------------------------------------------------#------------------------------------------------------------------------------------------------
---------||||||-----------S---------------##-----------------SSS-------------------------------#------------------------------S-----------------------------------------------------------------
---------||||||---------------------------##----oo---------------------------------------------#----------------o--o-----------o----------------------------------------------------------------
------%%%%%%%%%%------------------TT-----###-----------------------------------------2--------##----------------SSSSS----------------------------------tt----------------%%%%-------------------
-------||||||||-------------------TT---####----#----tt---#------------------------------------##--------#---------------#---------------##-------------tt-----------------||--------------------
-------||||||||-------------------TT--#####----#----tt---#-------------##----U----------TT---###--------#-------------------------------##-------------tt--#--------------||---K----------------
-------||||||||-------------------TT#######----#----tt---###----------###----U--g-------TT--####--------#------------##----kkkk---------##-------------tt--#g-----g-------||---o----------------
XXXXXXXXXXXXXXXX---------XXXXXXXXXXXXXXXXXX--XXXXXXXXXXXXXXXXXXXXXXXXXXXX---XXXXXXXXXXXXXXXXXXXXXXXXXXXXX-------XXXXXXXXXXXXXXXXXXXXXXXXXX---XXXXXXXXXXXXXXXXXXXX%XXXXXXXXXXXXXX------XXXXXXXXXX
XXXXXXXXXXXXXXXX---------XXXXXXXXXXXXXXXXXX--XXXXXXXXXXXXXXXXXXXXXXXXXXXX---XXXXXXXXXXXXXXXXXXXXXXXXXXXXX-------XXXXXXXXXXXXXXXXXXXXXXXXXX---XXXXXXXXXXXXXXXXXXXXXXXXXXXXXXXXXXX------XXXXXXXXXX
