------------------------------------------------------------------------------------------------------------------------------------------------------------------------------------------------
------------------------------------------S-----------------------------------------------------------------------------------------------------------------------------------------------------
------------------------------------------------------------------------------------------------------------------------------------------------------------------------------------------------
---------------------------------SSSSSSS-SSS---S----------------SS---------------------o------------------------SSSSSS----------------------------------------------------------SSSSSSSSSS-----S
------------------------------------------------------------------------------------------------------------------------------------------------------------------------------------------------
------------------------------------------------------------------------------------------------------------------------------------------------------------------------------------------------
--------%%%%%%%%---------------------------------------------------------------#----------------------------------------%-----------------%%%----------SS-----SS--------------------------------
---------||||||---------------------------------------------------------------##-------------------------------------%%-|------------------|---#------------------------------------------------
---------||||||--------------------------###-------------------------------#####-------------------------------------||-|------------------|---#------------------------------------------------
---------||||||-------------------------##-##------------------------------#####-----------o--------------S----------||-|------------------|--##ooo---------------------------------------------
------%%%%%%%%%%----------######-------#######-------------------------TT--#####-------------------------------------||-|------------------|---#-------------#----------------------------------
-------||||||||-----------------------########-------------------------TT-#####--------------------------------------||-|------------------|--##-------tt--####----------------------tt---------
-------||||||||----------------------#########-------------------------TT-#####--------------------------------------||-|------------------|-###-------tt--####-o---------------#----tt------TT-
-------||||||||-----------------k---##########--k------------g-gg-----#########-----------------------#--------o-----||-|------------------|--##-------tt--####------------rr---#----tt------TT-
XXXXXXXXXXXXXXXXXXXXXXXXXXXXXXXXXXXXXXXXXXXXXXXXXXXXXXXXXXXXXXXXXXXXXXXXXXXXXXX-XXXXXXXXXXXXXXXXXXXXXXXXXXXXX%%%---XXXXXXXXX%%%%--------%%%|--XXXXXXXXXXXXXXXXX--%%%----%%%%%%%XXXXXXXXXXXXXXXXX
XXXXXXXXXXXXXXXXXXXXXXXXXXXXXXXXXXXXXXXXXXXXXXXXXXXXXXXXXXXXXXXXXXXXXXXXXXXXXXX-XXXXXXXXXXXXXXXXXXXXXXXXXXXX--|X---XXXXXXXX--||----------X-|--X-XXXXXXXXXXXXXXX---|------|||||-XXXXXXXXXXXXXXXXX
