--------------------------------------------------------------------------------------------------------------------------------------------------------------------------------
--------------------------------------------------------------------------------------------------------------------------------------------------------------------------------
--------------------------------------------------------------------------------------------------------------------------------------------------------------------------------
----------------SSSSSSSSS---SSSS----------------SSSSSSSSSS--SSSS-----------------------------------------------------------------------------------------------------SSSSSSSSSSS
----------------SSSSS-----------------------------SS----------------------------------------------------------------------------------------------------------------------------
--------------------------------------------------SSS---------------------------------------------------------------------------------------------------------------------------
--------%%%%%%%%-------------------------------------------------------------------U-------------------------------------------------------------------USSS-----------------o---
---------||||||----------------------------------------------------------------------------------------------------------------y-SSS--------------------------------------------
---------||||||-------#---TT-------------------------------------------------------------------------------------------#--------------------------------------------------------
---------||||||-------#---TT------------------g-----S----------------------g-2-----------------------------------------#--------------------------------------------------------
------%%%%%%%%%%------##--##-------@%--SS-----SS--------------------------%--##-------------------TT-------------------#--------------------------------------------------------
-------||||||||-----#-##-------#----|------------------#------------------|-###-------------------TT-------------------#-------------------------------------------------TT-----
-------||||||||----#####-------#----|------------------##-----------------|####-------------------TT-----TT------------------------------TT------------------------------TT-----
-------||||||||-----#####------#-ggg|---gggg-------k---##-----------------|####-------------y--k--TT-----TT----g-------#--------#----y---TT----g---------------------y---TT-----
XXXXXXXXXXXXXXXXXXXXXXXXX---XXXXXXXX|--XXXXXXXXXXXXXXXXXXXXXXXXX-XXXXXXXXXXXXXXXXXXXXXXXXXXXXXXX-XXXXXXXXXXXXXXXXX--XXXXX---XXX-XXXXXXXXXXXXXXXXXXXXXXXXXXXXXXXXX---XXXXXXXXX-XX
XXXXXXXXXXXXXXXXXXXXXXXXX---XXXXXXXX|--XXXXXXXXXXXXXXXXXXXXXXXXXXXXXXXXXXXXXXXXXXXXXXXXXXXXXXXXXXXXXXXXXXXXXXXXXX---XXXXX---XXX-XXXXXXXXXXXXXXXXXXXXXXXXXXXXXXXXX---XXXXXXXXXXXX
