--------------------------------------------------------------------------------------------------------------------------------------------------------------------------------
-------------------------------------------K-K----------------------------------------------------------------------------------------------------------------------------------
----------------------------------------------Q---------------------------------------------------------------------------------------------------------------------------------
--------------------------------------------------------------------------------SSSSSSSSSSSSSSSS--------------------------------------------------------------------------------
------------------------------------------------------------------------------------SSSSSSS-------------------------------------------------------------------------------------
------------------------------------%------------------------------------------------SSSSSS---------------------------------------------------------------------------oo--------
--------%%%%%%%%--------------------|---------------------------SS-------SQQQ--------------SSSS-----QQU---------------------------------------@S---------------o-----SSSSS------
---------||||||---------------------|-----------------#---------------------------K------------------%%%%---------------------------o-------------------r-----------------------
---------||||||---------------------|----------------##-------------------------%%%---K------SS-g-----||----------------------------------------------%%%-----------------------
---------||||||---------------------|---------------###--------------------------|--------------------||-----------------------------------------------|------------------------
------%%%%%%%%%%--SS----S-----------|---------------###--------------------------|-------SS-----QQ----SQQS-------------So---TT------------------%%%----|-%%%----------SS--SSS---
-------||||||||---------------------|-------------#-###--------------------------|------------------------------------------TT-------------------|-----|--|---------------------
-------||||||||---------------------|------------##-###-----------TT------------B|--------%%%%------------------------------TT--#--------##-----%|-----|--|---------------------
-------||||||||-ggg-----ggggy-------|-----------#-#-###-----------TT----------g-b|---------||---ggggg----gggg-g--gggg--ggg--TT--#--------#------||-----|--|---------------------
XXXXXXXXXXXXXXXXXXXXXXXXXXXXXXXXXXXX|X--XXXXXXX-XXXXXXXXXXXXXXXXXXXXXXXXXXXXXXXXb|-%%%%%%%%%%---XXXXXXXXXXXXXXXXXXXXXXXXXXXXXXXXXXXXXXXXXXXXXXXX||-----|--|---XXXXXXXXXXXXXXXXXX
XXXXXXXXXXXXXXXXXXXXXXXXXXXXXXXXXXXX|X--XXXXXXX-XXXXXXXXXXXXXXXXXXXXXXXXXXXXXXXXb|--||||||||----XXXXXXXXXXXXXXXXXXXXXXXXXXXXXXXXXXXXXXXXXXXXXXXX||-----|--X---XXXXXXXXXXXXXXXXXX
