-------------------------------------------------------S----------------------------------------------------------------------------------------------------------------------------------------
-------------------------------------------------------S-----------------SS---------------------------------------------------------------------------------------------------------------------
-------------------------------------------------------S------------------------------------------------------------------------------------------------------S---------------------------------
----------------SSSSSSSSSSSSSSSS------------------------------------------------------------------SS-SSSSSSSSSSS--SSSSSSSSSSSSSS---------------------SSSSSS-------------------------------------
--------------------------------------------------------------------------------------------------S---S----------------------------------------------SSS----------------------------------------
----------------------------------------------------------------Q------------------------------------------------o------------------------------------------------------------------------------
--------%%%%%%%%-----------------------S-------------------------------------------------------#----------oo-ooo--------------------------------SSSSSSSSSSSSSSSS--------------------------------
---------||||||----------------------------oo--------------------------------------------------#--------------------------------SS--------------------------------------------------------------
---------||||||-------------------------------------------------------------------------------##-----------S--SS----------------------------------------------------------#---------------------
---------||||||--------------------------#SSSSS-----------SSSSS------------SSSS--o------------##ooo---------------------------------------------ooo--oo-------oo---------------------------o----
------%%%%%%%%%%------------------------##-------S---------------------##---------------------##SSS---------------------TT----------------------SSSSSSSSS----SSS---------K-------SQ------S%%----
-------||||||||------------------------###-----------------------------##-------------------#-##------------------------TT----------------------------------------TT----###---------------||----
-------||||||||-TT--------------------####---K------------------------###-------------------####---------#--------------TT----------------------------------------TT---####---------------||----
-------||||||||-TT-------------------#####----------------------------###------------------##-##---------#--------g-----TT-----g---------k--g--------------g---g--TT--#####-------gggg#---||----
XXXXXXXXXXXXXXXXXXXXXXXXXXXXXXXXXXXXXXSXXX---XXX---%%%%--%%%%%%%XXXXXXXXX-------XXXXXXXXXXXXXXXXXXXXXXXXXXXXXXXXXXXXXXXXXXXXXXXXXXXXXXXXXXXXXXXXXXXXXXXXXXXXXXXXXXXXXXXXXXX-XXXXXXXXXXXXXXXXXXXX
XXXXXXXXXXXXXXXXXXXXXXXXXXXXXXXXXXXXXSXXXX---XXX----||----|||||-XXXXXXXXX------XXXXXXXXXXXXXXXXXXXXXXXXXXXXXXXXXXXXXXXXXXXXXXXXXXXXXXXXXXXXXXXXXXXXXXXXXXXXXXXXXXXXXXXXXXXX-XXXXXXXXXXXXXXXXXXXX
