------------------------------------------------------------------------------------------------------------------------------------------------------------------------------------------------
------------------------------------------------------------------------------------------------------------------------------------------------------------------------------------------------
------------------------------------------------------------------------------------------------------------------------------------------------------------------------------------------------
--------------------------------SSSSSSSS-------S------------------------------------------------SSSSS-SS------------------------SSSSSSS-------SS------------------------------------------------
------------------------------------------------------------------------------------------------------------------------------------------------------------------------------------------------
------------------------------------------------------------------o----------------------------------------------------------------------o------------------------------------------------------
--------%%%%%%%%------------------------%%SS----------------------------------------------------------------------------------------------------------SS%SSS---------------K%%------------------
---------||||||-------------------------||-------o------------------------------------------------------------------------------------------------------|------------------o||---------------o--
---------||||||-------------------------||--------------------------------------------TT------------#---------SS----------------------------------------|-----------------%%%|------------------
---------||||||-------------------------||--------------------------------------------TT------------#---------------------------------------------------|------------------|-|------------------
------%%%%%%%%%%------------------------||---S----TT----------------------------------##--------#---##-------------------------------------------------S%%%--------------%%%-|---------TT-------
-------||||||||-------------------------||--------TT----TT-----TT----------------------------#--#---------#---------------K-----TTTT----TT---------------|----------------|--|--TT-----TT-------
-------||||||||---------------TT--------||--------TT----TT-----TT----------------------------#--##-----#-##---------------------TTTT----TT----TT---------|----------------|--|--TT-----TT-------
-------||||||||------kk----kk-TT--------||-g------TT----TT---ogTT----------------------------#--##-----##-###---g------k------k-TTTT----TT----TT---------|-------------r--rr-|--TT-----TT---k---
XXXXXXXXXXXXXXXXXXXXXXXXXXXXXXXXX-X---XXXXXXXXXXXXXXXXXXXXXX-XXXXXXXXXXXXXXXXXXXXXXXX-XXXXXXXXXXXXXXXXXXXXXXXXXXXXXXXXXXXXXXXXXXXXXXXXXXXXXX-XXX-%%%--%%%%%-----%%%%%%%%%%%%%%%-XXXXXXXXXXXXXXXX
XXXXXXXXXXXXXXXXXXXXXXXXXXXXXXXXX-X---XXXXXXXXXXXXXXXXXXXXXX-XXXXXXXXXXXXXXXXXXXXXXXX-XXX-XXXXXXXXXXXXXXXXXXXXXXXXXXXXXXXXXXXXXXXXXXXXXXXXXXXXXX--X----XXX-------|||||||||||||--XXXXXXXXXXXXXXXX
