--------------------------------------------------------------------------------------------------------------------------------------------------------------------------------
--------------------------------------------------------------------------------------------------------------------------------------------------------------------------------
--------------------------------------------------------------------------------------------------------------------------------------------------------------------------------
--------------------------------------------------------------------------------------------------------------------------------------------------------------------------------
------------------------------------------------------------------------------------------------------------------------------o-------------------------------------------------
------------------##---------------------------------k----o---------------------------------------------------------------------------------------------------------------------
--------%%%%%%%%-------------------------------------S-----------------------------SSSS------------SS--------------oS@--ooo---@%-----Q----------------r-------------------------
---------||||||----------------------------------------------------------------------------------------------------------------|---------K------%%%%%%%%%---------------o-------
---------||||||------------------------TTTTTT----------------------------------------------------------------------------SS--U-|-----------------|||||||------------------------
---------||||||------------------------TTTTTT-------------------------------------------------------------------------------y#-|-----------------|||||||---------------U--------
------%%%%%%%%%%--S-----U-------------#######-##-------------##---------------------o------------------------------#--------##-|--SS-------------|||||QQQ-------%-%%%--%%%%-----
-------||||||||-------------TT----#######-----#-------------###----------------------------------K--K--------------#-#-----###-|------------##---|||||----------|--|----||------
-------||||||||-------------TT---########-----#----S---#---####------------%---------------------------TT--------###-#-#--####-|------------##---|||||----------|--|----||------
-------||||||||-ggg-----g---TT---########-----#--k-K---##-######-----------|---------R---------#--kk---TT---#----###-#-#-#####-|---k-K--y---##---|||||---g-----g|--|----||------
XXXXXXXXXXXXXXXXXXXXXXXXXXXXXXXXXXXXXXXXX---XXX-XXXXXXXXXXXXXXXX-----------|----X---XXXXXXXXXXXXXXXXXXXXXXXXXXXXXXXXXXXXXXXXXX-XXXXXXXXXXXXXXXXXXXXXXXXXXXXXXXXX%--|-%--||------
XXXXXXXXXXXXXXXXXXXXXXXXXXXXXXXXXXXXXXXXX---XXX-XXXXXXXXXXXXXXXX-----------|----X---XXXXXXXXXXXXXXXXXXXXXXXXXXXXXXXXXXXXXXXXXX-XXXXXXXXXXXXXXXXXXXXXXXXXXXXXXXXXg--|-|--||------
