----------------------------------------------------------------------------------------------------------------------------------------------------------S-------------------------------------
----------------------------------------------------------------------------------------------------------------------------------------------------------S-------------------------------------
----------------------------------------------------------------------------------------------------------------------------------------------------------SS------------------------------------
--------------------------------SSS---SSSSSSSSSS------------------------------------------------S-----------------------------------------------SSSSSSSSSSSSSSSS--------------------------------
------------------------------------------------------------------------------------------------------------------------------------------------SS---S-S--S--SS---------------------------------
--------------------------------------------------------S----------------------------------oo---------------------------------------------------SSS--SSS-ooooSSS--------------------------------
--------%%%%%%%%--------------------------------SS-2-2-------S-------SQS-------S-------QQ------------------------------------------------------------SSSSSSSSSSS------QQQ-----------------------
---------||||||--------------------------------------------------------------------------------#------------------------------------------------------------------------------------------------
---------||||||-------------------------------------------------------------#-----------------##-------------SSS----------------------#---------------------------------------------------------
---------||||||-------------------------------oo-----------------------------#-------gg-------##--------------------------------------#--------------------------------g------------------------
------%%%%%%%%%%----------#####-TT---------------SSQSSUS-----S---------TT--###--########-----##---------------------------------------#------2------------------------S##----#---SoS-SSS----S@S-
-------||||||||-----------------TT---@--TT-----------------------------TT--###--#------------##------------#------------------------------------TT---------------------------#------------------
-------||||||||-----------------TT------TT---------------------------####--###---------------##-----------##-------------------TT---------------TT-----TT-------------------##------------------
-------||||||||-----------------TT----k-TT---------k--k---U----------####--###--------------####---------###------g----k-k-----TT----------gk---TT-----TT----g--------#------#----ok-----------k
XXXXXXXXXXXXXXXXXXXXXXXXXXXXXXXXXXXXXXXXXXXXXXXXXXXXXXXXXXXXXXXXXXXXXXXXX--XXXX-XXXX---XXXXXXXXXXXXXXXXXXXXXXXXXXXXXXXXXXXXXXXXXXXX---XXXXXXXXXXXXXXXXXXXXXXXXXXXXXXXXXXXX--XXXXXXXXXXXXXXXXXXXX
XXXXXXXXXXXXXXXXXXXXXXXXXXXXXXXXXXXXXXXXXXXXXXXXXXXXXXXXXXXXXXXXXXXXXXXXX-XXXXX-XXX---XXXXXXXXXXXXXXXXXXXXXXXXXXXXXXXXXXXXXXXXXXXXX---XXXXXXXXXXXXXXXXXXXXXXXXXXXXXXXXXXX---XXXXXXXXXXXXXXXXXXXX
