------------------------------------------------------------------------------------------------------------------------------------------------------------------------------------------------
----------------------------------------------------------------------------------------------------------S-------------------------------------------------------------------------------------
------------------------------------------------------------------------------------------------------------------------------------------------------------------------------------------------
--------------------------------------------------------------------------------SSSSSSS-----------S-SSSSSSSSSSSS--------------------------------##------------------------------SSS-------------
--------------------------------------------------------------------------------------------------------S----SSS--------------------------------------------------------------------------------
--------------------------------------------------o--------------oo-------------------------------S---------SSSS----------------------------------------------o---------------------------------
--------%%%%%%%%-----------------------SS------o------------------------------------------------SSSSSSSSSSSSSSSS-----QQQQ--------------------------------------------QQoo-----oo----------------
---------||||||--------------------S%--------------------------------------ooo------------------------------------------------##-------------------------------o----------------S---------------
---------||||||---------------------|---------S---------------------------------------------#-----------------------------------------------------------------------------------S---------------
---------||||||-----------oo--------|---------------------oo-------------------------------##---o-oooooo---------------g--------------------------------------------------------S---------------
------%%%%%%%%%%--------------------|-----------------------------------o-----------------###---SSSSSSSSS-------#-##--##Q-----------------------#----2------##----##--QQ#----S--------------SS--
-------||||||||------------------##-|------#----------------------------TT---TT-----------###-------------------#-##---------#------------------#-----------#-#--###----------------------------
-------||||||||---------##------###-|------#----------------------------TT---TT----------####-TT----------------#####--------#----------#-------#---------#####-#####---------------------------
-------||||||||---------##------###-|kg----#------g#--------------------TT---TT------########-TT------g-----###-####---g-gk-k#-#-k------##------#------k--###-#-#####----------------------k----
XXXXXXXXXXXXXXXXXXXXXXXXXX------XXXXXXXXXXXXXXXXXXXXXXXXXX--XX--XXXXXXXXXXXXXXXXXXXXXXXXXXXXXXXXXXXXXXXXXXXXXXXXXXXXXXXXXXXXXXXXXXXXXXXXXXXXXXXXXXX-XXXXXXXXXXXXXXXXXXXXXXXXXXXXXXXXXXXXXXXXXXXX
XXXXXXXXXXXXXXXXXXXXXXXXXX------XXXXXXXXXXXXXXXXXXXXXXXXXX--XX-XXXXXXXXXXXXXXXXXXXXXXXXXXXXXXXXXXXXXXXXXXXXXXXXXXXXXXXXXXXXXXXXXXXXXXXXXXXXXXXXXXXX--XXXXXXXXXXXXXXXXXXXXXXXXXXXXXXXXXXXXXXXXXXX
