-------------------------------------------------------------------------------------------------------------------------------------------------------------------------------------S-SSS------
-------------------------------------------------------------------------------------------------------------------------------------------------------------------------------------SSSSSS-----
---------------------------------------------------------------------------------------------------------------------------------------------------------------------------------------S--------
--------------------------------SSSSSSSSSSSSSSSS-------S----------------------------------------SSSSSSSSSSS-------------------------------------SSSSSSSSSSSSSSSS--------------------------------
--------------------------------------------------------------------------------------------------------------------------------------------------------------------------------Q-----SSS-------
-------------------------------------------------------------------------------------------------------------------------------------------------------------------------------o#--@-@SSS-@-----
--------%%%%%%%%---------------------------#--------------------SSSSSSSS-----S--SoK-------------------------oo--------SSSS---SSS-------------o-o-------------------------------------2SS-----2--
---------||||||---------------------------##----------------------------------------------------------------------------------------------------------------------------------------------------
---------||||||--------------------------###---------------------------------------------------------------SSSSS--------------------------------------------------------------------------------
---------||||||-------------------------####-------------#---------------------o---------------o-----------SSSSS---------------------------------------------------------------------------SSSSS
------%%%%%%%%%%----------######--------###-------TT-----#-----SSSSSS--S-------S--------#-------S-----------------------------------------------------------------TT----TT-------U-o--U@S------S
-------||||||||-----------------------y####-------TT--y###-----S-----------------------##-----------tt------------------------------------------------------------TT----TT----------------------
-------||||||||-------------------TT--#####-------TT--####-----S----------------------###-----------tt------------------------------------------------------------TT----TT----------------------
-------||||||||-------------------TT######--------TT--####----SS------k--------------####-----------tt-----------------------------k--------------g----k------g---TT----TT----------------------
XXXXXXXXXXXXXXXXXXXXXXXXXXXXXXXXXXXXXXXXXX---XXX-XXX--XXXXX-XXXXXXXXXXXXXXXXXXXXXXXXXXXXXXXXXXXXXXXXXXXXXXXXXXXXXXXXXXXXXXXXXXXXXXXXXXXXXXXXXXXXXXXXXXXXXXXXXXXXXXXXXXXXXXXXXXXXXXXXXXXXX----XXX
XXXXXXXXXXXXXXXXXXXXXXXXXXXXXXXXXXXXXXXXXX---X-XXXXXXXXXXXX-XXXXXXXXXXXXXXXXXXXXXXXXXXXXXXXXXXXXXXXXXXXXXXXXXXXXXXXXXXXXXXX-XXXXXXXXXXXXXXXXXXXXXXXXXXXXXXXXXXXXXXXXXXXXXXXXXXXXXXXXXXXXX----XXX
