------------------------------------------------------------------------------------------------------------------------------------------------------------------------------------------------
------------------------------------------------------------------------------------------------------------------------------------------------------------------------------------------------
------------------------------------------------------------------------------------------------------------------------------------------------------------------------------------------------
---------------------------------------------------S-SSS------------------------SSSSSSSSSS---SSS------------------------------------------------------------------------------------------------
------------------------------------------------------------------------------------------------------------------------------------------------------------------------------------------------
----------------------------------o------------------------------------------------------------------------------------------------------------------------------------------------------oooo--o
--------%%%%%%%%------------------------------------------------------SSSS----------------------------%%%%----------------------Soo------------------SQQSS--SSS---------------------------------
---------||||||---------------------------------------------------------------------------------%%%----||---------------------------------------S-----------------------------------------------
---------||||||----------------------------------------------------------------------------------|-----||---------------------------------------------------------------------------------------
---------||||||--------------------------------------------------------------------------------#-|-----||----SS---------------------------------------------------o-------o---------------------
------%%%%%%%%%%----------######SS-------S%SSSS------------#--------o--------------------###--##%|-----||---SS------------------------S------S---S---SSSQ----Q----SS------S----------2----------
-------||||||||---------------------------|--------------TT#-----------------------------##--###||-----||-----------------------------------------------------------------K-----TT------TT---TT-
-------||||||||---------------------------|--------------TT#---------------------------#########||-----||-----------------------------------------------------------------------TT------TT---TT-
-------||||||||-------------------g-------|---------gg---TT#---#----g----------g------##########||-----||---------g--ggy-----------k-kk-----------------------------gg----------TT----k-TT---TT-
XXXXXXXXXXXXXXXXXXXXXXXXXXXXXXXXXXXXXXXXXXXXXXXXXXXXXXXXXXXXX-XXXXXXXXXXXXXXXXXXXXXXXXXXXXXXXXXX||-----||--X-X--XXXXXXXXXXXXXXXXXXXXXXXXXXXXXXXXXXXXXXXXXXXXXXXXXXXXXXXXXXXXXXXXXXXXXXXXXXXXXXXX
XXXXXXXXXXXXXXXXXXXXXXXXXXXXXXXXXXXX-XXXXXXXXXXXXXXXXXXXXXXXX-XXXXXXXXXXXXXXXXXXXXXXXXXXXXXXXXXX||-----||--X-X--XXXXXXXXXXXXXXXXXXXXXXXXXXXXXXXXXXXXXXXXXXXXXXXXXXXXXXXXXXXXXXXXXXXXXXXXXXXXXXXX
