------------------------------------------------------------------------------------------------------------------------------------------------------------------------------------------------
------------------------------------------------------------------------------------------------------------------------------------------------------------------------------------------------
------------------------------------------------------------------------------------------------------------------------------------------------------------------------------------------------
------------------------------------------------------------------------------------------------SSSSSSSSSSSSSSSS---------------S----------------------------------------------------------------
----------------------------------------------------------------------------------------------------------------------------------S-------------------------------------------------------------
----------------------------------------------------------------------------o---------------------------------------------------------------------o---------------------------------------------
--------%%%%%%%%-------SSS----SS-------------------S-SSS------S------------%%-----o--SSS---#------------------------------------SSSSSSSS-----SS-------------------------------------------------
---------||||||-SS---------------------------------------------------------||--#-----------#--------------------%%------------------------------------------------------------------------------
---------||||||-S--------------------------S-------------------------------||------------###---S----------------||------------------------------------------------------------------------------
---------||||||----------------------------------------k-------------------||------------##---------------------||-----------SSSoooo------------------------------------------------------------
------%%%%%%%%%%--------------------------------QSQQ--SSSSSSSS-----------%%||--#-------####------TT-------------%%--------------SSSSS---#-------------------------------------------------------
-------||||||||----------------------------------------------------------||||#--------#####------TT-SSS-TT------||---------------------##-----------------------------------------------TT------
-------||||||||-------------------oo-----------------------------------tt|||###------######------TT-----TT------||---------S%%%%------###--------------------U-----------TT-------------TT------
-------||||||||----------------#---rr----------------------------------tt|||-###----######-------TT---k-TT---ooo||--------rr-||------####-------g-------k----k----%%%k---TT-------g-----TT------
XXXXXXXXXXXXXXXXXXXXXXXXXXXXXXXX-%%%%%%%%%%%%%----XXXXXXXXXXXXXX%%%%XXXXXXXXX-XXXXXXXXXXXX--XXXXXXXXXXXXXXXXXXXX||------%%%%%||-XXXXXXXXXXXXXXXXXXXXXXXXXXXXXXXX--XXXXXXXXXXXXXXXXXXXXXXXXXXXXXX
XXXXXXXXXXXXXXXXXXXXXXXXXXXXXXXX--|||||||||||-----XXXXXXXXX-XXXXX||--XXXXXXXX-X-XXXXXXXXXX--XXXXXXXXXXXXXXXXXXXX||-------|||-||-XXXXXXXXXXXXXXXXXXXXXXXXXXXXXXXX--XXXXXXXXXXXXXXXXXXXXXXXXXXXXXX
