-----------------------------------------Q--------------------------------------------------------------------------------------------------------------------------------------
--------------------------------------------------------------------------------------------------------------------------------------------------------------------------------
---------------------------------------------------------------------------------------------------------------------------R----------------------------------------------------
----------------------------------------------------------------------------------------------------------------------------------------------------------SSSSS-----------------
---------------------------------------g--gg----------------------------------K------------------------------------------------------------------SSSS-----SSSSS-----------------
-----------------------------------%%%%%%%%%-------------------------o---------------ooo--------%###------------------------------------------------kkS---ooSSSS----------------
--------%%%%%%%%--------------------|||||||-----------------------------------------------------|-----------------SoSSSS-SoU--@%---SSSSSSSoo--@----SSSS--SSSSSSSSS-LSU----------
---------||||||----------ooo--------|||||||-------------------------S------------SSS------------|--------ooo-------------------|-------------------SSS--------------------------
---------||||||---------------------|||||||------------------------SS--##-----------------------|------------------------------|------------------------------------------------
---------||||||-------------------g-|||||||----------------------SSSS--##-SS--------------------|---------------------------y--|-------------------SS--------ooo----------------
------%%%%%%%%%%---S--------------Q-|||||||-----Q----------------------##-----------TT----------|------------------------------|-------------QQS-----S-------S%%------------##--
-------||||||||---------------------|||||||--------------TT------------##-----------TT----------|--------------------B---------|------------------------------||-----------###--
-------||||||||---------------------|||||||--------------TT------SSS---##-----------TT----------|-----------##-------b---------|------------------------------||----------####--
-------||||||||------g--------------|||||||--------ggg-k-TT--------k---##----k------TT-#--------|-------y---##-----U-b---------|---y-g-K----gggg--------------||---------#####--
XXXXXXXXXXXXXXXXXXXXXXXXXXXXXXXXXX--|XX||||--%%%XXXXXXXXXXXXXXXXXXXXXXXXXXXXXXXXXXX-XXXXXXXXXXXXXXXXXXXXXXXXXXXXUXXXXXXXXXXXXXXXXXXXXXXXXXXXXXXXX-----S-------|XXXXXXXXXXXXXXX-X
XXXXXXXXXXXXXXXXXXXXXXXXXXXXXXXXXX--|X-||||---|-XXXXXXXXXXXXXXXXXXXXXXXXXXXXXXXXXXX-XXXXXXX-XXXXXXXXXXXXXXXXXXXXXXXXXXXXXXXXXXXXXXXXXXXXXXXXXXXXX-------------|XXXXXXXXXXXXXXX-X
