----------------------------------K-----------------------------------------------------------------------------------------------------------SS--------------------------------
-----------------------------------Q--------------------------------------------------------------------------------------------------------------------------------------------
--------------------------------------------------------------------------------------------------------------------------------tt----------------------------------------------
-------------------------------------------------------------------------------------------------------------------o------------tt------------------------------SSSSSSSSSSSSSSSS
-----------------------------------k-------------------------------------------------------@------------------------------------tt-----------------g------------------S--SS-----
---------------------------------------------------------------U----------------------------------------------------------------tt----------------##------------------SSSSS-----
--------%%%%%%%%---------------------------------------------------------------S---------------2SS------QQSQQSSS----------------S#------------------------------------------SSS-
---------||||||-----------------------------------------------------S--------------------------B-------------------------------------o--------------------------------o---------
---------||||||---------------------------------------------------S--#-----------------------y-Q----------------%----------------------%%%%%----------------------%%%%%---------
---------||||||-----------------------------------------------------##-----------------------2------------------|-----------------------|||------------------------|||-r---r-Sr-
------%%%%%%%%%%-oSSS-------TT-------------------------------###---####-----##-#--%%%%%%%%%---#---%------%%%%%%%|------%%%%%%%%-TT----tt|||----t--------------#-%%%%||%%%%%%%%%%
-------||||||||-----K-------TT-------------------------------##----#####---#---#---|||||||---##---|-------|||||-|-TT----||||||--TT----tt|||----t--------------#--||-||-||||||||-
-------||||||||-------------TT------TT----------------------###--#######---#---#---|||||||--###---|-------%%%%%-|-TT----||||||--TT---#tt|||----t-----------------||-||-||||||||-
-------||||||||---g-------k-TT------TT--g------------------####-########-#-----#K--|||||||-####---|--------|||g-|-TT----||||||--TT---#tt|||----t--------y---#-#--||-||-||||||||-
XXXXXXXXXXXXXXXXXXXXXXXXXXXXXXXXXXXXXXXXXXXXXXXX---X----X-XXXXXXXXXXXXXXXXXXXXXX%--|||||XXXXXXXX--|--X-----|||X-|XXX----||%%%|--XXXXXXXXXXXXXXXXXXXXXXXXXXXXXXXX-||%%%%%%%|||||-
XXXXXXXXXXXXXXXXXXXXXXXXXXXXXXXXXXXXXXXXXXXXXXXX---X---XX-XXXXXXXXXXXXXXXXXXXX-X|--|||||XXXXXXXX--|--X-----|||X-|XXX----||-|-|--XXXXXXXXXXXXXXXXXXXXXXXXXXXXXXXX-||-|||||-|||||-
