--------------------------------------------------------------------------------------------------------------------------------------------------------------------------------
---------------------------------------------K----------------------------------------------------------------------------------------------------------------------------------
--------------------------------------------------------------------------------------------------------------------------------------------------------------------------------
-----------------------------------------------------------------------------------------------------------SSSSS----------------------------------------------------------------
------------------------------------------g-------------------------------------------------------------------------------------------------------------------------------------
------------------------------------------L-------------------------------------------------------------------------------------------------------------------------------------
--------%%%%%%%%o----------------------------------------------------------------------@SS---SSS-------------------SSS-------SSS------ooo--o--2---------------------------------
---------||||||-S----------------------ooo----U-------------------------------------------------------------------------------------------r--U-----------ooo-------------------y
---------||||||-----------------------%%%%%%%%-----------------------------------------------------------------------------------------SSSSS-----------------------------------#
---------||||||-------------------g----||||||-r--------------------------------------tt-----------o-----oSSS-SrS-------------------------------------------------------------2##
------%%%%%%%%%%o----------------%%%---|||||%%%%--SSS-------------SS-----------------tt-QQQQ------------------%%----------------#---SSSSoSS-o----o---------------------------###
-------||||||||-------------TT----|----|||||-||-----K--------------------------------tt-----------------------||-------TT-----------TT--------------K-----------------------####
-------||||||||-----TT------TT----|----|||||-||--------------------------------------tt-----------------------||-------TT-----------TT----------------------TT-------------#####
-------||||||||-----TT------TT-k--|----|||||-||---------g-k-y-----g-----gg---k-k-----tt-------k---------------||-------TT---kk------TT--kg----------------k-TT------------######
XXXXXXXXXXXXXXXXXX--XXXXXXXXXXXX--|----||||X-||-XXXXXXXXXXXXXXXXXXXXXXXXXXXXXXXXXXXXXXXXXXXXXXXX-----------X--X|XXXXXXXXXXXXXXXXX---XXXXXS-----XXXXXXXXXXXXXXXXXX---XXXXXXXXXXXX
XXXXXXXXXXXXXXXXXX--XXXXXXXXXXXX--|----|||XX-||-XXXXXXXXXXXXXXXXXXXXXXXXXXXXXXXXXXXXXXXXXXXXXXXX----------XXX-X|XXXXXXXXXXXXXXXXX---XXXXXX--X--XXXXXXXXXXXXXXXXXX---XXXXXXXXXXXX
