------------------------------------------------------------------------------------------------------------------------------------------------------------------------------------------------
------------------------------------------------------------------------------------------------------------------------------------------------------------------------------------------------
------------------------------------------------------------------------------------------------------------------------------------------------------------------------------------------------
----------------------------------------------------------------SSSSSSSSSS-----SSSSSSSSSSSSSSSSS--------------------------------SSSSSSSS--SS----SSS------SSSSSSS----------------SSSSSSSSSSSSSSSS
----------------------------------------------------------------S----SS----------------------------------------------------------S--------------------------------------------------------------
------------------------------------------------------------------------------------------------------------------------------------------------------------------------------------------------
--------%%%%%%%%------------------------------------SSSo-------S-------------S---Soo----o----oo----------SSS-------------------S-SSSSSSSS----SSS----------------------SSSSSSSS-----------------o
---------||||||-------------------------------------------------S-----------------------------------------------------------------------------------------------------------------------------##
---------||||||-------------------------------------------------S-----------------------------SS-------------------------------------------------------------------------------------------#####
---------||||||-------------------------------------------------S---------S-----o-ooo----------o--------------------------------ooooo------------------------------------------------------#####
------%%%%%%%%%%----------######----------#------------------------S------------SSSSS--------------------------#-------tt-------S--SSS--------S-------S-TT-------------------SSS----------######
-------||||||||---------------------------#----------------------------------------------##--------------------#-------tt------------------#----TT------TT-------------------------------#######
-------||||||||-------------------------###---------------------------------------------###--------------------#-------tt----#------------##----TT------TT-----------------------------#########
-------||||||||---------------------g-#-###--------k-ggy------------#-g----k-g-g-------####--------------------#g------tt---g##------ggg--##k---TT----k-TT----------------------##-----#########
XXXXXXXXXXXXXXXXXXXXXXXXXXXXXXXXXXXXXXXXXXXXXXXXXXXXXXXXXXXXXXXXXXXXXXXXXXXXXXXXXXXXXXXXXXXXXXXX%%%%%%--XXXXXXXXXXXXXXXXXXXXXXXXXXXXXXXXXXXXXXXXXXXXXXXXXXX--X-XXXXXXXXXXXXXXXXXXXXXXXXXXXXXXXXX
XXXXXXXXXXXXXXXXXXXXXXXXXXXXXXXXXXXXXXXXXXXXXXXXXXXXXXXXXXXXXXXXXXXXXXXXXXXXXXXXXXXXXXXXXXXXXXXX-||||---XXXXXXXXXXXXXXXXXXXXXXXXXXXXXXXXXXXXXXXXXXXXXXXXXXX--X-XXXXXXXXXXXXXXXXXXXXXXXXXXXXXXXXX
