---------------------------------------------------------------------------------------------------------------------------------------------------------------------S--SS----------------------
---------------------------------------------------------------------------------------------------------------------------------------------------------------------S--SSS---------------------
-----------------------------------------------------------------------------------------------------------------------------------------------------------------------SS-----------------------
------------------------------------------------------------------------------------------------SSSSS---------------------------------------------------------------------------SSSS------------
-----------------------------------------------o----------------------------------------------------------------------------------------------------------------g-----SSS-----------------------
-----------------------------------------o----------------------------------o-o--------------------------------------------------------------o------------------SS-@QoSSS-K---------------------
--------%%%%%%%%-------SS----------------------------QSSSS----------------------------------------------SSSSS---------------------------------------QQQQQS--------------------------------------
---------||||||--------------------------------o---------------------------------o-----------------------------------------oooo-----------------------------------------------------------------
---------||||||---------------------------------------------------------------------------------------------------------------------------------------------------------------------------------
---------||||||-------------------------------------------------------------------TT-----------------------------------------------------------o---g---g------------------oo-----------%--------
------%%%%%%%%%%---------------------2---------------SSQS----U------SSSSSS%SSoS---TT----TT---------------------------------------------TT-------######QQQ---SU--SSS-------------%------|--------
-------||||||||-----------------TTTT----TT-------S------------------------|-------TT----TT----TT-------------------------------------U-TT-------####------------SSSS------------|------|--------
-------||||||||-----------------TTTT----TT----TT--------------------------|-------TT-TT-TT----TT-----------------------------K---------TT-------####------------SSSS------------|------|--------
-------||||||||-----------------TTTT----TT----TT--------------------------|-------TT-TT-TT----TT------k----k---------------------------TT----k--####---g--------SSSSS-----------%%%%---|-------#
XXXXXXXXXXXXXXXX-----XXXXXXXXXXXXXXXXXXXXXXXXXXXXXXX----XXX-XXXXXXXXXXXXXXXXXXXX-XXXXXXXXXX---XXXXXXXXXXXXXXXXXXXXXX--XXXXXX----XXXXXXXXXXXXXXXXXXXXXXXXXXXXXXXXXXXXXXXXX----XXX-||--XXXXXXXXXXX
XXXXXXXXXXXXXXXX-----XXXXXXXXXXXXXXXXXXXXXXXXXXXXXXX----X-X-XXXXXXXXXXXXXXXXXXXXXXXXXXXXXXX-----XXXXXXXXXXXXXXXXX-XX---X--XX----XXXXXXXXXXXXXXXXXXXXXXXXXXXXXXXXXXXXXXXXX----XXX-||--XXXXXXXXXXX
