-------------------------------------------------------------------------------------------------------K----------------------------------------------------------------------------------------
------------------------------------------------------------------------------------------------------------------------------------------------------------------------------------------------
------------------------------------------------------------------------------------------------------------------------------------------------------------------------------------------------
----------------------------------------------------------------------------------SSSS--------------------------------------------------------------------------SSSSSSSSSSSSSSSS--------------S-
------------------------------------------------------------------------------------------------------------------------------------------------------------------------------------------------
------------------------------------------------------------------o-----------------------------------------------------------------------------------------------------------------------------
--------%%%%%%%%------------------------oSS----o---------------------------------------------------------------------------------------SSSS-----SS-------------S-----------oo-------------------
---------||||||------------------------------------------------------------------------------------------------------------------------------------------------------------------------o--------
---------||||||---------------------oo------------------------------------------------------------------------------------------------------------------------o---------------------------------
---------||||||-----------oo--------------------------------------------------------------------------------------------------------------------------------------------------------------------
------%%%%%%%%%%----------%%-------SSSS-----S@S--------tt----------------------------o-----------------------------------TT---------------------S------------SSS----------S---------------------
-------||||||||-----------||---------------------------tt-------------------------------------TT-------------------------TT--------------------#------------------------------------------------
-------||||||||-----------||---------------------------tt--------------------#-----------TT---TT-------------------------TT------------------###------------------------------------------------
-------||||||||---g-------||-------k--------k----------tt-------k------k-----g--k----k-k-TT---TT---------------------k-k-TT---ko---g---------###--ggg-----k-k------------------------------o----
XXXXXXXXXXXXXXXXXXXXXXXX--||-%%%XXXXXXXXXXXXXXXXXXXXXXXXXXXXXXXXXXX---XXXXXXXXXXXXXXXXXXXXXXXXXX-%%%-XXXXXXX%%%-XXXXXXXXXXXXXXXXXXXXXXXXXXXXXXXXXXXXXXXXXXXXXXXX-XXXXXX--X-X-X--XXXXXXXXX--XSS-X
XXXXXXXXXXXXXXXXXXXXXXXX--||--|-XXXXXXXXXXXXXXXXXXXXXXXXXXXXXXXXXXX---XXXXXXXXXXXXXXXXXXXXXXXXXX--|--XXXXXXX-|--XXXXXXXXXXXXXXXXXXXXXXXXXXXXXXXXXXXXXXXXXXXXXXXX-XXXXX---X-X-X--XXXXXXXXX--X---X
