------------------------------------------------------------------------------------------------------------------------------------------------------------------------------------------------
------------------------------------------------------------------------------------------------------------------------------------------------------------------------------------------------
------------------------------------------------------------------------------------------------------------------------------------------------------------------------------------------------
--------------------------------------------------------------------------------------------------------------------------------------------------------------------SSSS--------SSSSSSSSSSSS--SS
------------------------------------------------------------------------------------------------------------------------------------------------------------------------------------------------
-------------------------------------------------------ooo---------------------------------------------------------------------------------------------------------------------------------o----
--------%%%%%%%%--------------------------------------------------------------------QQQQQ------#------SSSS-----o------SS---------o-----SS------o----QQQSQSS--SSSSS----SS---------SSS------------
---------||||||-------------------------------------------------------------------------------##----------------------------------%%------------------------------------------------------------
---------||||||------------------------------------------------------------------------------###----------------------------------||-------####-------------------------------------------------
---------||||||--------------------------------------------------------------------g--------####----------------------------------||-------####--------o--------oo-----------------------------o
------%%%%%%%%%%----------######-----2---------------------------------------o--########---#####-------------------------------o--||-----######-----QQQQQS--SU--SSS-----#-------TT-----TT-------
-------||||||||------------------TT-----TT--------TT--------------------#------------------#####----------------------------------||-----######------------------------##-------TT-----TT----#--
-------||||||||-----------------TT------TT----TT--TT--------------------#------------------#####---------------#------------------||----#######-----------------------###-------TT-----TT----#--
-------||||||||-----------------TT------TT----TT--TT------------g-gg----#---g-------------######----k---------##----gg------------||-k-########----k--------k--------####-------TT-----TT----#--
XXXXXXXXXXXXXXXXXXXXXXXXXXXXXXXXXXXXXXXXXXXXXXXXXXXXXXXX-X---%%-XXXXXXXXXXXXXXXXXXXXXXXXXXXXXXXXXXXXXXXXXXXXXXXXXXXXXXXXXXXXXXXXXXXXXXXXXXXXXXXXXXXXXXXXXXXXXXXXXXXXXXXXXXXXXXXXXXXXXXXXXXXXXXXX
XXXXXXXXXXXXXXXXXXXXXXXXXXXXXXXXXXXXXXXXXXXXXXXXXXXXXXXXXX---||-XXXXXXXXXXXXXXXXXXXXXXXXXXXXXXXXXXXXXXXXXXXXXXXXXXXXXXXXXXXXXXXXXXXXXXXXXXXXXXXXXXXXXXXXXXXXXXXXXXXXXXXXXXXXXXXXXXXXXXXXXXXXXXXX
