------------------------------------------------------------------------------------------------------------------------------------------------------------------------------------------------
------------------------------------------------------------------------------------------------------------------------------------------------------------------------------------------------
---------------------------------------------------------------------------------------------------------------------------------------------------------------------------------#--------------
---------------------------------------------------------------------------------------o------------------------##---------------------------------------------------------------#--------------
-----------------------------------------------------------------------------------------------------------------------------------------------2---------------------------------#--------------
------------------------------------------------------------------------------------------------------------------------------------------------------------------------------------------------
--------%%%%%%%%-------------------o------------S-----USoS---SSS------QQSSS---------------------S-----------------------oo-----------------------SSU---S-----S------------##-----#-------------#
---------||||||------------------------------------------------------------------------o-------------------------------------------------------------------------o--------##---oS#-------------#
---------||||||-----------------------------------------------------------------S-----------------------------------------------------------------------------------------##------------------##
---------||||||---------------------------------------------------------------------------------------g-----------------------------------------------U------------------###----------------####
------%%%%%%%%%%----------######----S-S---------QSQQSSSSSS--SS---------Q----SSS-----------------SSSSSSSS-----U-----------------------------------SQQ--UQ-----S----------#####-----------TT--####
-------||||||||------------------SSS--K--------------------------------------------------------------------------------------------------------------------------TT-----#####-----------TTT#####
-------||||||||-------------------------------------------------###----------------------------------------------------------------------------------------------TT---#######-----------TTt#####
-------||||||||-------------------k----------------g------------#-#--------k------------------------------k-------#--k------------ky-----------------------------TT---#######--##-g-----TTt#####
XXXXXXXXXXXXXXXXXXXXXXXXXXXXXXXXXXXXXXXXXXXXXXXXXXXXXXXXXXX-XXXXXXXX-XXXXXXXXXXX--XXXXXXXX-X-XXXXXXXXXXXX-XXXXXXXXXXXXXXXXXXXXXXXXXXXXXXXXXXXXXXXXXXXXXXXX--XXXXXXXXXXXXXXXXXXXXXXXXXXXXXXXXXXX-
XXXXXXXXXXXXXXXXXXXXXXXXXXXXXXXXXXXXXXXXXXXXXXXXXXXXXXXXXXX-XXXXXXXX--XXXXXXXXXX--XXXXXXXX---XXXXXXXXXX-X-XXXXXXXXXXXXXXXXXXXXXXXXXXXXXXXXXXXXXXXXXXXXXXXX--XXXXXXXXXXXXXXXXXXXXXXXXXXXXXXXXXXXX
