------------------------------------------------------------------------------------------------------------------------------------------------------------------------------------------------
------------------------------------------------------------------------------------------------------------------------------------------------------------------------------------------------
------------------------------------------------------------------------------------------------------------------------------------------------------------------------------------------------
-----------------------------------------------------------------------o-------o--------------------------------SS------------------------------------------------------------------------------
-------------------------------------------------------------------------------------------------------------------------------------------------------------------------o----------------------
----------------------------------------------------------------------------------o-------------------------------------------------------------------------------------------------------------
--------%%%%%%%%-----QQQQ----------------------o--------------------------------%%%--------o--------------------------o-------------------------------------------S---SSSS---S--oooo--SSoS---So-
---------||||||--------------------------------------------#---------------------|-------------------------------S%%%%%-------SS---------------------------#------------------------------------
---------||||||--------------o------------#--------------###---S----------%%-----|---------------------------------|||-----##-S----------------S---------##-------------------------------------
---------||||||---#----------------------#SS--S----------##---------------||-----|---------------------------------|||-----#-----------------------------##----o--------------------------------
------%%%%%%%%%%####---#----S@S---------###-------------###----S----------||-----|---------------------------------|||---###----------------------------TT------Q----SSSSSSSS@S-S------------SSS
-------||||||||-####-------------------####------------####-------TT------||-----|---------------------------------|||---###------------#---------------TT--------------------------------------
-------||||||||-####------------------#####-----------#####-------TT------||-----|------------------------------#--|||--####--------------------------####---#----------------------------------
-------||||||||-###k---k----k--------######--#----g#-######-------TT------||-----|----------------------------kg#--|||-#####---------##--------------#####---#-----------------------k----------
XXXXXXXXXXXXXXXXXXXXXXXXXXXXXXXXXXXXXXXXXX---XXXXXXXXXXXXXXXXXXX--XX---X-X||----%%%%------XXXXXXXXXXXXXXXXXXXXXXXXXXXXXXXXXX---XXXXXXXXXXXXXXXXXXXXXXXXXXXXX-XXXXXXXXXX-X----XXXXXXXXXXXXX--XXXX
XXXXXXXXXXXXXXXXXXXXXXXXXXXXXXXXXXXXXXXXXX---XXXXXXXXXXXXXXXXXXX-------X--||---XX||------XXXXXXXXXXXXXXXXXXXXXXXXXXXXXXXXXXX---XXXXXXXXXXXXXXXXXXXXXXXXXXXX-XXXXXXXXXXX-X----XXXXXXXXXXXXX--XXXX
