--------------------------------------------------------------------------------------------------------------------------------------------------------------------------------
---------------------------------------------------------------------------------------------------------------------------------------o----------------------------------------
--------------------------------------------------------------------------------------------------------------------------------------------------------------------------------
-----------------------------S--------------------------------------------------SSSSSSSSSSSSSSSS--------------------------------------------------------------------------------
------------------------Soo--------------------------------------------------------SSSSS-So-SSSS--------------------------------------------------------------------------------
------------------------SSS---------------------------------------------------------SSS-SSSSSSSS--%--%%------------------------U------------------------------------------------
--------%%%%%%%%--------SS--------------------------------------------oo-o----2%---S-S------------|--|U-----------SQQ-SSooo-----------r---------SSS---------------------------Q@
---------||||||------------------------------------------------------%%%%%---U-|------------------|--||-------------------------S-%%%%%%%%--------------------------------------
---------||||||-------------------------------------------------------|||------|------SS----------|--||----------------------------||||||---------------------------------------
---------||||||---o----ooooo------------------------------------------|||------|ooooSSS---SS--SS--|--||----------------------R-----||||||---------------------------------------
------%%%%%%%%%%-------%%-----#-----------------S---TT----------oS----|||------|--------------#---|--||-K------------SSoS---##-----|||SS|-------------------------S------------Q
-------||||||||--------||-----#---------------------TT----------------|||---TT-|SSSS----------#---|-TT|--------------------###-----|||--|---------TT----------------------------
-------||||||||--------||-----#---------------------TT---TT-----------|||---TT-|SSSS----------#---|-TT|-----TT------------####-----|||--|---------TT----------------------------
-------||||||||--------||-----#----------------g----TT---TT-----------|||k--TT-|------------kk#---|-TT|g-y--TT--------y--#####-----|||-k|--ggg----TT--g------ggg-----------gg-g-
XXXXXXXXXXXXXXXXXX-----|XXXXXXXXX---XXXXXXX----XXXXXXXXXXXXXXXXXXX--XXXXXXXXXXXX---S-------XXXXXXX|-XXXXXXX-XXXX--XXXXXXXXXXXX--XXXXXXXXXXXXXXXXXXXXXXXXXXXXXXXXXXXXXXXXXXXXXXXX
XXXXXXXXXXXXXXXXXX-----|XXXXXXXXXX--XXXXXXX----XXXXXXXXXXXXXXXXXXXX-XXXXXXXgXXXX----------XXXXXXXXX-XXXXXXX-XXXX--XXXXXXXXXXXX--XXXXXXXXXXXXXXXXXXXXXXXXXXXXXXXXXXXXXXXXXXXXXXXX
