--------------------------------------------------------------------------------------------------------------------------------------------------------------------------------
--------------------------------------------------------------------------------------------------------------------------------------------------------------------------------
--------------------------------------------------------------------------------------------------------------------------------------------------------------------------------
------------------------------------------------------------------------------------------------------------------SSSSSSSSSSS-SS------------------------------------------------
---------------------------------------------------------------------SS----S----------------------------------------------------------------------------------------------------
--------------------------------------------------------------------------------------------------------------------------------------------------##----------------------------
--------%%%%%%%%-------------------------------Q-----US-oSoo---%---SSSSSSSSSSSSS------------------------------------SUSSo-------------------------------------------------------
---------||||||----------------B-------------------------------|-----S----SS------o--------------------------------S--------------------------------------oo-------------r------
---------||||||---------------Rb-------------------------------|---SSSS---SS-------------------------------------------------------------------------------------------%%%%%%%--
---------||||||--------r------##-------------------------------|---SSSS--------o-------------------goo-r------r---------------------------------------------------------|||||---
------%%%%%%%%%%%-%%%%%%%%%--Q#---S-----S------Q----------SSSQ-S---SSSS---SSSSSS--------------%----QS--K-%%%%%%%--------------------Q------------oS---------------------|||||---
-------||||||||-|--|||||||--###-----tt--------------------------------------------------------|-----------|||||--------------------------TT-----------------------------|||||---
-------||||||||-|--|||||||-####-----tt-----tt---------B----------SSS------------#---#---------|-----------|||||-#--------##--------------TT-----------------------------|||tt---
-------||||||||-|--|||||||#####-g---tt--y--tt-g-------b------ggg---k-------k----#---#---------|---------gg|||||-#--------##--------gggg--TT----g-----------gg-g---------|||tt---
XXXXXXXXXXXXXXXX|--|||||XXXXXXXXXXXXXXXXXXXXXXXXXXXXXXXXXXXXXXXXXXSSS-XXXXXXXXXXXXX-XXX---%%%%|--X-------XX||||XX---XXXXXXX----XXXXXXXXXXXXXXXXXXXXXXXXXXXXXXXXXXXXXXXXXXXXXXXX-
XXXXXXXXXXXXXXXX|--|||||XXXXXXXXXXXXXXXXXXXXXXXXXXXXXXXXXXXXXXXXX-XXX-XXXXXXXXXXXXX-XXX----||-|--X-------XXX|||XX---XXXXXXX----XXXXXXXXXXXXXXXXXXXXXXXXXXXXXXXXXXXXXXXXXXXXXXXX-
