------------------------------------------------------------------------------------------------------------------------------------------------------------------------------------------------
------------------------------------------------------------------------------------------------------------------------------------------------------------------------------------------------
------------------------------------------------------------------------------------------------------------------------------------------------------------------------------------------------
--------------------------------SSS---------------------------------------------------------------------------------------------SSSSSSSSSSSSSS--------------------------------------------------
------------------------------------------------------------------------------------------------------------------------------------------------------------------------------------------------
-----------------------------------------------------------------oooo----ooooo------------------------------------------------------------------------------o---oooo----------------------------
--------%%%%%%%%------------------------oo---o-----QQSSQQ---------------------------------------------SS-----So-SSSSSSS------------------o---o--S--SSSQS--------%%------------------------ooo---
---------||||||--------------------------------------------------------------ooo-#------------------------------------------------------------------------------||------------------------------
---------||||||-------------------------S-----S-----------------------------------------------------------------------------------------------S-----------------||-----TT-----------------------
---------||||||-----------------------S-SSSSSSS--------g----------------------------------------------------------oo---------------------SSS--S-----------------||-----TT--o--------------------
------%%%%%%%%%%----------######----------------####--##S----S--------------------------------------S---##------SS-------------------------------SSSSSSSSS------|SS----%%%%%--------------------
-------||||||||-------------------------------------------------------------------------TT------------y###---#---------------------------#----------------------|-------|||---------------------
-------||||||||-------------------------------------------------TT----------------------TT----TT------####---##----------------------#---#----------------------|-------|||---------------------
-------||||||||-------------------------------------------------TT----------------g---k-TT----TT----######---##--------k-----g-g-----#---#-----g-----kk---------|-------|||--------------------o
XXXXXXXXXXXXXXXXXXXXXXXXXXXXXXXX---------XXXXXXXXXXXXXXXXXXXXXXXXXXXXXXXXXXXX--XXXXXXXXXXXXXXXXXXXXXXXXXXXX-XXXXXXXXXXXXXXXXXXXXXXXXXXXXXXXXXXXXXXXXXXXXXXXXXXXX|%%%%%%%%%%%--%-XXXXXXXXXXXXXXXX
XXXXXXXXXXXXXXXXXXXXXXXXXXXXXXXX-------X-XXXXXXXXXXXXXXXXXXXXXXXXXXXXXXXX-XXX-XXXXXXXXXXXXXXXXXXXXXXXXXXXXXXXXXXXXXXXXXXXXXXXXXXXXXXXXXXXXXXXXXXXXXXXXXXXXXXXXXX|-|||||||||---|-XXXXXXXXXXXXXXXX
