------------------------------------------------------------------------------------------------------------------------------------------------------------------------------------------------
------------------------------------------------------------------------------------------------------------------------------------------------------------------------------------------------
------------------------------------------------------------------------------------------------------------------------------------------------------------------------------------------------
----------------------------------------------------------------------------------------------------------------------------------------------------------------------------------SSSSS---------
-----------------------------------------------------------------------------------------------------------------------------------------------------------------------------S------------------
--------------------------------------------------------------oo---------oo----------------------------------------------------------------------o-@o--o----------------------------------------
--------%%%%%%%%----------------------SS-------S-------------%--%%%-------------------SSSSSSSSS------QQo-------------QQQ-----------------SSS---o------------------------------------------------
---------||||||----------------------------------------------|---|-------------#-----------------------------o-------------ooo-------------------@--------------------------S-------------------
---------||||||----------------------------------------------|---|------------##----------------------------------------------------------------------------------------------------------------
---------||||||------------------------------------------oooo|---|-----------##---------------o---------------------------------------------------TT--------------------------------------------
------%%%%%%%%%%---------TT-----------------------S---%%%%%%%|---|-----------##-SS----SSS-SSSSS--------###-------Soo------------------------------TT----------------SSS--------------------#----
-------||||||||---TT-----TT----------------------------|||||-|---|-----tt----##-----------------TT-----##--------------------------------------#--TT----TT--------------------K---------##-#----
-------||||||||---TT-----TT----------------------------|||||-|---|-----tt---###-----------------TT------#---#----------------------------------#--TT----TT------#----------------------#####--TT
-------||||||||---TT-----TT----------k-------------r---|||||-|---|-----tt---###-----------------TT-k-#k-k-###--------------------------------g##--TT----TT------#----k------k--------#-#####--TT
XXXXXXXXXXXXXXXXXXXXXXXXXXXXXXXXXXXXXXXXXXXXXXXX-%%%%%%%%%%|-|--XXXXXXXXXXXXXXXX--X------%%%%%%-XXXXXXXXXXXXXXXXXXXXXXXXXXXXXXXXXXXXXXXXXXXXXXXX-XXXXXXXXX---X-XXXXXXXXXXXXXXXXXXXXXXXXXXXXXXXXX
XXXXXXXXXXXXXXXXXXXXXXXXXXXXXXXXXXXXXXXXXXXXXXXX--||||||||-|-|--XXXXXXXXXXXXXXX---X-------||||--XXXXXXXXXXXXXXXXXXXXXXXXXXXXXXXXXXXXXXXXXXXXXXXXXXXXX-XXXX---X-XXXXXXXXXXXXXXXXXXXXXXXXXXXXXX--X
