-------------------------------------------------------K----------------------------------------------------------------------------------------------------------------------------------------
------------------------------------------------------SS----------------------------------------------------------------------------------------------------------------------------------------
------------------------------------------------------SS----------------------------------------------------------------------------------------------------------------------------------------
---------------------------------SS-------------------------------------------------------------SSSS--------------------------------------------------------------------------------------------
------------------------------------------------------------------------------------------------------------------------------------------------------------------------------------------------
-------------------------------------------------------------------------------o----------------------------------------------------------------------------o------------------o----------------
--------%%%%%%%%-------------------------------------------------------------------o----o------o-----------------SSS-SS-----------------------------QQQQQS----------@-QS------------------------
---------||||||-----------------S---------o---------------------S-------------------------------------------------------------------------------------------------------------------------------
---------||||||---------------------------------------------------------------------------------------------------------------------------------------------------------------------------------
---------||||||--------------------------------------------------------------------g--------------------TT---------------------o-------------------------------------------------o--------------
------%%%%%%%%%%--S-----%%%--------S---------------------------------------------####-------------------TT-------------##-------TT---SS---------SS---SSSSS--S@S-QSQo-SS@%%%%SSS-----------------
-------||||||||----------|----TT------------------------------------------------------------------------TT---TT--------##-------TT------TT----TT-------------------------||---------------------
-------||||||||----------|----TT-------TT----------------------------------------#----------------------##---TT--------##-------TT------TT----TT-------------------------||---------------------
-------||||||||----------|----TT-------TT----------%%%------------g--------------#----------------k-----##---TT------##-k-------TT------TT----TT---k---------------g-----||---------ggg-#--gk---
XXXXXXXXXXXXXXXX--XXXXXXXXX---XXXXXXXXXXXXXXXXXX----|------X----XXXXXXXXXXXXXXXXXXXXXXXXXXXXXXXXXXXXXXXXXXXXXXXXXXXXXXXXXXXXXXXXXXXXXXXXXXXXXXXXXXXXXXXXXXXXXXXXXXXXXXXXXXX--XXXXXXXXXXXXXXXXXXX
XXXXXXXXXXXXXXXX--XXXXXXXXX-----XXXXXXXXXXXXXXXX----|------X----XXXXXXXXXXXXXXXXXXXXXXXXXXXXXXXXXXXXXXXXXXXXXXXXXXXXXXXXXXXXXXXXXXXXXXXXXXXXXXXXXXXXXXX-XXXXXXXXXXXXXXXXX-X--XXXXXXXXXXXXXXXXXXX
