------------------------------------------------------------------------------------------------------------------------------------------------------------------%%------------
------------------------------------------------------------------------------------------------------------------------------------------------------------------||------------
------------------------------------------------------------------------------------------------------------------#-----------------------------------------------||------------
--------------------------------------------SS-S---------------------S--SS-------------------S-------------------##---------------------------------SSSSSSSSSSSS--||------------
---------------------------------------------------g----------U-------------------------------------------------###-----------------------------------------------||------------
----------------------------------------------------------------------------------------------------------------##------------------------------------------------||------------
--------%%%%%%%%--SSSS---------------------S----------------------------------------------------SS--------------------------------------------SSSS-----------oo---||------------
---------||||||------------------------------------------------------------------------------------oooo---------S--------ooo--------------------------------------||------------
---------||||||---------------------------------------------------------------------------------------------------------------------------------------------------||------------
---------||||||-------------------------------o-----------------------------------------------------------------------------------o-------------------------------||------------
------%%%%%%%%%%------------------------------SS--2---------------------------------------------TT--------------------------TTT---------------S-QSSS--------------||------------
-------||||||||----------TT----------------------------------#----------------------------------TT-------TT-----------------TTT--------------------------TT-------||------------
-------||||||||----------TT----#-------TT-------------------###---------------------TT----------TTT------TT------------TT---TTT--------------------------TT-------||-----TT-----
-------||||||||------y---TT----#---g---TT-------K----------####---------------------TT----k-----TTT---g--TT---------g--TT---TTT--------------------------TT-------||-----TT-----
XXXXXXXXXXXXXXXXXX--XXXXXXXXXXXXXXXX---XX--XXXX-XXXXXXXXXXXXXXXXXX-XXXX---------XXXXXXXXXXXXXXXXXXXXXXXXXXXX---XXXXXXXXXXXXXXXXX-XXX----XXXXXXXXXXXXXXXXXXXXXXXXXXXXXXXXXXX----X
XXXXXXXXXXXXXXXXXX--XXXXXXXXXXXXXXXX---XX--XXXX-XXXXXXXXXXXXXXXXXX-XXXX---------XXXXXXXXXXXXXXXXXXXXXXXXXXXX---XXXXXXXXXXXXXXXXX-XXX----XXXXXXXXXXXXXXXXXXXXXXXXXXXXXXXXXXX-----
