------------------------------------------------------------------------------------------------------------------------------------------------------------------------------------------------
------------------------------------------------------------------------------------------S-----------------------------------------------------------------------------------------------------
------------------------------------------------------------------------------------------------------------------------------------------------------------------------------------------------
----------------------------------------------------------------SS----SS-------S----------------------------------------------------------------------------------SSSSSSSSSSSSSS----------------
------------------------------------------------------------------------------------------------------------------------------------------------------------------------------------------------
------------------------------------------------------------------------------------------------------------------------------------------------------------------------------------------------
--------%%%%%%%%--------------------QSSSSS----So---------------o-----------------------------------------------------------------%%%--%%%----------------------#-SSSSSS------S-----------------o
---------||||||------------------------------------------------#SSS---------o-----------------------------------------oo----------|----|----------------------##-------------S------------------
---------||||||------------------------------------------------#------------------------------SS----------####--------------------|----|-------------------#####--------------------------------
---------||||||-----------------------------------------------##---------S----------------SSSS-----------#####------------------o-|----|-------------------#####----o---------------------------
------%%%%%%%%%%----------########Q----------------------------#------------------------------SS---------#####------------------%-|----|------------------######---SS----TT---------------------
-------||||||||----------------------------------------------###---------------------------------------#######------------------|-|----|-----------------#######S-SS-----TT---TT----------------
-------||||||||----------------------------------------#----####---#-----#-K--------------------------########------------------|-|----|---------------TT#######---------TT---TT----------------
-------||||||||--------------------kggg--------#-------#----####--#--------k-------------------------#########----o-------------|-|----|-------#--g----TT#######-----kkk-TT---TT---kkk---------g
XXXXXXXXXXXXXXXXXXXXXXXXXXXXXXXXXXXXXXXXXXXXXXXXXXXXXXXXXXXXXXXXXXXX--XXXXXX---X-XXXXXXX-----X-XXXXXXXXXXXXXXXX--%%XXXXXXXXXXXXX|-|XXXXXXXXXXXXXXXXXXXXXXXXXXXX-XXXXXXXXXXXXXXXXXXXXXXXXXXXXXXXX
XXXXXXXXXXXXXXXXXXXXXXXXXXXXXXXXXXXXXXXXXXXXXXXXXXXXXXXXXXXXXXXXXXXX--XXXX-X---X-XXXXXXX-----X-XXXXXXXXXXXXXXXX--|XXXXXXXXXXXXXX|-|XXXXXXXXXXXXXXXXXXXXXXXXXXXX-XXXXXXXXXXXXXXXXX-XXXXXXXXXXXXXX
