-----------------------------------------------------------------------------------------------------------------------------------------------------------------------K------------------------
-----------------------------------------------------------------------------------------------------------------------------------------------------------------------o------------------------
-----------------------------------------------------------------------------------------------------------------------------------------------------------------------%------------------------
--------------------------------------------------------------------------------S---------------------------------------------------------------SSS--------------------|------------------------
-----------------------------------------------------------------------------------------------------------------------------------------------------------------------|------------------------
------------------------------------------------------------------------------------------------------------------------------------------oo---------------------------|------------------------
--------%%%%%%%%------------------o---SSS-----o------------#------------------------------------------SSSS---------S--------------------------------------------%%%%---|--------------SSSS----SS
---------||||||----------------------------#--------------##----------------------------------------------------------------------------------oo-----------------||----|------------------------
---------||||||---------------------------##-SSS---------###--SS---------------------------------------------oo---------------------TT--------##--------------S--||----|------------------------
---------||||||--------------------------##----o---------###---------------------------------------------------------------#--------TT--------##---------#-------||---%%%-----------------------
------%%%%%%%%%%----------######--------###----S--------####-------------TT---------------------%------------S-----------#-#----TT-###--------##---------#-------||----|-----------QQ---S-------
-------||||||||------------------------###--------------###--------------TT---------------------|------------------------#------TT----------####--TT-----#----TT-||----|------------------------
-------||||||||-----------------------####-------------#####-------------##-----------tt--------|-----------------------###-----TT------TT--####--TT----##----TT-||----|------------------------
-------||||||||----------------------#####k-------g--#######--------------------------tt-------g|---gk---------r------#####-----TT------TT--####--TT----##----TT-||----|------or---gg-----------
XXXXXXXXXXXXXXXXXXXXXXXXXXXXXXXXXXXXXXXXXX---XXXXXXXXXXXXXXXXXXXXXXXXXXXXXXXXXXXXXXXXXXXXXXXXXXXXXXXXXXXXXXXXX%%-XXXXXXXXXX--XXXXX--XXXXXXXXXXXXXXXXXXXXXXXXXXXX-||---%%%XXXX%%%XXXXXXXXXXXXXXXX
XXXXXXXXXXXXXXXXXXXXXXXXXXXXXXXXXXXXXXXXXX---XXXXXXXXXXXXXXXXXXXXXXXXXXXXXXXXXXXXXXXXXXXXXXXXXXXXXXXXXXXXXXXXXXX--XXXXXXXXX-XXXXXXXXXXXXXXXXXXXXXXXXXXXXXXXXXXXX-||----|-XXXXX|-XXXXXXXXXXXXXXXX
