--------------------------------------------------------------------------------------------------------------------------------------------------------------------------------
--------------------------------------------------------------------------------------------------------------------------------------------------------------------------------
--------------------------------------------------------------------------------------------------------------------------------------------------------------------------------
----------------SSSSSSSSSSSSSSSS-#-----------------SSSSSSS---S--------------------------------------------------------------------------------------------------SSSSSSSSSSSSSSSS
----------------SSSSS----SS-SSS-####-----------------------------------------------------------------------g-------k-----------------------------------------------SSSSSSSSSSSS-
-----------------SS------SSS-SSS##------------------------------------oo------o-----------------------------------##---------------------------U-------------------SSSSSSSSSSSS-
--------%%%%%%%%-------------SS----#---------------------------------SS%-----------------------------------------------------------SQQSSSSSS---%-------------o----SSS----SSSSSS-
---------||||||---SSS-------SSSS---------------------------------SSSSSS|--------------------------------r-----------##-------------------------|------------------K-------------
---------||||||-o-S-----------------------------S----#------------SS---|-----------------------------%%%%%-%%%---------------------------------|--------------------------------
---------||||||-SUS----------SSS--------------------##-----------------|------------------------------|||---|-r--------------------------------|------------------S---SSSooSSSS-
------%%%%%%%%%%SS------------------TT-TT----------###---------S-------|----------S-------------------|||-%%%%%%------------------%%%%%%SS--2-SQ-----------------%%%%%%%-%%--SS-
-------||||||||---------------------TT-TT---------####---TT-----#------|-TT---------------------------|||--||||--------------------||||---------------------------|||||--||-----
-------||||||||---------------------TT-TT--------#####---TT-----#------|-TT------------TT-------------|||--||||--------------------||||----%-------------##----SSS|||||--||---S-
-------||||||||---------------------TT-TT-----k-#######k-TT-----#----y-|-TT----g-------TT-------------|||--||||-----------ggg--yK--||||---y|--k----------##-------|||||--||-----
XXXXXXXXXXXXXXXX------%--%%%----XXXXXXXXXXXXXXXXXXXXXXXXXXXXXXXXXX--XXXXXXXXXXXXXXXXXXXXXXXXXXXX-XXX--|||-XX|||-XXXXXXXXXXXXXXXX-XXX|XXXXXXXXXXXXXXXXXX-XXXXXXXX--|%%%%%%%|2--XX
XXXXXXXXXXXXXXXX------|---|-----XXXXXXXXXXXXXXXXXXXXXXXXXXXXXXXXXX--XXXXXXXXXXXXXXXXXXXXXXXXXXXX-XXX--|||-XX|||-XXXXXXXXXXXXXXXX-XXX|XXXXXXXXXXXXXXXXXX-XXXXXXXX--|-|||||-|XX-XX
