--------------------------------------------------------------------------------------------------------------------------------------------------------------------------------
-------------------------------------------K-K----------------------------------------------------------------------------------------------------------------------------------
-----------------------------------------------U--------------------------------------------------------------------------------------------------------------------------------
--------------------------------o------------%%%SSSSSSSS--SSSSSS----------------SSSSS--------------SSSSSSSSSSSSS----------------SSSSSSSSSSSSSSSS--------------------------------
----------------------------------------------|------------------------------------------------------S---oSS------------------K--SSSSSS------SSS--------------------------------
----------------------------------------------|--------------------------------------------------S--SSSSSSSS---------o-------------SS--------SSS-----------%--------------------
--------%%%%%%%%---------ooo--@---------------|----------------------------------------##--------------------S------SS-------------------------------------|--------------------
---------||||||----------------------r--------|-o----------S--------------------oo----###---------Ko---------------SS--------------------------------ooo---|--------------------
---------||||||-----------------%%%%%%%-------|---------------------------------S----####-TT----------------------SSS--------------------------------------|----%---------------
---------||||||-------------U----|||||----U---|-----------SS--------------------S---#####-TT-------S-------oooo--------------------------------------------|----|---------------
------%%%%%%%%%%---------SSS-----|||||%%%%%---#--------TT-----------------------------###-##--TT-------------%%%o----------------S-------------------------|----|---------------
-------||||||||------------------|||||-|||----#--------TT-------------------------#######-----TT--------------|-----------------SS--------------TT---------|----|---------------
-------||||||||------------------|||||-|||----#--------TT------------------------########-----TT--------------|-S---------------SSSS------------TT---------|----|---------------
-------||||||||------g-----------|||||-|||----#--------TT----------g-K----------#########-----TT--------------|------#----------------------k---TT----g----|----|---------------
XXXXXXXXXXXXXXXXX---XXXX----X--X-|||%%%|%|----X-XXXXXXXXXXXXXXXXXXXXXXXXXXXXXXXXXXXXXXXXXXXXXXXXX--------XX---|XXXXXXXXXXXXXXXXXXXXXXXXXXXXXXXXXXXXXXXX--XX|----XXXXXXXXX----XXX
XXXXXXXXXXXXXXXXX---XXXX----XX-X-|||-|g|||----X-XXXXXXXXXXXXXXXXXXXXXXXXXXXXXXXXXXXXXXXXXXXXXXXXK--------XXX--|XXXXXXXXXXXXyXXXXXXXXXXXXXXXXXXXXXXXXXXX--XX|----XXXXXXXXX----XXX
