------------------------------SS--------------------------------------------------------------------------------------------------------------------------------
----------------------------------------------------------------------------------------------------------------------------------------------------------------
-----------------------------------------------------------------------------------------------------------2----------------------------------------------------
SSSSSSSSSSSSSSSS----------------------SSSSSSSS---------------------------------------------------------------------------SSSSSSS--------------------------------
SSSSSSSSSSSSSSSS------------------------------------------------------------------------------------------------------------------------------------------------
SSSSSSSSSSSSSSSS------------------------------oo----------------------------------------------------------------------------------------------------------------
---------S--SSS-------------QQ-o--SSSSS-------SS-------------------o-----SS---@%---ySU--------@%-SQQQSSSSSQS--@%------------------------------------------------
--Ko------------------------------SSSS----------SSSS-%%%%----------------------|----------1----U---------------|---------SSSSS----------------------------------
----------------------------------SSSS----------------||-----------------------|--SSSS-S-SS----|---------------|------------------------------------------------
-U------oooooSo-----ttt------------SS-----------------||-----------------------|---------------|---------------|--------SSS-SSSo--------------------------------
------------SSS--Q--ttt--------t---SSU----------------||-TT----------------o---|-----S------##-#---Ro----QQQQQQ|-------------%%%--------------------------------
-----------SS-------ttt--------t----------------------||-TT----T---------------|-----------#-#-#---------------|--------------|---------------------------------
-------------------#ttt--------t----------------------||-TT----T------K--------|----------##---#---------------|--------------|---------------------------------
------------k------#-tt-------kt----------------------||-TT----T-k-----------g-|---------###---#---gggy--------g---k----------|---ggg-----ggg-gg---------------y
--%%%%%----2--XXXXXXXXXXXXXXXXXX---------XX----XXXXXXXXXXXXXXXXXXXXXXXXXXXXXXXXXX---XXXXXXXXXX-XXXXXXXXXXXXXXXXXXXXX----------|-XXXXXXXXXXXXXXXXXXXXXXXXXXXXXXXX
---|||-----XX-XXXXXXXXXXXXXXXXXX---------XX----XXXXXXXXXXXXXXXXXXXXXXXXXXXXXXXXXX---XXXXXXXXXX-XXXXXXXXXXXXXXXXXXXXX----------|-XXXXXXXXXXXXXXXXXXXXXXXXXXXXXXXX
