--------------------------------------------------------------------------------------------------------------------------------------------------------------------------------
---------------------------------------------K----------------------------------------------------------------------------------------------------------------------------------
----------------------------------------------Q---------------------------------------------------------------------------------------------------------------------------------
-------------------SSSSS-SSSSSSSQ--o--------------------------------------------------------------------------------------------------------------------------------------------
---------------------SSS--------------QS----------------------------------------------------------------------------------------------------------------------------------------
---------------------SS-------S---------%%---------------------U---------------------------------------------------------------------------%------------------------------------
--------%%%%%%%%--------SSSS------------||-------------@SSS----%--------------@-------------------------------------------------SS---------|--------------------%%--------------
---------||||||----------SSS---------r--r|-K--o----------------|----------------oo--------------oS----------------------------------oo-----|--------------------||--------------
---------||||||---------SSS-----%%%%%%%%%%---------------------|---------------------------------------TT----------------------------------|--------------------S|--------------
---------||||||---------SSSSS----||||||||----SrS---------------|--------------------------------S------TT----------------------------------|----------------y---S|--------------
------%%%%%%%%%%---------SS--SSS-||||||||----%%%--%-%%%%SS--2--|--2S---SU---------TT--Q-----------TT---TT-------#--------------------------|------SQ--------##---|TT------------
-------||||||||------------------||||||||-----|---|--||--------|------------------TT--------------TT-#-##-----------------------TTT--------|---------------###---|TT------------
-------||||||||------------------||||||||-----|---|--||---%%%--|------------------TT--------------TT---##-----------------------TTT---tt---|--------------####---TTT------------
-------||||||||------------g-----||||||||-----|-g-gg-||----|---|ggg----ggg--y--g--TT--------------TT---##-----------------------TTT---tt---|-------ggg----####---TTT--------o---
XXXXXXXXXXXXXXXXXXXXXXXXXXXXXXXX-%%%%%%||--2%-|---|--|XXXX-|-X-|yXXXXXXXXXXXXXXXXXXXXXXXX---XXXXXXXXXXXXXXXXXXXX-----%%-%%%%----XXXXXXXXXXX|---%XXXXXXXXXXXXXXXXXXXXXXXX--------
XXXXXXXXXXXXXXXXXXXXXXXXXXXXXXXX--||||ggg---|-|---|--|XXXX-|-X-|XXXXXXXXXXXXXXXXXXXXXXXXX---XXXXXXXXXXXXXXXXXXXXg-g--||--||-----XXXXXXXXXXX|---XXXXXXXXXXXXXXXXXXXXXXXXX--------
