--------------------------------------------------------------------------------------------------------------------------------------------------------------------------------
--------------------------------------------------------------------------------------------------------------------------------------------------------------------------------
--------------------------------------------------------------------------------------------------------------------------------------------------------------------------------
----------------------------------S----------------------------------------------S-----SS-----S-----------------SS------S-------------------------------------------------------
--------------------------------------------------------------------------------------------------------------------------------------------------------------------------------
----------------------------------------------o--------------------------------U----------------------------------------------o-------------------------------------------------
--------%%%%%%%%-----------------------#--------S-------------------------------%%-----------------------------------------------------------------------------------S---------S
---------||||||--SS----#---------SSSS-##----------------------------------------||---r------SS-----------------y-------------SS----------------------%--------------------------
---------||||||-S----###--------SS----###-TT------------------------------------%|-%%%%--------------------------------------------------------------|-------------SS-----------
---------||||||-S---####--------SS--S-###-TT------------------------------------||--||-------Sr--------------------------------S---------------------|--------------------------
------%%%%%%%%%%#---####-------------####-##--------------%%%-------------------||--||---%%%%%%%-------#----####--------------%%--------------------Q|---@----------------------
-------||||||||-----####-----------######-----TT-----------|--------------------||--||----|||||----#---#---####---------------||---------------------|--------------------------
-------||||||||-----####-----------######-----TT-----------%%-%%----------------||--||----|||||----#---#--#####---------------||----TT---------------|--------------------------
-------||||||||-#---####---------########-----TT-----------||-||---gg-g---------||--||----|||||--#-#---##-#####---------------||----TT----------k----gg--------g---k------------
XXXXXXXXXXXXXXXXXXXXXXXXX---XXXXXXXXXXXXXXXXXXXXXX--------%%%%%%XXXXXXXXXXXXXXXX|XXX||-%%%|||||-XXXXXXXXXXXXXXXX----------%%%%||XXXXXXXXXXXXXXXXXXXXXXXXXXXXXXXXXXXXXXXXXXXXXXXX
XXXXXXXXXXXXXXXXXXXXXXXXX---XXXXXXXXXXXXXXXXXXXXXX--X------||||-XXXXXXXXXXXXXXXX|XXX||--|-|||||-XXXXXXXXXXXXXXXX-----------||-||XXXXXXXXXXXXXXXXXXXXXXXXXXXXXXXXXXXXXXXXXXXXXXXX
