---------------------------------------Q----------------------------------------------------------------------------------------------------------------------------------------
--------------------------------------------------------------------------------------------------------------------------------------------------------------------------------
--------------------------------------------------------------------------------------------------------------------------------------------------------------------------------
----------------------------------------------------SSS-SSSSSSSS----------------------------------------------------------------SSSSSSSSSSSSSSSS--------------------------------
------------------------------------------------------------------------------------------------------------------------------------SSSSSSSSSSS---------------------------------
------------------------------------%------------------------------------------------o-----------------------------------------------SSSSSSSSSS---------------------------------
--------%%%%%%%%--------------------|----------------------------------------------------------------SSUSS------Q-QQQQ--QQQQQQ--------S---SSUSS---------------@%----------------
---------||||||---------------------|-----------------------------------------------S--------------------------------------------------------------------------|----------------
---------||||||---------------------|------------------------------------------------#-----------------S------------------------------------------------SSSS---|----------------
---------||||||----o----------------|-----------------o-----------------------------##--------------------------g---------------------------o------------------|----------------
------%%%%%%%%%%--yS---------#--QQQ-|-----------------S----------------------------###----------------SSSS---#--QQQ---QQQQQQQQ------------%%%S-----------------|----------------
-------||||||||-------------##------|------tt--------------------------------------###----------------------##-----------------------------|--------K----------|--TT------------
-------||||||||------------####-----tt-----tt-----------------------TT-----------#-###---------------------###----------------------------S|SSS----------------|--TT------------
-------||||||||-----------#####-ggg-tt-----tt-g---------------------TT-----------#-###-------k----------kk####--gg------K--g-gg--------o---|-----------#----y--|--TT------------
XXXXXXXXXXXXXXXXXXXXXXXXXXXXXXXXXXXXXXXXXXXXXXXXXXXXX-XXXX--XXXXXX--XXXXXXXXXXXXXXXXXXXXXXXXXXXXXXXXXXXXXXXXXXXXXXXXXXXXXXXXXXXX----------X|---XXXXXXXXXXXXXXXXX-XXXXXXXXXXXXXX-
XXXXXXXXXXXXXXXXXXXXXXXXXXXXXXXXXXXXXXXXXXXXXXXXXXXXX-XXXXX-XXXXXX--XXXXXXXXXXXXXXXXXXXXXXXXXXXXXXXXXXXXXXXXXXXXXXXXXXXXXXXXXXXX---------XX|---XXXXXXXXXXXXXXXXXXXXXXXXXXXXXXXX-
