-----------------------------------------------------------------------------------------------------------%-------------------------------------------------------------Q------
-----------------------------------------------------------------------------------------------------------|-----------------------------------------------------------------L--
-----------------------------------------------------------------------------------------------------------|--------------------------------------------------------------------
----------------------------------------------------------------------------------o------------------SS----|--------------------------------------------------------------------
-------------------k--------------------------------------------------------------Q------------------------|----------------------------------------------------------U-Q-g-----
-----------------###---------------------------------------------------------------------------------------|----------------------------------------------------------%%%%%-----
--------%%%%%%%%--------------------------------S-----r-----------QSQQQ@S------Q----------------o-----o--oS|--2%------1---------SS----------------@QQQSSSSQQS--S-------|||------
---------||||||---------oooo------------ooo-----%-SS-%%%%%-------------------------------------------------|-U-|----------------S--------------------------------------|r|----U-
---------||||||---------------------------------|-----|||----------------------------------R---------------|---|----------------S----#---------------------------%%%%%%%%%%%%---
---------||||||----------S----------------------|-----|||--------------------------------------------------|---|--------------------##----------------------------||||||||||--1-
------%%%%%%%%%%--------------------------------|2----|||---------2--------QQQ----------------#------------|---|#------------------###---TT--------------QQQQQQQ--|||||||||%%%--
-------||||||||---------------------tt----------|-----|||TT----------------------------------##------------|---|------------------####---TT-----------------------|||||||||-|---
-------||||||||---------------------tt-----tt---|---TT|||TT---------------------------------###----#-------|---|-----------------#####---TT-----------B-----------|||||||||-|---
-------||||||||-----------k-----g---tt-----tt---|---TT|||TT---gk-------------#---k--------#####--------k---|---k----------------#######--TT--------gg-b---y--gg---|||||||||-|---
XXXXXXXXXXXXXXXXXXXXXXXXXXXXXXXXXXXXXXXXXXXXXXXXXXXXXXXXXXXXXXXXXXXXXXXXXXXXXXXX-XXX---XXXXXXXXXXXXXXXXXXXXXXXXXX---XXXX-XX-XX-XXXXXXXXXXXXXXXXXXXXXXXXXXXXXXXXX--|||X|||||-|---
XXXXXXXXXXXXXXXXXXXXXXXXXXXXXXXXXXXXXXXXXXXXXXXXXXXXXXXXXXXXXXXXXXXXXXXXXXXXXXXX-XXX---XXXXXXXXXXXXXXXXXXXXXXXXXX---XXXX-XX-XX-XXXXXXXXXXXXXXXXXXXXXXXXXXXXXXXXX--|||X|||||X|---
