----------------------------------------------------------------------------------------------------------------------------------------------------------------
---------------------------------------------------------------------------------------------L------------------------------------------------------------------
------------------------------------------------t---------------------------------------------------------------------------------------------------------------
------------------------------------------------tt--------------------------------------------%%----------------------------------------------------------------
------------------------------------------------tt--------------------------------------------||----------------------------------------------------------------
------------------------------------------------tt--------------------------------------------||--------------------------------------g-g-----------------------
-----------------------oSS--------------------------------------------------------------------||SSS-----------------------------Q-Q-QQQQ------------------------
-----oooo-------------------------------------------------------------------------------r-----||----------------o-S---------------------------------------------
------%%%%%%----------------------------------##----------------------------------%-%%%%%%%---||----------------------------------------------------------------
-------||||----------------------------------###----------------------------------|--|||||----||-----------------K-----------------g---------1------------------
-------||||---------------SSS----------#----####--TT----------------------------%%%--|||||----||--TT-----T----------TT-TT---------yQQ--------#------TT----------
-------||||----------------------------#---#####-TTT---------------------TT----T-|---|||||-tt-||--TT-#---##-----#---TT-TT-----TT------------##------TT----------
-------||||----------------------------#--######--TT---------------------TT----T-|---|||||-tt-||--TT-#---##---------TT-TT-----TT%%---------###------TT----------
-------||||--------k--------y----------#-#######-TTT----------gg-----y---TT----T-|---|||||-tt-||--TT-###-##---gg----TT-TT-----TT|g----U-K-####K-----TT----------
XXXX---||||X---XXXXXXXXXXXXXXXXXXX-XXXXXXXXXXXXXXXXXXXXXXXXXXXXXXXXXXXXXXXXXXXXX-%%%%|||||-X-XX|XXXXXXXXXXXXXXXXXXXXXXXXXXXXXXXXXXXXXXXXXXXXXXXXXXX-XXXXXXXXXXXX
gXXX---|||XX---XXXXXXXXXXXXXXXXXX--XXXXXXXXXXXXXXXXXXXXXXXXXXXXXXXXXXXXXXXXXXXXX--||-|||||-X-XX|XXXXXXXXXXXXXXXXXXXXXXXXXXXXXXXXXXXXXXXXXXXXXXXXXXXXXXXXXXXXXXXX
