----------------------------------------------------------------------------------------------------------------------------------------------------------------
-----------------------------------------------------------K-K--------------------------------------------------------------------------------------------------
---------------------------------------------------------------U------------------------------------------------------------------------------------------------
--------------------------------SS----------SSSS---------------------------------------------------------------------------------------------------SSSS---------
-----------------------------------------------------------------------------------------------------------------------------------g----------------------------
-------------------#-----------------------------------------------------------------g--------------------------------------------##----------------------------
--------SQQQS-SS---------------------------------------------------------------------------------------o-------S------------------------------------------------
-------------------------------------oo----------------ooo----U-------------------SSS-----------------------------S-S-#-------------##---------------oo---------
--------------------------------------@-----------------%------------------------SS--#-------------------------------##----------------------------%%%----------
--------------------------------------------------------SS----@---------------------###-----------------------------###-----------------------------|-----------
--------QQQQ--------------------------------------%---------------SS-SSSS---------#####--TT----------------SQ-----#####--TT-------------------------|-----%%%%%-
----------------------------------------------TT--|-------------------------TT---######--TT----------------------######--TT---------------------TT--|------|||--
----------------------------------------------TT--|-------------------------##--######---TT----T----------------#######--TT----#----------------TT--|------|||--
-----gg------ggg------------------------------TT--|--------y-----ggg----gg#-##--#######--TT----T----------------#######--TT----#----------------TT--|--o---|||--
XXXXXXXXXXXXXXXXXXXXXXXXXXXXXXXXXXXXX---XXXXXXXX--|--X----XXXXX-XXXXXXXXXXXXXXXXXXXXXXXXXXXXXXXX--XXXXXX----XXXXXXXXXXXXXXX----XXXXXXXXXXXXXXXXXXX--|--%%--|||--
XXXXXXXXXXXXXXXXXXXXXXXXXXXXXXXXXXXXXX--XXXXXXXX--|--X----XXXXX-XXXXXXXXXXXXXXXXXXXXXXXXXXXXXXXXX-XXXXXX----XXXXXXXXXXXXXXX----XXXXXXXXXXXXXXXXXgX--|--||--|||--
