------------------------------------------------------------------------------------------------------------------------------------------------------------------------------------------------
------------------------------------------------------------------------------------------------------------------------------------------------------------------------------------------------
------------------------------------------------------------------------------------------------------------------------------------------------------------------------------------------------
-----------------------------------------------------------------------------------------------------------SSSSS---------------------SSSSSSSSSS-----------------------------------------SSSSSSS-
---------------------------------------------------------------o------------------------------------------------------------------S--SS---------------------------------------------------------
----------------------------------------------------------------------------------------------------------------------------------------------------------o--------o----------------------------
--------%%%%%%%%-----------------------------------------------------------------------SSS----oo------------------------o-------SSSo---------S--------------------------------------------------
---------||||||------------------#------------oo-#------------------------------o----oo%-------------------#------------------------------------------------S----------o------------------------
---------||||||---------------------------------------------------S%%%----------%------|------------------##--S--------------------------------S------------------------------------------------
---------||||||---------------------------##------------------------|-----------|------|------------------##---S-------------------ooo--------oS--------TT----------------SSSSS--------------SS-
------%%%%%%%%%%----------######---------###------------------------|-----------|------|-----------------###--------------------S-SSSSS------SSS--------TT------------##---S-------------#------
-------||||||||-------------------TT----###------TT------TT---------|-----------|------|------oo--------####--------------#-----------------------TT----TT----TT------------------------##------
-------||||||||-------------------TT---####------TT------TT---TT----|-----------|------|-----%%%-------####---------------#-----------------------TT-TT-TT----TT-----------------------###---#--
-------||||||||-------------------TT--#####------TT---y--TT---TT----|-----------|------|------|##-----######----------gg-##----#----------------k-TT-TT-TT----TT----------------------####---#--
XXXXXXXXXXXXXXXXXXXXXXXXXXXXXXXXXXXXXXXXXXXXXXXXXXXXXXXXXXXXXXXX-%%%|-%%---X----|------|-%%%--|-XXXXXXXXXXXXXXXXXXXXXXXXXXXXXXXXXXXXXXXXXXXXXXXXXXXXXXXXXXXX-XXXXXXX------------XXXXXXXXXXX-XXXX
XXXXXXXXXXXXXXXXXXXXXXXXXXXXXXXXXXXXXXXXXXXXXXXXXXXXXXXXXXXXXXXX--|-|-||---X-X--|------X--|---|-XXXXXXXXXXXXXXXXXXXXXXXXXXXXXXXXXXXXXXXXXXXXXXXXXXXXXXXXXXXXXXXXXXXX-----------XXXXXXXXXXXX-XXXX
