------------------------------------------------------------------%-------------------------------------------------------------------------------------------------------------
------------------------------------------------------------------|-------------------------------------------------------------------------------------------------------------
------------------------------------------------------------------|-------------------------------------------------------------------------------------------------------------
--------------------------------SSSSSSSSSSSSSSSS------------------|--------------------------------------------------------SSSSS------------------------------------------------
-----------------------------------------oS-----------------------|g---------------g--------------------------------------o-----------------------------------------------------
------------------------------------S--SSSS--S------------------%%%%--------------##-------------------------------------SS-----------------------------------------------------
--------%%%%%%%%---------------------------------------------Q---||------------------------------------------------------------------------QQ-----------------------------------
---------||||||----------------------oo-o------------------------||------oo-------------ooooo---o---------o---------------------------------------------------------------------
---------||||||---------%%-------%%%%%%%%------------------------||----------------------------------------------------------------------------------------------%%%------------
---------||||||---------||-------o||||||--oo---------------------||---------------------------------------------oo-------ooR--------------------------------------|--------S-SSS
------%%%%%%%%%%--------||--------||||||----------Q----SS------Q-||-------------------------------TT------------%%---%--------#--%%%----%%%%%%%%------------------|-------------
-------||||||||---------||--------||||||-------y-----------------||----------##-----tt-----tt-----TT------------||---|--------#---|------||||||-------------------|-------------
-------||||||||---------||--------||||||------#T-----------tt----||---------###-----tt-----tt-----TT------------||---|--------#---|------||||||-------------------|-------------
-------||||||||---------||-----T--||||||----k--Tggg--------tt-g-g||-----y--####-----tt-----tt-----TT---------ggg||---|------###---|------||||||---------------#---|-------------
XXXXXXXXXXXXXXXXXXXXXXXXXXXXXXXX-XXX||||---2--XXXXXXXXXXXXXXXXXXXXXXXXXXXXXXXXXXXXXXXXXXXXXXXXX-XXXXXXXXXXXXXXXX||-%%%----XXXXXX--|------|XX||XXX---XXXXX-XXXXXX%-%%%%%-%%-2----
XXXXXXXXXXXXXXXXXXXXXXXXXXXXXXXX-XXX||||--XXX-XXXXXXXXXXXXXXXXXXXXXXXXXXXXXXXXXXXXXXXXXXXXXXXXX-XXXXXXXXXXXXXXXX||--|-----XXXXXX--|------|XX||XXX---XXXXX-XXXXXXg--|||--g|------
