---------------------------------------------------------------------------------------------------------------------------------------------------------------------------------------S-S------
-------------------------------------------------------------------------------------------------------------------------------------------------------------------------------------SSSS-------
---------------------------------------------------------------------------------------------------------------------------------------------------------------------------------------S--------
----------------SSSSSS---------S----------------------------------------------------------------------------------------------------------------------------------------------------------------
---------------------------------------------------------------------------------------------------------------------------------------------------------------------------------------U-U------
-----------------------------------------------------------------------------------------------------------------------------------------------------------------------------------@--oS--------
--------%%%%%%%%-%%--%%%%%----------------------%%%%--------------------oo--------------------------QSQQ-----------SSSS-------------QQQQ-------o---------------------------------@----SSSS------
---------||||||--||---|||--------------o---------||-----------------------------------------Ko--------------------------------------------------SS------------o--------o---oo-------------------
---------||||||--||---|||------------------------||---------------------------------------------------------------------------------------------------------------------------------------------
---------||||||--||--%%%|-------------------S----||------------------------------------------------------------------------------o-------------------------------------k---------------------S--
------%%%%%%%%%%-||---|-|------------------------||---------SSS-----------------------S#---------------------US-----S------------------------U---TT--------------SS-----SSS------SQoSS@@S----SS-
-------||||||||--||---|-|------------------------||----------------------------------------------------------------------##----------------------TT---------------------------------------------
-------||||||||-%||---|-|------------------------||----------------------------------------------------------------------#----------------------TT------TT--------------------------------------
-------||||||||-|||---|-|----g-g-----------------||----------------------------#-------------------k--k-----k---------y-##---------ggg------k---TT------TT--k----------------------k------------
XXXXXXXXXXXXXXXX|||--XXXXXXXXXXX--%%%%%%%%%%%%%%XXXXXX-----XXXXXXXXXXXXXXXXXXXXXXXXXXXXXXoXXXX-XXXXXXXXXXXXXXXXXXXXXXXXXXXX-XXXXXXXXXXXXXXXXXXXXXXXXXXXXXXXXXXXXXXXXXXXXXXXX--XXXXXXXXXXX---XXXX
XXXXXXXXXXXXXXXX|||--XXXXXXXXXXX---||||||||||||-XXXXXX----XXXXXXXXXXXXXXXXXXXXXXXXXXXXXXXXX-XXXXXXXXXXXXXXXXXXXXXXXXXXXXXXX-XXXXXXXXXXXXXXXXXXXXXXXXXXXXXXXXXXXXXXXXXXXXXXXX--XXXXXXXXXXX---XXXX
