--------------------------------------------------------------------------------------------------------------------------%-----------------------------------------------------
--------------------------------------------------------------------------------------------------------------------------|-----------------------------------------------------
--------------------------------------------------------------------------------------------------------------------------|-----------------------------------------------------
------------------------------------------------SSSSSSSS-SSSSSSS----------------------------------------------------------|-----------------------------------------------------
-----------------------------------------------------S---------S----------------------------------------------------------|-----------------------------------------------------
-----------------------------o--------------------------------------------------------------------------------------------|-----------------------------------------------------
--------%%%%%%%%------------------------------------------------------------------SoSSS-SSo---------------------SS--------|--------------------o--------------------------------
---------||||||-------------SS-----------oo-------------------------------o-------------------------------------------%%--|-------------oooo---------#--------------------------
---------||||||-------------------------------------------------------------------------------------------------------||--|---------------%%------------------------------------
---------||||||--K-------------S------------------------SSSS--------------------------------y-------------------------||--|---------------||------------------------------------
------%%%%%%%%%%#-----------------------------------------S---#-------------------------------------------------------||--|---------------||----QQS-----S------Q----------------
-------||||||||-----TT----------------------TT---K---------K--#-------------TT-------gB-------------------------------||-TT---------tt----|tt-----------------------------------
-------||||||||-----TT--------------TT------TT---SS----#------#-------------TT-----#--b-K--#----------------------TT--||-TT---------tt-TT-|tt-------tt--------------------------
-------||||||||-----TT--------------TT----k-TT-----k-k-#----kk#-----------k-TT-k---#--b--------------------#------TT--g|-TT--ggg----tt-TT-|tt-------tt--------gg----------------
XXXXXXXXXXXXXXXXX---XX--------XXXXXXXXXXXXXXXXXXXXXXX--XXXXXXXXXXXXXXXXXXXXXXXXXXXXXXXXXXXXXXXXXX----X-XX--X-XX-XXXXXXXXXXXXXXXXXXXXXXXXXXXXXXXXXXXXXXXXXXXXXXXXX---XXXXX----XX-
XXXXXXXXXXXXXXXXX---XXXX------XXXXXXXXXXXXXXXXXXXXXXXX-XXXXXXXXXXXXXXXXXXXXXXXXXXXXXXXXXXXXXXXXXX----X-X---X-XX-XXXXXXXXXXXXXXXXXXXXXXXXXXXXXXXXXXXXXXXXXXXXXXXXX---XXXXX----XX-
