------------------------------------------------------------------------------------------------------------------------------------------------------------------------------------------------
------------------------------------------------------------------------------------------------------------------------------------------------------------------------------------------------
------------------------------------------------------------------------------------------------------------------------------------------------------------------------------------------------
--------------------------------------------------------------------------------SS------------------------------SS------------------------------------------------------------------------------
------------------------------------------------------------------------------------------------------------------------------------------------------------------------------------------------
-----------------------------------------o------------------------------------------------------------------------------------------------------------------------------------------------------
--------%%%%%%%%---------------------------------------------------------------------o%%S---------K-----------------------------------S---------------------------------------------------------
---------||||||-----------------------------------------------------------------------||------------------------%%%%-----------------------------------o-------------------o--------------------
---------||||||-----------------------------------------------------------------------||-----SSS-----------------||----------------------------------------------SSSSS--------------------------
---------||||||-----------------------------------------------------------------------||-------------------------||--------------------------------------ooo------------------------------------
------%%%%%%%%%%----------######---------%%%%----------------oS--------------SS-------||-----------------%%%-----||--------#--------------------------------------------------------------------
-------||||||||---------------------------||-------------TT---------------------------||------------------|----o-||--------##-------------------------------------------------------------K-----
-------||||||||---------------------------||-------------TT---------------------------||------------------|------||-------###----------TT-------------------------------------------------------
-------||||||||------------------------k--||------gggg---TT--------------------------k||------------------|------||-------##-------ggg-TT------g---g------------------------------ggggg---------
XXXXXXXXXXXXXXXXXXXXXXXXXXXXXXXX-%%-XXXXXXX|%%%%XXXXXXXXXXXXXXXX--XXX--------S-XXXXXXXXXXXXXXXXX--%--X%%%%%-----XXX-XXXXXXXXX---XXXXXXXXXXXXXXXXX%XXXXXX-----%%%XXXXXXXXXXXXXXXXXXXXXXXXXXXXXXXX
XXXXXXXXXXXXXXXXXXXXXXXXXXXXXXXX-||-XXXXXXX|-||-XXXXXXXXXXXXXXXX--XXX--------X-XXXXXXXXXXXXXXXXX--|--X-|||------XXX-XXXXXXXXX--XXXXXXXXXXXXXXXXXX|XX--XX------|-XXXXXXXXXXXXXXXXXXXXXXXXXXXXXXXX
