------------------------------------------------------------------------------------------------------------------------------------------------------------------------------------------------
------------------------------------------------------------------------------------------------------------------------------------------------------------------------------------------------
------------------------------------------------------------------------------------------------------------------------------------------------------------------------------------------------
------------------------------------------------------------------------------------------------------------------------------------------------------------------------------------------------
------------------------------------------------------------------------------------------------------------------------------------------------------------------------------------------------
---------------------------------------oooo---------------------------------------------------------------------------------------------------------------------------------------o-------------
--------%%%%%%%%---------------------------------SSSSSSo------SS--------------------------------SooS--SSSSSSSSSS------------------------------##------------------------------------------------
---------||||||--------------------------------------------------------------------------------------------------------------------%%%%-------##------------------------------------------------
---------||||||-----------------------------------------------S---------------------------------------------------------------------||-----#####------------------------------------------------
---------||||||-----------------------------------------------oo--------------------------------S------k----------------------------||-----#####-----------------------k------------------------
------%%%%%%%%%%--------------------------------###SSS-------SSS-----2--TT-------------##-------S----SSQQS--S@SS--------------------||----######---------TT------------##----------------TT-----
-------||||||||---------------------------------------------------------TT----TT----------------------------------------------------||---#######---------TT-----------------------TT-----TT-----
-------||||||||---------------------------------------------------------TT----TT----------------------------------------------------||-#########--------###-----------------------TT-----TT-----
-------||||||||------------------------------------k--g---k-k----k---k--TT----TT------#----------------------------g----------------||##########-------g###----------------k------TT-----TT-----
XXXXXXXXXXXXXXXXXX%%%%XXXXXXXXXX-XXXXXXXXXX-XXXXXXXXXXXXXXXXXXXXXXXXXXXXXXXXXXXXXXXXXXXXX--------XXXXXXXXXXXXXXXXXXXXXXX-XXXXXXXXXXXXXXXXXXXXXXX--XXXXXXXXXXXXXXXXXXXXXXXXXXXXXXXXXXXXXXXXXXXXXX
XXXXXXXXXXXXXXXXXXX||--XXXXXXXXXXXXXXXXXXXX--XXXXXXXXXXXXXXXXXXXXXXXXXXXXXXXXXXXXXXXXXXXX-------XXXXXXXXXXXXXXXXXXXXXXXX-XXXXXXXXXXXXXXXXXXRX-Xo---XXXXXXXXXXXXXXXXX-XXXXXXXXXXXXXXXXXXXXXXXXXXX
