-------------------------------------------------------------------------SS---------------------------------------------------------------------------------------------------------------------
-------------------------------------------------------------------K-SS--SSS--------------------------------------------------------------------------------------------------------------------
------------------------------------------------------------------------------------------------------------------------------------------------------------------------------------------------
----------------------------------------------------------------------------------------------------------------S---------------SSSSSSSSSSSSSSSS------------------------------------------------
---------------------------------------------------------g----------------------------------------------------------------------S--------------S---------------o--------------------------------
-------------------------------------------------------------------------------------------------------------------------------------------o---S------------------------------------------------
--------%%%%%%%%--------------------------------@S-Q---SSS-----------U-------S---------SSS-----o--------------------SS----------------------SSSS-----------------or----SSS-------------#--------
---------||||||--------------------------------------------------------------S-----%%----------------------------------------------------------------------------%%%%------------------------oo-
---------||||||-------------------------------------------------------------SS-----||-----------------------------------------------------------------------------||----------------------------
---------||||||-----------------------------------------------------------ooSS-----||-----------------------------------------------------------------------------||----------------------------
------%%%%%%%%%%----------######-----------------SQQo-UQ-----US--SSoSSU---S----S---||------------------------------SSS--------------------------------------------||-------#------#----tt-------
-------||||||||------------------------TT-------------------------------------SS---||----------------------------TT-------------TT----K-TT------TT------------K---||-------#-----##----tt-------
-------||||||||------------------------TT------------------------------------------||----#-----------------------TT-------------TT------TT------TT----------------||-----###---#-##----tt-------
-------||||||||-------------------gg---TT---k------k------k-----------U-------SS---|oy---#-----------------------TT----k----k---TT----k-TT----k-TT---kkk----kkkg--||----####--#####----tt----k--
XXXXXXXXXXXXXXXXXXXXXXXXXXXXXXXXXXXXXXXXXXXXXXXXXXXXXXXXXXXXXXXX-XXXXXXX-------XXXXXXXXXXXX-XX------X--------%--XXXXXXXXXXXXXXXXXXXXXXXXXXXXXXXXXXXXXXXXXXXXXXXXXXXXXXXXXXXXXXXXXXXXXXXXXXXXXXXX
XXXXXXXXXXXXXXXXXXXXXXXXXXXXXXXXXXXXXXXXXXXXXXXXXXXXXXXXXXX-XXXX-XXXXXXX-------XXXXXXXXXXXX-XX------XX-------|--XXXXXXXXXXXXXXXXXXXXXXXXXXXXXXXXXXXXXXXXXXXXXXXXXXXXXXXXXXXXXXXXXXXXXXXXXXXXXXXX
