-----------------------------------------------------------------------------------------------------SS-----------------------------------------------------------------------------------------
------------------------------------------------------------------------------------------------------------------------------------------------------------------------------------------------
-----------------------------------------------------------------------------------------------------S------------------------------------------------------------------------------------------
----------------------------------------------------------------SSSSSSSSS-----SS--------------------------------SSSSSSSSSSSSSSSS----------------------------------------------------------------
------------------------------------------------------------------------------------------------------------------------------------------------------------------------------------------------
------------------------------------------------------------------------------------------------------------------------------------------------------------------------------------------------
--------%%%%%%%%--------oo-----o---------------o--------------------------------------------------------%S-------or---------------------------------------------------SSS------o----------------
---------||||||--------------------------------------------ooo-------------rr---------------------------|-------%%%%-------y--------------------------------------------------------------------
---------||||||----------------------------S-SS-------------------------%%%%%%%-------------------------|--------||-----------------------------------------------------------S-#---------------
---------||||||----------------------------SoS-----------ooo-------------|||||----#---------------------|--------||----------------------oooo-----------------------------oo-SS-----------------
------%%%%%%%%%%%----------------------------S---%S-----%%%%-------------|||||--###---------------------|--------||------#-#-----SSo---%%%%%%K-----------------------------S--------------------
-------|||||||||---------------o-----------------|-------||-----o--------|||||--#-#---------------------|--------||------#-#------------||||-------------------------------K-------------TT-----
-------|||||||||--------------%%-----------------|-------||--K--%--------|||||--#-K---------------------|--------||-#--###-#------------||||-%-----------TT------------------------------TT-----
-------|||||||||--------------##---#-#-----------|-------||-----|------k-|||||-##-#----k-----k----------|------o-||-#-######-------r----||||-|--#--------TT---g----------------------k---TT-----
XXXXXXXXXXXXXXXX-%%%%--XXXXXXXXXXXXXXXXXXXXXXXXX-%%%%----||%%%%%XXX-XXXXXXXXX|XXXXXXXXXXXXXXXXXX--XXXXXX|--%%%%%XXXXXXXXXXXX-XXX-%%%%%%-||||-|--XXXXXXXXXXXXXXXXX-XX--XXX-------XXXXXXXXXXXXXXXX
XXXXXXXXXXXXXXXX--||---XXXXXXXXXXXXXXXXXXXXXXXXX--||-----||-|||---X-XXXXXXXXX|XXXXXXXXXXXXXXXXXX--XXX-XX|---|||-XXXXXXXXXXXX-XXX--||||--||||-|--XXXXXXXXXXXXXXXXX-XX--XXX-------X--XXXXXXXXXXXXX
