------------------------------------------------------------------------------------------------------------------------------------------------------------------------------------------------
------------------------------------------------------------------------------------------------------------------------------------------------------------------------------------------------
------------------------------------------------------------------------------------------------------------------------------------------------------------------------------------------------
------------------------------------------------S#-------------------------------#-----------------------------SSSS-----------------------------------------------------------------------------
---------------------------------------g-g-----------------------------------------------------------------------------------------------------------------------------------------------------#
------------------------------------------------------------------------------------------------------------------------------------------------------------------------------------------------
--------%%%%%%%%-----------------U-----S----------------------o----QS-SSSSS----S---------------#-------------------------------o------------------%----------------------------------SQS--------
---------||||||----------------------------------o%%%%--------#%------------------------------##---------------#---------------#------------------|---------------------------------------------
---------||||||------------------------------------||-------####----------------------------####-----------#-----------------###------------------|---------------------------------------------
---------||||||------------------------------------||------#####---------------------------#####-----------#--------g-------####------------------|-------------------g-------------------------
------%%%%%%%%%%----------######-SQo---@-----------||-----######-----QQQQ---SUSS--#--------#####----------##----##-###-#---#####------------------|------TT----------###------------------------
-------||||||||------------------------------------||----#######-----------------##----tt--####----------###----TT-#---#---#####------------------|------TT-------------------------------------
-------||||||||------------------------------------||---########----------------###----tt--####---------####----TT-----#---#####---------TT-------|------TT-----#-#-----------------------------
-------||||||||------------------------------------||--#########---k--------k---##-----tt######--------####-----TT-----#--######---------TT-------|------TT----##-#---------k-------------------
XXXXXXXXXXXXXXXXXXXXXXXXXXXXXXXXXXXXXXXXX----XXXXXXXXXXXXXXXX-XXXXXXXXXXXXXXXXXXXXXXXXXXXXXXXXX-------XXXXX-----XXXXXXXXXXXXXXXXXXXXXXXXXXXXXXXXXXXXXXXXXXXXXXXXXXXXXXXXXXXXXXXXXXXXXXXXXXXXXXXX
XXXXXXXXXXXXXXXXXXXXXXXXXXXXXXXXXXXXXXXXX----XXXXXXXXXXXXXXXX-XXXXXXXXXXXXXXXXXXXXX-XXXXXXXXXXX-------XXXX------XXXXXXXXXXXXXXX-XXXXXXXXXXXXXXXXX-XXXXXXXXXXXXXXXXXXXXXXXXXXXXXXXXXXXXXXXXXXXXXX
