---------------------------------------------------------------------------------------------------------------------------------------S--------------------------------------------------------
---------------------------------------------------------------------------------------------------------------------------------------S--------------------------------------------------------
---------------------------------------------------------------------------------------------------------------------------------------S--------------------------------------------------------
----------------SSSSSSSS------SS---------------------------------------------------------------------------------------------------------------oSSSSSSSS----------------------------------------
------------------------------------------------------------------------------------------------------------------------------------------------------------------------------------------------
------------------------------------------------------------------------------------------------------------------------------------------------------------------------------------------------
--------%%%%%%%%-----------------------------------------------o-----SSSSS---------------------------------%---------------------------------------------------o--------------------oQQo-------o
---------||||||--#-------------------------oo--------------oo----------------------------------------------|------o---ooo--------------o-------------------------#------------------------------
---------||||||---------------------------------------------------------------------------##---------------|------------------------------------------------------------------------------------
---------||||||------------------------------------------#SS-S-----------------o---------###---------------|------------------------------SSSSSS------------------------------------------------
------%%%%%%%%%%-----------#----------------------------##------------SS-----------------###----%S----%#%%%%SS----------------S------------------------------SSS---------TT---------------------
-------||||||||----------###---------------------------###------------------------------###--#--|-----|--||----o--------------------------------------------------TT-----TT---------------------
-------||||||||---------####---#----------------------####----------------------------#####--#--|-----|--||----%--------------------------------------------------TT-----TT---------------------
-------||||||||--------#####---#--------#------------#####--------------------------#######--#--|-----|--||----|---------------------------rrrro#------k----------TT-----TT---k-------gg--------
XXXXXXXXXXXXXXXXXXXXXXXXXXXX---XXXXX--XXX-------XXXXXXXX@X------XXXXXXXXXX--XXXXXXXXXXXXXXX-XXXX%%%%%%%%%XX----|--XXXXXXXXXXXXXX----------%%%%%%XX--XXXXXXXXXXXXXXXXXXXXXXXXXXXXXXXXXXXXXXXXXXXX
XXXXXXXXXXXXXXXXXXXXXXXXXXXX---XXXXX--XX--------XXXXXXXXXX------XXXXXXXXXX--XXXXXXXXXXXXXXX-XXXX-|||||||--X--X-|--XXXXXXXXXXXXXX-----------||||-X---XXXXXXXXXXXXXXXXXXXXXXXXXXXXXXXXXXXXXXXXXXXX
