-------------------------------------------------------------------------Q-----Q------------------------------------------------------------------------------------------------
---------------------------------------------------------------------------K-K--------------------------------------------------------------------------------------------------
--------------------------------------------------------------------------------------------------------------------------------------------------------------------------------
------------------------------------------------SSSSSSSSSSS-SSSS--ogg--------%%%------------------------------------------------------------------------------------------------
------------------------------------------------------------------QQQQQ-------|-------------------------------------------------------------------------------------------------
-------------------------------------------------------------------%%%%%%%%%%-|--------------------------------U-----------------------o----------------------------------------
--------%%%%%%%%---SQQ-SoSU------------#----------------------------||||||||--|----------------o--------------SS-----------------------------------SSSSooo----------------------
---------||||||------------------------#----------------------------||||r|||--U-%%%%%%%%%%----------------------------------------ooo------S--------------------%---------------
---------||||||-------------------SSSS-#-------S-----------------%%%%%%%%%%%%%|--||||||||-------%---------------#-----------------------------------SS----S-----|---------------
---------||||||-------------y#-----SS-##-------#------------------|||||||||||-r--||||||||-------|---------------------------------------------oo----------------|---------------
------%%%%%%%%%%--o2SUS-US--##--------###------#------------------|||||||||||%%%QQQ|||||QQQQ----|--------%%%%%----------------%---------------S----#--------##-#|---------------
-------||||||||------------###-----#--###------#------------------|||||||||||-|----|||||--------|---------|||-----------------|-TT-----TT----------#-------###-#|-TT--------TT--
-------||||||||---%-------####---S-#-####------#------------------|||||||||||-|----|||||--------|---------|||-----------------|-TT-----TT----------#------##-#-#|-TT--------TT--
-------||||||||---|ggg---#####---#-#-####-----##------------------|||||||||||-|-gg-|||||--y-ggg-|---------|||-----------------|-TT-----TT----------#-----#####-#|-TT---g-k--TT-k
XXXXXXXXXXXXXXXXX-XXXXXXXXXXXX-XXXXXXXXXXXXXXXXXXXXXXXXXXXXXXXXX-%|||%%||||%|%%-XXXXXXXXXXXXXXXX|XXX------|||-XX----------%---|-XXXXXXXXXXXXXXXXXXXXXXXXXXXXXXXXXXXXXXXXXXXXXXXX
XXXXXXXXXXXXXXXXX-XXXXXXXXXXXXXXXXXXXXXXXXXXXXXXXXXXXXXXXXXXXXXX-||ggg||ggg||||-XXXXXXXXXXXXXXXX|XXX------|||-XX----------|---|-XXXXXXXXXXXXXXXXXXXXXXXXXXXXXXXXXXXXXXXXXXXXXXXX
