--------------------------------------------------------------------------------------------------------------------------------------------------------------------------------
--------------------------------------------------------------------------------------o------------------------------------------------------------------------------------K-K--
-------------------------------------------------------------------------------------------------------------------------------------------------------------------------------U
----------------SSSSSSSSSSSSSSSSSSSSSSSS--SSSSSS--------------------o-----------------------------------------------------------------------------------------------------------
-----------------SSSSS-------SS-SSSSS-------SSSS-------------------------------------------------------------------------------------------------------------K------------------
------------------SSS--------SSS----S-----o-SSSS------------------------------------------------%%%%------------------------------------%%%--------------------U----------------
--------%%%%%%%%----------SSSSSS------------------------------------------------------r----------||--------------------------------------|---------------------%----------------
---------||||||-----------------------------------------------------------------SSS--------------||--------------------------------------|---------------------B--------ooooo-U-
---------||||||-SS--------SSS-------------TT-------------------------%%%%%%%---------#-----------||-------------------------------%%-----|--------------S------Q----------------
---------||||||-----------------SS--S-----TT---S---g------------------|||||---------##-----------||-------------------------------||-----|--oS---------------2----------------1-
------%%%%%%%%%%SS--------SS-SSS----------##---S--%%%%%%%-------------|||||---------##-----------||----S2----#-----------TT-------||-----|-%%%%---2%%--SS-----------------------
-------||||||||----#-------------S-----------------|||||--------------|||||---------##---TT------||---------##-----------TT-------||-----|--||-----||--------#---------TT-------
-------||||||||----#-------------S-----------------|||||--------------|||||---------TT---TT------||--------###-----------TT-------||-----|--||-----||-------###--------TT-------
-------||||||||----##-#------k--------------k------|||||--------------|||||---g-#---TT---TT------||----gg-#####------y---TT----#--||-----|--||-----||-----#####--------TT-------
XXXXXXXXXXXXXXXXXXXXXXXXXXXXXXXXS-----------XXXX---|||||---XXXX--X----|||XXXXXXXXXXXXXXXXXXXXXXX-XXX--XXXXXXXXX-XXXXXXXXXXXXXXXX--||---%%%%-||--%--||-XXXXXXXXXX-XXXXX-XXXXXXXXX
XXXXXXXXXXXXXXXXXXXXXXXXXXXXXXXX------------XXXX---|||||--XXXXX--XXX--|||XXXXXXXXXXXXXXXXXXXXXXX-XXX--XXXXXXXXX-XXXXXXXXXXXXXXXXK-||----||--||--|--||XXXXXXXXXXX-XXXXX-XXXXXXXXX
