--------------------------------------------------------------------------------------------------------------------------------------------------------------------------------
--------------------------------------------------------------------------------------------------------------------------------------------------------------------------------
----------------------------------------------------------------------------------------------------------------------------------Q--------1------------------------------------
----------------------------------------------------------------------------SSS----------------------S---SSSSSSS------------------------------------SSSSSSSSSSSS----------------
--------------------------------------------------------------------------------------------------------------------------------------------------------S-----------------------
--------------------------------------------------------------------------------------------------------------------------------------------------------SS--SS------------------
--------%%%%%%%%------------------------------------------S---SS------------------------oo-o--SS-------SSS-------------#--------SoSo-U----oo--@%------------SS------------------
---------||||||---------------------------------------------------------o---------K--------------------------------SS-##-----------------------|------------SS-----------U------
---------||||||-----------------------------------SSSSSSSSSSS----------%%-----------------------------------------SSS###-----------------------|--------------------------------
---------||||||--------------------------------------------------------||-------------------------------------------####-#---------------------|--------SSoSSS-----------------o
------%%%%%%%%%%--------------------------------------SSSSSSSSSS-------||-----------------S-------S----------------#####-##--------#-----@SS1--|-S-----------------------------%
-------||||||||------------------------TT------------------S-----------||------------------------------------------#####-##--------#-#g--------|--------------TT---------------|
-------||||||||------------------------TT--------S-------SSS-----------||--#--------------%%%%%%-------------#---#######-#-------#-#-#B--------|--------------TT---------------|
-------||||||||------------------k-----TT---g------K------------k------||--#----#----------||||----g-K--y---##--########-#-------#-#-#b------ggg---------k----TT---o-----------|
XXXXXXXXXXXXXXXXX---XX-----X--X-XXXXXX-XXXXXXXXXXXXXXXXXX--XXXXXXXX--X-||--X----X----------|%%|-XXXXXXXXXXXXXXXXXXXXXXXXXXXXXXXXXXXXXXXXXXXXXXXXXXX------XXX--XX--------X---XXXX
XXXXXXXXXXXXXXXXX---XX--------X-XXXXXX-XXXXXXXXXXXXXXXXXX---XXXXXX---X-||--X----K----------||||-XXXXXXXXXXXXXXXXXXXXXXXXXXXXXXXXXXXXXXXXXXXXXXXXXXX------XXX--XX--------X---XXXX
