--------------------------------------------------------------------------------------------------------------------------------------------------------------------------------
--------------------------------------------------------------------------------------------------------------------------------------------------------------------------------
--------------------------------------------------------------------------------------------------------------------------------------------------------------------------------
----------------SSSSSSSSSSSS----------------------------------------------------SSSSSSSSSSSSSSSS--------------------------------SSSSSSSSS-------SSSSSSSSSSS--SSS----------------
----------------SS--------------------------------------------------------------SSSSS-------SSS---------------------------------------------------------------------------------
----------------------------------------------------------------------------------S---------SSS----------------U----------------------------------------------------------------
--------%%%%%%%%-----------oo--------------------------------------------------U--------------S-----SSSUSS-----%---SSUSoooo----%----------------------------SSS-----------------
---------||||||--SSS-------------------------------------------------------------------------------------------|---------------|------------------------------------------------
---------||||||------------------------------------------------------------------------------------------------|-----S---SS----|%-----#---------S-------------------------------
---------||||||-----------------------SSSSS--------------------------------------------------------------------|------------y#-||-----#----------------------------gg-----------
------%%%%%%%%%%-------------%%%--------------#---#-TT------------------S-------------#-----------2-----S----QQ|-----SS-----##-#|-----#-------%%---#--#---S--------yQ-----------
-------||||||||---------------|---------------#-#---TT--------------------------------#------------------------|-----------###-#|-TT--#-------||--##--#-------------------------
-------||||||||-#---#---------|---------------#-----TT--------------------%----------------------------------#-|----------####-#|-TT--#-------||-####-#--------#----------------
-------||||||||-#---#---------|---------------#-----TT--------------------|---------#-#---------K-------U-##-#-|---------#####-#|-TT--#-------||-######------k-#---------------g
XXXXXXXXXXXXXXXXXXXXXXX-------|-----------XXXXXXXXX-XXXXXXXXXXXX-----XX---|-----XXXXXXX-----XXXXXXXXXXXXXXXXXXXXX-XXXXXXXXXXXX-X|XXXX-X---%%%%%|XXXXXXXXXXXXXXXX----XXXXXXX----X
XXXXXXXXXXXXXXXXXXX-XXX-------|-----------XXXXXXXXXXXXXXXXXXXXXX-----XX---|-----XXXXX-X---XXXXXXXXXXXXXXXXXXXXXXX-XXXXXXXXXXXX-X|XXXX-X----|||-|XXXXXXXXXXXXXXXX----XXXXXXX----X
