------------------------------------------------------------------------------------------------------------------------------------------------------------------------------------------------
----------------------------------------------------------------------------------------------------------------------S-------------------------------------------------------------------------
------------------------------------------------------------------------------------------------------------------------------------------------------------------------------------------------
------------------------------------------------SSSSSSSSSS------SSSSSSSSSSSSSSSS--------------------------------------------------------------------------------------SSSSSS--------------------
------------------------------------------------------------------------------------------------------------------------------------------------------------------------------------------------
---------------------------------------------------------------------------------------------------------------------------------------------------------------------------------oo-------------
--------%%%%%%%%-------------------------------U-----------#---------------------%---------------------------------------------------%-----------------Qoo-----o--------------------------------
---------||||||--------------------------------------------#---------------------|-------------#-------------------------------------|-----------------------------------------------------o----
---------||||||------------------------------------------###-SSS-----------------|------------##-------------------------------------|----------------------------------------------------------
---------||||||-----------------oo--------------oo-------###---------------#-----|-----------###--------------------------SSS--------|------------------------------------SS--------------------
------%%%%%%%%%%----------######------------------------####-------------#-#-----|-----------###---------TT--------------------------|-----------##-------##------------------------------------
-------||||||||------------------------TT-------------y#####-----------###-#-----|----------####---------TT-------S------------------|-----------###------#-------------------------------------
-------||||||||------------------------TT-------------#######--------#-#####-----|------TT-#####---------TT--------------------------|-----------##------##----------------------------------K--
-------||||||||-------------------ggg--TT--g---------########--g-##-########-#---|------TT-#####---------TT-----------------------kk-|-k-------g-###----###-k-------#------------------------#--
XXXXXXXXXXXXXXXXXXXXXXXXXXXXXXXXXXXXXXXXXXXXXXXXXXXXXXXXXXXXXXXXXXXXXXXXXXXXXX-X-|-XXXXXXXXXXXXXXXXXXXXXXXXXXXXXXXXXXXXXXXXXXXXXXXXXXXXXXXXXXXXXXXXXXXXXXXXXXXXXXXXXXXXXXXXXXXXXXXXX--XXXXXX-X--
XXXXXXXXXXXXXXXXXXXXXXXXXXXXXXXXXXXXXXXXXXXXXXXXXXXXXXXXXXXXXXXXXXXXXXXXXXXXXX-X-|-XXXXXXXXXX-X-XXXXXXXXXXXXXXXXXXXXXXXXXXXXXXXXXXXXXXXXXXXXXXXXXXXXXXXXXXXXXXXXXXXXXXXXXXX-XXXXXXXX--XXXXXX-X--
