-------------------------------------------------------------------------------------------------------------------------------------%------------------------------------------
-------------------------------------------------------------------------------------------------------------------------------------|------------------------------------------
-------------------------------------------------------------------------------------------------------------------------------------|------------------------------------------
--------------------------------------------SS-S------------------------------------------------SSSSSSSSSSSS-SS-SSSSSSSSSSSSSSSS-----|------------------------------------------
-------------------------------------------------------------------------------------------------------------------------------------|------------------------------------------
---------------------------------------------------------------------------------------------------------------U---------------------|------------------------------------------
--------%%%%%%%%--SQQSSK---------------------o------------------------o------------SSUSoSSQ---@%---oSSS--oo------------------S-------|----------------r-------------------------
---------||||||-----------------------------SS-------------------------------------------------U---------------------------SSS-------|----------%%%%%%%%%-----------------------
---------||||||--------------------------------------------------------------------------------|------S------------------------------|-----------|||||||----------------SSSS-g--
---------||||||--------------1----------------oo---------------------------------------------R-|------------y#-----------------------|-----------|||||||---------------------#--
------%%%%%%%%%%-------SSSSQ##-----------------%-----------Q----------------------SSoUSS-----#-|------S-----####--------------S------|----------SSS||||S----TT---------S----##-#
-------||||||||------------###------TT---------|----------------------------TT--------------##-|-----------#####---------------------|-------------||||-----TT-------------###-#
-------||||||||-----------####------TT---------|----------------------------TT-------------###-|---#------######---------------------|-------------||||-----TT------------####--
-------||||||||----------#####------TT---------|---#-k-------k---------k----TT-----g--yg-k####-|-k-#-----#######---------------------|-##----------||||--y--TT---k-------#####--
XXXXXXXXXXXXXXXXXXXXXXXXXXXXXXXXX---XXXX-XXX--XXXXXXXXXXXXXXXXXXX---XXXXXXX-XXXXXXXXXXXXXXXXXXXXXXXXXXXXXXXXXX-XXX--------XXXXXXXXXXXXXXXXXXXXXXXXXXXXXXXXXXXXXXXXXXXXXXXXXXXX-X
XXXXXXXXXXXXXXXXXXXXXXXXXXXXXXXXXX--XXXX-XXX--XXXXXXXXXXXXXXXXXXX---XXXXXXX-XX--XXXXXXXXXXXXXXXXXXXXXXXXXXXXXX-XoXX-------XXXXXXXXXXXXXXXXXXXXXXXXXXXXXXXXXXXXXXXXXXXXXXXXXXXX-X
