----------------------------------------------SS--------------------------------------------------------------------------------------------------------------------------------
--------------------------------------------------------------------------------------------------------------------------------------------------------------------------------
---------------------------------------------------------------------------------------------------------------------------2----------------------------------------------------
----------------SSSSSSSSSSSSSSSS----------------------SSSSSSSS---------------------------------------------------------------------------SSSSSSS--------------------------------
----------------SSSSSSSSSSSSSSSS------------------------------------------------------------------------------------------------------------------------------------------------
----------------SSSSSSSSSSSSSSSS------------------------------oo----------------------------------------------------------------------------------------------------------------
--------%%%%%%%%---------S--SSS-------------QQ-o--SSSSS-------SS-------------------o-----SS---@%---ySU--------@%-SQQQSSSSSQS--@%------------------------------------------------
---------||||||---Ko------------------------------SSSS----------SSSS-%%%%----------------------|----------1----U---------------|---------SSSSS----------------------------------
---------||||||-----------------------------------SSSS----------------||-----------------------|--SSSS-S-SS----|---------------|------------------------------------------------
---------||||||--U------oooooSo-----tt-------------SS-----------------||-----------------------|---------------|---------------|--------SSS-SSSo--------------------------------
------%%%%%%%%%%------------SSS--Q--tt-------------SSU----------------||-TT----------------o---|-----S------##-#---Ro----QQQQQQ|-------------%%%--------------------------------
-------||||||||------------SS-------tt--------------------------------||-TT--------------------|-----------#-#-#---------------|--------------|---------------------------------
-------||||||||---------------------tt--------------------------------||-TT-----------K--------|----------##---#---------------|--------------|---------------------------------
-------||||||||-------------k------##t--------k-----------------------||-TT----g-k-----------g-|---------###---#---gggy--------g---k----------|---ggg-----ggg-gg---------------y
XXXXXXXXXXXXXXXX--%%%%%----2--XXXXXXXXXXXXXXXXXX---------XX----XXXXXXXXXXXXXXXXXXXXXXXXXXXXXXXXXX---XXXXXXXXXX-XXXXXXXXXXXXXXXXXXXXX----------|-XXXXXXXXXXXXXXXXXXXXXXXXXXXXXXXX
XXXXXXXXXXXXXXXX---|||-----XX-XXXXXXXXXXXXXXXXXX---------XX----XXXXXXXXXXXXXXXXXXXXXXXXXXXXXXXXXX---XXXXXXXXXX-XXXXXXXXXXXXXXXXXXXXX----------|-XXXXXXXXXXXXXXXXXXXXXXXXXXXXXXXX
