----------------------------------K-----------------------------------------------------------------------------------------------------------SS--------------------------------
-----------------------------------Q--------------------------------------------------------------------------------------------------------------------------------------------
--------------------------------------------------------------------------------------------------------------------------------tt----------------------------------------------
-------------------------------------------------------------------------------------------------------------------o------------tt------------------------------SSSSSSSSSSSSSSSS
-----------------------------------k-------------------------------------------------------@------------------------------------tt-----------------g------------------S--SS-----
---------------------------------------------------------------U----------------------------------------------------------------tt----------------##------------------SSSSS-----
--------%%%%%%%%---------------------------------------------------------------S---------------2SS------QQSQQSSS----------------##------------------------------------------SSS-
---------||||||-----------------------------------------------------S--------------------------#-------------------------------------o--------------------------------o---------
---------||||||---------------------------------------------------S--#-----------------------y-Q----------------%----------------------%%%%%----------------------%%%%%---------
---------||||||-----------------------------------------------------##-----------------------2------------------|-----------------------|||------------------------|||-r---r-Sr-
------%%%%%%%%%%-oSSS-------TT-------------------------------###---####-----##-#--%%%%%%%%%---#---%------%%%%%%%|------%%%%%%%%-TT------|||-------------------#-%%%%||%%%%%%%%%%
-------||||||||-----K-------TT-------------------------------##----#####---#---#---|||||||---##---|-------|||||-|-TT----||||||--TT----k-|||-------------------#--||-||-||||||||-
-------||||||||-------------TT------TT----------------------###--#######---#---#---|||||||--###---|-------%%%%%-|-TT----||||||--TT---###|||----------------------||-||-||||||||-
-------||||||||---g-------k-TT------TT--g------------------####-########-#-----#K--|||||||-####---|--------|||g-|-TT----||||||--TT---###|||-------------y---#-#--||-||-||||||||-
XXXXXXXXXXXXXXXXXXXXXXXXXXXXXXXXXXXXXXXXXXXXXXXX---X----X-XXXXXXXXXXXXXXXXXXXXXX%--|||||XXXXXXXX--|--X-----|||X-|XXX----||%%%|--XXXXXXXXXXXXXXXXXXXXXXXXXXXXXXXX-||%%%%%%%|||||-
XXXXXXXXXXXXXXXXXXXXXXXXXXXXXXXXXXXXXXXXXXXXXXXX---X---XX-XXXXXXXXXXXXXXXXXXXX-X|--|||||XXXXXXXX--|--X-----|||X-|XXX----||-|-|--XXXXXXXXXXXXXXXXXXXXXXXXXXXXXXXX-||-|||||-|||||-
