--------------------------------------------------------------------------------------------------------------------------------------------------------------------------------
-----------------------------------------------------------------------------K--------------------------------------------------------------------------------------------------
--------------------------------------------------------------------------------------------------------------------------------------------------------------------------------
------------------------------------------------------------------------------------------------------SS-SSSSSSSSSSSSSS-------------------------SSSSSSSSSSS-SSSS----------------
--------------------------------------------------------------------------g--------k----------------------o---------------------------------------------------------------------
-------------------------------------------------------------------%%%%%%%%------------------------------SS-------------------------------oo---oSS------------------------------
--------%%%%%%%%----------------------------------------------------||||||------------------------------------------------------%%%---------------------------------------------
---------||||||---------------------##------------------------------||||r|----U---------oooo--------------------------#----------|--------------ooo-----------------------------
---------||||||------------------------------------------%%---------|%%%%%%%%%---------------------------------------##--TTTT----|--------------SS--------------S---------------
---------||||||------------------------------------------||---------|-|||||||-r-----------S------ooo------o---------###--TTTT----|---------------K----#-------------##----------
------%%%%%%%%%%-----------------------------------------||----Q----|-|||||||-%%----------------%%%%----------S---#####--#######-|--------------------#------------#-----TT-----
-------||||||||------------------------------------------||---------|-|||||||-||-------TT--------||-----------#---######---------|TT----------------#-#-----------##-#---TT-----
-------||||||||----------TT---------TT-------------------||tt-------|-|||||||-||-------TT--------||-----------#-########---------|TT--------##--#---#------------#####---TT-----
-------||||||||-------gg-TT----g----TT-------------------||tt-------|-|||||||-||-------TT-----#--||-----------#-########---------|TT--------##--#---#-#---------######---TT-----
XXXXXXXXXXXXXXXXXXXXXXXXXXXXXXXXXXXXXXXXXXXXXXXX-XXXXXXXXXXXXXXX----|-|||||||-||XXXXXX-XXXXXXXXX-||--%----XXXXXXXXXXXXXXX-X-XXXXXXXXXXXXX---XXXXX---X-X--------XXXXXXXXXXXXXXXXX
XXXXXXXXXXXXXXXXXXXXXXXXXXXXXXXXXXXXXXXXXXXXXXXX-XXXXXXXXXXXXXXX----|-|||||||-||XXXXXX-XXXXXXXXX-||--|---XXXXXXXXXXXXXXXX---XXXXXXXXXXXXX---XXXXX---X-X--------XXXXXXXXXXXXXXXXX
