--------------------------------------------------------------------------------------------------------------------------------------------------------------------------------
--------------------------------------------------------------------------------------------------------------------------------------------------------------------------------
------------------------------------------------------------------------------------------------------------------------------Q-------------------------------------------------
--------------------------------------------------------------------------------------------------SSSSSSSSSSSSS-----------------------------------------------------------------
--------------------------------------------------------------------------------------------------------------------------------------------------------------------------------
--------------------------------%%%---------------------------------------------------------------------------------------------------------------------------------------------
--------%%%%%%%%-----------------|----------------------------------------------Q-------SQQS-----SSSooS---------------------------------------------------------S--K------------
---------||||||-%----------------|-------o-------------------------------------------%------------SSS-------------------r---------SS--------------------------------------------
---------||||||-|---------U------|---------------------------------------------------|------------SSS-----------------%%%%%%%%%-------------------------------------------------
---------||||||-|----------------|-o----SSS----------------K-------g-----------------|---------------------------------|||||||g-------------------------------------------------
------%%%%%%%%%%|@---------------|-S----------#--%------------#-----Q-----------QQQQQQQQQQQQQ------------TT------------|||||||-----------TT-----SSS----------------------#------
-------||||||||-|----------------|------------#--|-----------##------------------------------------------TT-------TT---|||||||--TT-------TT---TT-----------tt-------------------
-------||||||||-|----------------|----------###--|----------###-#----------------------------------------TT-------TT---|||||||--TT--#----TT---TT-----------tt-----##------------
-------||||||||-|---------k----k-|----------###--|----------###-#----------------g--g----------g-----y---TT-------TT---|||||||--TT--#----TT---TT--g--------tt-g---##-#----------
XXXXXXXXXXXXXXXXXXXXXXXXXXXXXXXXXXXXXX-XXXXXXXXX%|%%%%--X--XXXX-XX-XXXXX------%%XXXXXXXXXXXXXXXXXXXXXXXXXXXXXXXX-XXXX--|XXXXXXXXXXXXXXXXXXXXXXXXXXXXXXXXXXXXXXXXXXXXXXXXXXXXXXXX
XXXXXXXXXXXXXXXXXXXXXXXXXXXXXXXXXXXXXX-XXXXXXXXXg|-||---X--XXXX-gX-XXXXXX-X---||XXXXXXXXXXXXXXXXXXXXXXXXXXXXXXXX-XXXX--|XXXXXXXXXXXXXXXXXXXXXXXXXXXXXXXXXXXXXXXXXXXXXXXXXXXXXXXX
