--------------------------------------------------------------------------------------------------------------------------------------------------------------------------------
-------------------------------------------------------------------------------------------K-K----------------------------------------------------------------------------------
----------------------------------------------------------------------------------------------Q---------------------------------------------------------------------------------
-----------------------------------SSSSS----------------------------------------o-------------------------------SSSSSSSSS-------SSSSSSSSSSSSSSSS--------------------------------
--------------------------------------------------------------------------------------------------------------------------------------S-----------------------------------------
---------------------------K---U-------------------------------------------------------%%%%------------------------------------------SS-----------------------------------------
--------%%%%%%%%--@Q----y------%---oSSSSo---------S----------------r--r--r--------------||-----------U--oooo--@%-------#--------------------------------------------------------
---------||||||----------------|-------------------SS-----------%%%%%%%%%%--------------||---------------------|------##--------------------------------------------------------
---------||||||----------------|------SSSSS----------------------||||||||---------%%%%%-||------S----#---SS-y--|SS---###----------%%%%%---K-------------------------------------
---------||||||--------------2-|------------y--------------------||||||||----------|||-o||---Sr-----#----------|----####-----------|||--------o---------------------------------
------%%%%%%%%%%%-%%--%%%%%y---|-----SSS-SSSSS------------------QS|||Q|||----------|||--|%--%%%%---####---SSQ--S--#####--TT--------|||--------------Q---------------------------
-------||||||||-|-||---|||-----|-----------###--------------------|||-|||TT-----T--|||--||---||----####-----------######-##--------|||---------------------------K----------###-
-------||||||||-|-||---|||-----|---------S####--------------------|||-|||TT-----T--|||--||---||--######---------########-##--------|||-------------------------#-----------####-
-------||||||||-|-||---|||-----|---------###----------#--------#--|ggg|k|TT---ggT--|||--||---||--######---------########-##--------|||----------------o--------#k-K-------#####-
XXXXXXXXXXXXXXXX%-%%%--|||-----|XXXXXXXXXXXXXX-XXXXXXXXXXXXXXXXXXXXXXXXXXXXXXXXXXX-|||%-%%---||-XXXXXXXXX---XXXXXXXXXXXXXXXXXXXX-XXX||-----XXXX-X----X---XXX--XXXXXXXXXXXXXXXXXX
XXXXXXXXXXXXXXXXg--|---|||-----|XXXXXXXXXXXXXX-XXX-XXXXXXXXXXXXXXXXXXXXXXXXXXXXXgX-||||-g|---||-XXXXXXXXX---XXXXXXXXXXXXXXXXXXXX-XXX||-----XXXX-X----X---XXX--XXXXXXXXXXXXXXXXXX
