--------------------------------------------------------------------------------------------------------------------------------------------------------------------------------
---------------------------------------------------------------------------------------------------------------------------K---------------K-K----------------------------------
------------------oo-----------------------------------------------------------------------------------------------------------U--------------QU--------------------------------
------------------------------------------S---------------SSSSSS----------------------------------------------------------------------------------------------------------------
--------------------------------------------------------------------------------------------------------------------------------------Q-----------------------------------------
------------------------------------------------------------------------------------------------------------------------------------%%%%%-------------------------##------------
--------%%%%%%%%-SQQS---------QQ--SSSSSS-------------SSSSSS----------Q--QQQS--SSS---------------------------------U-Q----------------|||----------------------------------------
---------||||||--------------------SS-------------------------------------------SSSooo----------%%%%%%%%-----------------------------|||r-----U--------------------------oo-----
---------||||||-------------------SSSS-----------------------------------------------------------||||||------------------------------||%%%-%%-----------------------------------
---------||||||----------------------------------------------------------------------------------||||||----------------r-------------||r|--||----------------------------S------
------%%%%%%%%%%--------------QQ---SoS---#-----#--SS--S------S----------QQSQQQQo---------TT-----Q||||||---------%%%%%%%%%%%-----%%%%%%%%%%%%%%%%---------TT---------------------
-------||||||||--------------------------##----#-------------#---------------------------TT----T-|||TT|-----TT---|||||||||-------||||||||||||||----------TT---------------------
-------||||||||------------B-------------##----#------------##----------------------#----TT----T-|||TT|-----TT---||||||||%%%%%%--||||||||||||||---TT-----TT----T------------##--
-------||||||||----K-K-----b--g------y---##----#---g------####---g---g--K----ggg----#-#--TT----T-|||TT|-----TT---||||||||-||||---||||||||||||||---TT-----TT----T--k---------##--
XXXXXXXXXXXXXXXXXXXXXXXXXXXXXXXXX---XXXXXXXXXXXXXXXXXXXXXXXXXXXXXXXXXXXXXXXXXXXXXXXXXXXXXXXXX--XXXXXXXXXXXXXXXXX-||||||||-||||---||||||||||||||-XXXXXXXXXXXXXXXXXXXXXXXXXXXXXXXX
XXXXXXXXXXXXXXXXXXXXXXXXXXXXXXXXX---XXXXXXXXXXXXXXXXXXXXXXXXXXXXXXXXXXXXXXXXXXXXXXXXXXXXXXXXX--XXXXXXXXXXXXXXXXX-||||||||-||||---||||||||||||||-XXXXXXXXXXXXXXXXXXXXXXXXXXXXXXXX
