----------------------------------------------------------------------------------------------------------------------------------------------------------------
-------------------------------------------------------------K--------------------------------------------------------------------------------------------------
--------------------------------t-----------------------------------------------------------------Q-------------------------------------------------------------
--------------------------------t-----------------------------------------------SSSSSSSSSSSSSSSS----------------------------------------------------------------
--------------------------------t----------------------------------------------------SSS-SSS--oo----------------------------------------------------------------
--------------------------------t-------------------%%-K-----------------------------SS--SSS---S----------------------------------------------------------------
--------------------------------S-------------------||-----------------#----------US-----SSS----QQQQQQSQSQS---@S-------SQSS@--SS-----oR-oo----2S----------------
------------------oo--------------------r-----------||----------oSS---##------------------------------------------------------------S--------------------oooo---
--------------------------------------%%%%%%%-------||----------S----###----------------%--------------------------------------------#-----------------%%%%%%---
---------------------------------------|||||--------||--------------####----------------|--o--S------------gg1----------------------##------------------||||----
---L-USS2---------------------TT--TT---|||||--------||-%%-----#----####--TT-----%%%%%%%%%%----#------------QQ---------S@---SQ----#--##------------------||||----
------------------------------TT--TT---|||||--------||-||----##---######-##------||||||||----##-------------##------------------#---##---TT----#--------||||----
------------------------------TT--TT--tt||||--------||-||---###--######--TT-----SS|||||||----##---------B-##-#------------------#---##---TT----#--------||||----
----------------T-------------TT--TT--tt||||--------||-||--####-########-TT-------|||||||-----#----g-g--b-####---g-----gg---y---#---##---TT----#--------||||----
XXX-XXXXXXX-----XXXXXXXXXXXXXXXX-XXXXXXXXXXXXXXX-XXX|XXXXXXXXXX-XXXXXXXXXXXXXXXX--%%%%|||----XX-XXXXXXXXXXXXXXXXXXXXXXXXXXXXXXXXXX--XXXXXXXXXXXXXXXXXXXXXXXXXXXX
XX--XXXXXXX-----XXXXXXXXXXXXXXXXXXXXXXXXXXXXXXXX-XXX|XXXXXXXXXX-XXXXXXXXXXXXXXXXg--||-|||----XU-XXXXXXXXXXXXXXXXXXXXXXXXXXXXXXXXXX--XXXXXXXXXXXXXXXXXXXXXXXXXXXX
