------------------------------------------------------------------------------------------------------------------------------------------------------------------------------------------------
-------------------------------------------------------------------------------------------------K---------------------------------------------------------------K------------------------------
------------------------------------------------------------------------------------------------------------------------------------------------------------------------------------------------
------------------------------------------------------------------------------------------------------------------------------------------------------------------------------------------------
--------------------------------------%%--------------------------------------------------------------------------------------------------------------------------------------------------------
--------------------------------------||---------ooo--------------------------------------------------------------------------------------------------------------------------------------------
--------%%%%%%%%----------------------||--oo-----%%%----------------QSQQQS------------------------------------------------------------------------------------------QQQQQ-----------------------
---------||||||-----------------------||---r------|----------------------------------------#-----------------S--------------oo------------------------------------------------------------------
---------||||||--------------------SSSSSS-SS-S----|-------------------------------------------------------------------TT------------------------------------------------------------------------
---------||||||----------------------------ooSSS--|--------------------g--------ooo-------S---------------------------TT------------------------------------------------------------------------
------%%%%%%%%%-TT-----TT-------S-----------------|----TT--#----####SSSSS----U--SSS------#-----------------------S----##----------------------#--------TT--------#------------------------------
-------|||||||--TT-----TT-------------------------|----TT--#-----------------#---------###--------TT-----TT-----------------------------TT---##-TT---U-TT---------------------------------------
-------|||||||--TT-----TT----TT-------------------|----TT--#-----------------##-------####--------TT-----TT-----------------------------TT--###-TT-----TT---------------------------------------
-------|||||||--TT-----TT----TT-------------------|----TT--#--------------k-###------#####--------TT-----TT-----------------------------TT--###-TT-----TT----g-----k--k---------g---------------
XXXXXXXXXXXXXXXXXXXXXXXXXXXXXXX----------%%%%S%-XXXXXXXXXXXXXXXXXXXXXXXXXXXXXXXX-XXXXXXXXX-----XXXXXXXXXXXXXXXXXXXXXXXXXX-XXXXXXXXXXXXXXXXXXXXXXXXXXXXXXXXXXXXXXXXXXXXXXXXXXXXXXXXXXXXXXXXXXXXXX
XXXXXXXXXXXXXXXXXXXXXXXXXXXXXXX-----------||--|-XXX-XXXXXXXXXXXXXXXXXXXXXXXXXXXXXXXXXXXXXX-----XXXXXXXXXXXXXXXXXXXXXXXXXX-XXXXXXXXXXXXXXXXXXXXXXXXXXXXXXXXXXXXXXXXXXXXXXXXXXXXXXXXXXXXXX-XXXXXXX
