------------------------------------------------------------------------------------------------------------------------------------------------------------------------------------------------
------------------------------------------------------------------------------------------------------------------------------------------------------------------------------------------------
------------------------------------------------------------------------------------------------------------------------------------------------------------------------------------------------
------------------------------------------------SSSSSSSSSSS-------------------------------------SSSSSSSSo-------------------------------------------------------SSSSSSS--SSSSSSS----------------
------------------------------------------------------------------------------------------------------------------------------------------------------------------------------------------------
-----------------------------------------------------------------------------------------------o-------------------S%#-SS-o---------------------------------------------------------------------
--------%%%%%%%%-------------------------------------------------------------------------------@--rrr---------------|2---------------------------------------------------------------SSSSSS----o
---------||||||----------------------------------------------------------------%----------------%%%%%%%%------------|---------------------------------------------------------------------------
---------||||||-----------------------------------------------------oo---------|-----------------||||||---%%%-------|------------------------------SSS--------S---------------------------------
---------||||||-----------------------------------------------------%%---------|-o---------------||||||----|--------|-----o------------------------------------------------------o--------------
------%%%%%%%%%%----------######-------tt--------##--2--------------||---------|-SS-----%%%%-----||||||----|--------|-----------------------------------------------------------SS--------------
-------||||||||------------------------tt--------##-----------------||---------|---------||------||||||----|--------|-------------------TT------------------------------TT----------------------
-------||||||||------------------------tt-------TT------------------||---------#---------||--#%%%%|tt-|----#--------|-------------TT----TT----TT------------------------TT---TT-----------------
-------||||||||------------------------tt--gy---TT-----y----kkk-----||----g---##--gg-----||----||-|tt-|----#---#----|-------------TT----TT----TT------------------g-----TT---TT---ggggg---k-----
XXXXXXXXXXXXXXXXXXXXXXXXXXXXXXXXXXXXXXXXXXXXXXXXXXXXXXXXXXXXXXXX----||XXXXXXXXXXXXXXXXXXXXXXXX-||-|XXXXXXXXXXX-X--XXXXXXX----%%%XXXXXXXXXXXXX-XX---XX--------%%-XXXXXXXXXXXXXXXXXXXXXXXXXXXXXXXX
XXXXXXXXXXXXXXXXXXXXXXXXXXXXXXXXXXXXXXXXXXXXXXXXXXXXXXXXXXXXXXXX----||XXXXXXXXXXXXXXXXXXXXXXX--||-XXXXXXXXXXXXXX--XXXXXX------|-XXXXXXXXXXXXX-XX---XX--------||-XXXXXXXXXXXXXXXXXXXXXXXXXXXXXXXX
