-------------------------------------------------------------------------------------------------------S-----------------------------------------------K----------------------------------------
-------------------------------------------------------------------------------------------------------------------------------------SS---------------------------------------------------------
------------------------------------------------------------------------------------------------------------------------------------------------------------------------------------------------
----------------------------------------------------------------------------------------------------------------------------------------------------------------SSSSSSS-------------------------
------------------------------------------------------------------------------------------------------------------------------------------------------------------------------------------------
----------------------------------------------------------------------------------------------------------------------------------------------------------------------------------o-------------
--------%%%%%%%%-----------------%%-------oo------o--SSSS-----SS#---------------%%%%%------%------------------------------------------------------------%---------------------------------------
---------||||||------------------||-----------------------------S----------------|||-------|---------------------#-------------o------------------------|---------------------------------------
---------||||||------------------||-----------------------------S----------------|||-------|------------------------------------------------------------|---------------------------------------
---------||||||------------------||--%%------------------------------------------|||-------|-----------------------------------#----------o-------------|---------------------------------------
------%%%%%%%%%%----------######-||--||------------------------------------------|||---%%%%%%%%-------------------------------##----------------%-------|--------------TT-------#-#-###---------
-------||||||||------------------||--||-------------------#------------TT--------|||----||||||--------------------------------##---------------o|-------|--------------TT-------#--------------#
-------||||||||------------------||--||------------------##------------TT------#-|||----||||||-------------------------------###----------------|-------|--------------TT---#-TT-------------###
-------||||||||-----------------%%%--||---k---------ggg-###------------TT----###-||g-g--||||||------------------------------####----------------|-------|------------##TT--##-TT-------g----g###
XXXXXXXXXXXXXXXXXXXXXXXXXXXXXXXX-|---XXX-XXXXXXXXXXXXXXXXXXXXXXXXXXXXXXXXXXXXXXX%%%XXXX-XXXX|%%%------X%%%%%%---XXXXXXXXXXXXXXXX--%%%%%--------X|-------XX------XXXXXXXXXXXXXXXXXXX--XXXXXXXXXXX
XXXXXXXXXXXXXXXXXXXXXXXXXXXXXXXX-|---XXX-XXXXXXXXXXXXXXXXXXXXXXXXXXXXXXXXXXXXXXX-|XXXX--XXXX|-|---------|||X----XXXXXXXXXXXXXXXX---|||---------X|-------XX------XXXXXXXXXXXXXXXXXXX--XXXXXXXXXXX
