----------------------------------K-----------------------------------------------------------------------------------------------------------SS--------------------------------
-----------------------------------Q--------------------------------------------------------------------------------------------------------------------------------------------
--------------------------------------------------------------------------------------------------------------------------------tt----------------------------------------------
-------------------------------------------------------------------------------------------------------------------o------------tt------------------------------SSSSSSSSSSSSSSSS
-----------------------------------k-------------------------------------------------------@------------------------------------tt-----------------g------------------S--SS-----
---------------------------------------------------------------U---------------------------------------------------------------SSt----------------##------------------SSSSS-----
--------%%%%%%%%---------------------------------------------------------------S---------------2SS------QQSQQSSS---------------SSS------------------------------------------SSS-
---------||||||-----------------------------------------------------S--------------------------B-------------------------------------o--------------------------------o---------
---------||||||---------------------------------------------------S--#-----------------------y-Q----------------%----------------------%%%%%----------------------%%%%%---------
---------||||||-----------------------------------------------------##-----------------------2------------------|-----------------------|||------------------------|||-r---r-Sr-
------%%%%%%%%%%-oSSS-------TT-------------------------------###---####-----##-#--%%%%%%%%%---#---%------%%%%%%%|------%%%%%%%%-TT----tt|||-------------------#-%%%%||%%%%%%%%%%
-------||||||||-----K-------TT-------------------------------##----#####---#---#---|||||||---##---|-------|||||-|-TT----||||||--TT----tt|||-------------------#--||-||-||||||||-
-------||||||||-------------TT------TT----------------------###--#######---#---#---|||||||--###---|-------%%%%%-|-TT----||||||--TT----tt|||----------------------||-||-||||||||-
-------||||||||---g-------k-TT------TT--g------------------####-########-#-----#K--|||||||-####---|--------|||g-|-TT----||||||--TT----tt|||-------------y---#-#--||-||-||||||||-
XXXXXXXXXXXXXXXXXXXXXXXXXXXXXXXXXXXXXXXXXXXXXXXX---X----X-XXXXXXXXXXXXXXXXXXXXXX%--|||||XXXXXXXX--|--X-----|||X-|XXX----||%%%|--XXXXXXXXXXXXXXXXXXXXXXXXXXXXXXXX-||%%%%%%%|||||-
XXXXXXXXXXXXXXXXXXXXXXXXXXXXXXXXXXXXXXXXXXXXXXXX---X---XX-XXXXXXXXXXXXXXXXXXXX-X|--|||||XXXXXXXX--|--X-----|||X-|XXX----||-|-|--XXXXXXXXXXXXXXXXXXXXXXXXXXXXXXXX-||-|||||-|||||-
