--------------------------------------------------------------------------------------------------------------------------------------------------------------------------------
-------------------------------------------------------------------------------------------------------------K------------------------------------------------------------------
--------------------------------------------------------------------------------------------------------------------------------------------------------------------------------
-------------------------------------S------------SSSSSSSSSSSSSSSSS---------------------------SS--------------------------------------------------------------------------------
--------------------------------------------------------SS--SS--S-----------------------------------------------------------------------------------------g---------------------
--------------------------------------------------------SS--SSS-------------------------------------------------------------------------------SSS---------%--%%%----------------
--------%%%%%%%%-------##-------o-----r-SSSo----------o-----SS--------------------------------------------------------------------------------SSS---------|---g-SSS---------SSQo
---------||||||-oo----###---------------------------------------------#----------------------------------------y----------------------------------------r-|---|-----------------
---------||||||-S-----#TT-TT------------------------------------S----##--TT-TT-----------------o-------------------------------------------------%%%%%%%%%%%%%|-----------------
---------||||||-S-----#TT-TT----------------U-----------------------###--TT-TT----------------SS----------K---------------K---##------------------|||||||||||-|-----------------
------%%%%%%%%%%------#TT-##-----S--------SSSS--SSS----------------####--#####----------------%%-%%%%-------------2-----------#--------##---------||||||||%%|-|-----------------
-------||||||||---TT-####-----------------------------------------#####--##----#--------------||--||-------------------------##----#---##---------|||||||||||-|----------TT-----
-------||||||||---TT#####----------------------------------------######--------#--------------||--||---------##-------------###----#---##---------|||||||||||-|----------TT-----
-------||||||||---TT#####------------y-k-------k----------------########-------#-k------------||--||---------##------------####----#---##---------|||||||||||-|----------TT-----
XXXXXXXXXXXXXXXXXXXXXXXXXX--XXXXXXXXXXXXXXXXXXXXXXXXXXXXXXXXXXXXXXXXXXXXX------X-XXX----------X|--||-------XXXX----X-XXXXXXXXXXXXXXXXXXXXXXXXXXX-XXXXX|||XX||-|-XXXXXXXXXXXXXXXX
XXXXXXXXXXXXXXXXXXXXXXXXX---XXX-XXXXXXXXXXXXXXXXXXXXXXXXXXXXXXXXXXXXXXXXX------X-XXX----------X|--||------XXXXU----X-XXXXXXXXXXXXXXXXXXXXXXXXXXX-XXXXXX||XX||-|-XXXXXXXXXXXXXXXX
