------------------------------------------------------------------------------------------------------------------------------------------------------------------------------------------------
------------------------------------------------------------------------------------------------------------------------------------------------------------------------------------------------
------------------------------------------------------------------------------------------------------------------------------------------------------------------------------------------------
------------------------------------------------------------------------------------------------------------------------------------------------------------------------------------------------
------------------------------------------------------------------------------------------------------------------------------------------------------------------------------------------------
------------------------------------------------------------------o---------------------------------------------------------------------------------------------------------------oo-----o------
--------%%%%%%%%-------SoS-----------------------%%---------------------------------------------S---Q--SoS--------------------------QQQQQ-----o-S--QQS@SQSS----S--------------------------------
---------||||||----------------------------------||--------------------------------------------#------------------------------S-----------------------------------------------------------------
---------||||||----------------------------------||-------------------------------------------##------------------------------------------------------------------------------------------------
---------||||||--------k-------------------------||-----------------------oo------------------##------------------------------------------------------------------------------------------------
------%%%%%%%%%%S-----SQS----------------%%%%---%%%--------#----SS--------S--S---------------###QSQQS--QS----USS-------#--------#####---------------SSSS-----@S------2--------------------------
-------||||||||---------------------------||-----|---------#---------------------------------###-----------------------#--------#-------------------------------TT-----TT--------------------#--
-------||||||||--------------#-#----------||---#-|------#--#--------------------#-----------###------------------------#--------#-------------------------------TT-----TT---------TT----#----#--
-------||||||||---------------k#----------||---#%##-----#--#--------------------#-----------###----k------k-----#------#-----g--#--k----#----------k-kgg--k-k---TT-----TT----k----TT----##---#--
XXXXXXXXXXXXXXXXXXXX--XXXXX-XXXX%%%%%%%XXXXX-%%%XXX--XXXXXXXXXXXXXXXXXXXXXXXXXXXXXXX--XXXXXXXXX-XXXXXXXXXXXXXXXXXXXXXXXXXXXXXXXXXXXXXXXXXXXXXXXXXXXXXXXXXXXXXXXXXXXXXXXXXXXXXXXXXXXXXXXXXXXXXXXX
XXXXXXXXXXXXXXXXXXXX--XXXXX-XXXX-|||||--XXXX--|-XXX--XXXXXXXXXXXXXXXXXXXX-XXXXXXXXXX--XXXXXXXXX-XXXXXXXXXXXXXXXXXXXXXXXXXXXXXXXXXXXXXXXXXXXXXXXXXXXXXXXXXXXXXXXXXXXXXXXXXXXXXXXXXXXXXXXXXXXXXXXX
