------------------------------------------------------------------------------------------------------------------------------------------------------------------------------------------------
------------------------------------------S-----------------------------------------------------------------------------------------------------------------------------------------------------
------------------------------------------------------------------------------------------------------------------------------------------------------------------------------------------------
------------------------------------------S----S------------------------------------------------SSSSS--------------------------------------------------------------SSSSSSSSSSSS-----------------
------------------------------------------------------------------------------------------------------------------------------------------------------------------------------------------------
--------------------------------------SS--------------------------------------------------------------------------------------------------------------------------------------------------------
--------%%%%%%%%---------------------SS-------------------------%%%------------U-----------------------------------------------------QQS-------o-------------------------------------QQ-QS------
---------||||||--------------------------------------------------|-------------------------------------------------------------------------#-----------o---o------------------------------------
---------||||||--------------------------------------------------|---------K---------------------------------------------------------------#----------%%%-%%%--------------#--------------------
---------||||||---------------------g---------oo-----------------|---------oor-------------------------TT---------------------------------##-----------|---|--------------##--------------------
------%%%%%%%%%%----------#####----SSS--------------------------%|---------%%%%%-----------------------TT---------Q-------------##-------###-----------|---|--------------##-----SS--S@QSS--SU--
-------||||||||-------------------------------------------------||----------|||------------------------TT-----------------------##------###------------|---|------TT----####--------------------
-------||||||||-----------------SS------------------------------||----------|||------------------------TT---#-------------------##-----#####-----------|---|------TT---#####--TT----------------
-------||||||||-------------------------------------------------||----------|||------------------g-----TT--##------gg-----------##-##-#####------------|---|------TT--######--TT---U------------
XXXXXXXXXXXXXXXXXXXXXXXXXXXXXXXXXXXXXXXXXXXXXXXXXXXXXXXXX---XXXX|%%%---%%XXXXXXXXXXXXXXXX----X-XXXXXXXXXXXXXXXXXXXXXXXXXXXXXXXXXXXXXXXXXXXXXXXXX-%%XXXXXXX-|%%%%XXXXXXXXXXXXX-XXXXXXXXXXXXXXXXXX
XXXXXXXXXXXXXXXXXXXXXXXXXXXXXXXXXXXXXXXXXXXXXXXXXXXXXXXXX---XX-X|-|----||--XXXXXXXXXXXXXX----XXXXXXXXXXXXXXXXXXXXXXXXXXXXXX-XXXXXXXXXXXXXXXXXXXX-||XXXXXXX-|-||-XXXXXXXXXXXXX-XXXXXXXXXXXXX-XXXX
