----------------------------------------------------------------------------------------------------------------------------------------------------------------
----------------------------------------------------------------------------------------------------------------------------------------------------------------
----------------------------------------------------------------------------------------------------------------------------------------------------------------
------------------------------------------------------------------------------------o---------------------------------------------------------------------------
----------------------------------------------------------------------------------------------------------------------------------------------------------------
-------------------------------------------------------------------------------------------------------o--oo-o----------------K---------------------------------
------------SQ---------------------QQSSK-------%-------#---------------------------------------------SS-------------------------------------oo--%%--------------
-----------------------------------------------gSSSS--##---------------------------------------------------------o---------S------o----------S--||--------------
---------------------------------------------y#QS----###TTTT---------------------%%%%%%%%-----------------------%----------S--------------------%|---%%%%%------
--------------------------------------------y2##----####TTTTT------ooS--------oS--||||||------------------------|1------------------------------||----|||-------
QSS-----QQSS--SQ-------------------S--------##-----###########-----SSS---------%--||||||------------------------|-----##---------##-------------||----|||-------
-------------------------------------------####---#######----------------------|--||||||------------------------|------#--------#---TT----------||TT--|||-------
------------------------------------------#####--########----------------------|--||||||------------------------|----------%%%--#---TT---------T||TT--|||-------
---------gggg-gg---ggg--------gg---k-g---##########-#####----------------------|--||||||---------------k--------|------#----|---#---TT---------T||TT--|||-------
XXXXXXXXXXXXXXXXXXXXXXXXXXXXXXXXXXXXXXXXXXXXXXXXXXXXXXXXXXXXXXXX---%%---------X|--||%%%%%%%%%%--XXXXXXXX-XXX---XXXXXX-XX----|---X---XXX--XX----X|XXXX-|||---%%%%
XXXXXXXXXXXXXXXXXXXXXXXXXXXXXXXXXXXXXXXXXXXXXXXXXXXXXXXXXXXXXXXX---||---------X|g-||-||||||||---XXXXXXXXXXXX---XXXXXX-XX----|---X---XXX--XX----X|XXXX-|||----||-
