---------------------------------------k------------------------------S-------------------------------------------------------------------------------------------------------------------------
----------------------------------------------------------------------S-------------------------------------------------------------------------------------------------------------------------
------------------------------------------------------------------------------------------------------------------------------------------------------------------------------------------------
----------------------------------------------------------------SSSSSSSSSSSSSSSS------------------------------------------------SSSSSSSSSSSSSSSS------------------------------------------------
----------------------------------------------------------------SS--SSSSSS-S--------------------------------------------------------------------------------------------------------------------
----------------------------------------------------------------SS---SSSSSSSSSSS--------------------------------------------ooo----------------S----------------------------------------------o-
--------%%%%%%%%--o----SS-------%-----SS%------------------------SSSSSSSSSSSSSSS---------------------------------%-----------------------------o-------------------------------o-----SSSSSS--S-S
---------||||||--S%%%-----------|-------|------------------------------------------------------------------ooo---|-------------o---------------------------#---------------#--##----------------
---------||||||----|------------|-------|------------------------------------------------------------------------|--TT------------------------------------###--------------#####----------------
---------||||||----|------------|------o|------------------------------------------------------------------------|--TT----------------------------k------###--------------######----------------
------%%%%%%%%%%---|------------|------%%%%%%S------------------S--SSSS--------------------------------#---------|--##---------------------#------S-----####------------########Q--Q---SSSSSSSS-
-------||||||||----|tt----------|-------||||-----K--------------------------------------TT----K--#-k---#---------|-----------------------###-----------#####-----------#########----------------
-------||||||||----|tt----------|-------||||-----U--------------------------------------TT----U--#--------------TT------TT---------------###-----------#####----------##########----------------
-------||||||||----|tt----------|-------||||-----#----kk-------g------------------g-----TT--k----#----k---------TT------TT-----------y--####----------######---------###########----g----------k
XXXXXXXXXXXXXXXXXXXXXXXXXXXXXXXX|%%%-XXXXXXXXXXXXXXXXXXXXXXXXXXXXXXXXXXXXXXXXXXXXXXXXXXXXXXXXXXXXXXXXXXXXXXXXXXXXX----XXXXXXXXXXXXXXXXXXXXXXXXXXXoXXXXXXXXX-----XXXXXXXXXXXXXXXXXXXXXXXXXXXXXXXX
XXXXXXXXXXXXXXXXXXXXXXXXXXXXXXXX|-|--XXXXXXXXXXXXXXXXXXXXXXXXXXXXXXXXXXXXXXXXXXXXXXXXXXXXXXXXXXXXXXXXXXXXXXXXXXXXX----XXXXXXXXXXXXXXXXXXXXXXXXXXXXXXXXXXXXX----XXXXXXXXXXXXXXXXXXXXXXXXXXXXXXXXX
