----------------------------------------------------------------------------------------------------------------------------------------------------------------
----------------------------------------------------------------------------------------------------------------------------------------------------------------
-------------------------------------------------------------------------------U-----------------------------------------------------------2--------------------
----------------S--SSSSS------------------------SSSSSSSSSSSSSSSS---------SSSS%%%--------------------------------------------------------------------------------
--------------------------------------------------------------------------o---|---------------------------------------------------------------------------------
----------------------o-------------------------------------------------------|-%%%%%%--------------------------------------------------------------------------
----------o---@%--------------------------------------------------------------|--||||-U------------------------------------------U-------ooU--@-----------------
---------------|-SS---#-------------------------------------------------------|--%%%%--%------------------------------------------------------------------------
---------------|S----##-------------------------SS----#-----------------%%----|---||---|--------%-----%%%%%%-------------------------------------------T--%%%---
---------------|----###-------------------------SS----#--------o--------||----|---||---|--------|------||||---------------------------------U--------------|----
---------------|--#-###-------------------------------#------%%%--------||----|-QQ||---|@-------|------||||%%%%------------------2-------@S------------TT--|----
---------------|--#-###-------------------------------#-------|---------||----|---||---|--------|-TT---||||-||----------------------gg------------TT---TT--|----
---------------|###-###-------------TT------------TT--#-------|---------||----|---||---|--------|-TT---||||-||%-----TT---------------B---------#--TT---##--|----
---------------|###-###-------------TT-k-------k-kT#--##------|---------||-y--#--gggg--gggg-----|-TT---||||-|||-----TT---------------b---------#--TT---##--|----
XX-XXXXXXXXXXXXXXXX-XXXX-------XXXXXXXXXXXXXXXXXXXXXX-XXX-----|-XXXX----XXXXXXXXXXXXXXXXXXXXXXXX|XXX---|||%%%%%-XXXXXXXXXXXXXXXXXX--XXXXXXXXXXXXXXXXXX-XXX-X-XX-
XXXXXXXXXXXXXXXXX---XXXX-------XXXXXXXXXXXXXXXXXXXXXX-XXX-----|-XXXX----XXXXXXXXXXXXXXXXXXXXXXXX|XXXX--|||-|g|--XXXXXXXXXXXXXXXXXX--XXXXXXXXXXXXXXXXXX-XX--X--X-
