---------------------------------------------------------------------------------------------------------------------------------------------------------------Q----------------
--------------------------------------o----------------------------------------------------------------------------------------------------K-K---------------K------------------
----------------------------------------------------------------------------------------------------------------------------------------------Q---------------Q-----------------
-------------------------------------------------SSS------------------------------------------------------------------------------------------%%--------------------------------
---------------------------------------------------------------------------------------------------------------------------------------S------||--------------------------------
----------------------------------------------------------------------------------------------------------------------------------------------||--------------------------------
--------%%%%%%%%------------------------------------oo------------------------------------------------------------1QSSSKoSQS--@S--------------||----------------------o-SSS-----
---------||||||--------------------SS---------------------------------------------------------------------------------------------------------||--------------------------------
---------||||||------------------------------------------------------------------------------------------------------------------%%---%-------||-%%%%%--------------------------
---------||||||--------------------------------------------------------------------------------------------------------------1---||---|r------||--|||--r---r--------------------
------%%%%%%%%%%--------------------##---TT--------#-----##------------------#-------------------------Q------------2SSSQSS-Q---%%%%%%%%%%%-2-||--%||--%%%%%%%%%---#-----SSSS---
-------||||||||-#---TT---TT---TT---------TT--------#--#---------------------###-T--------TT--------------------------------------|||||||||----||--|||---|||||||----#------------
-------||||||||-----TT---TT----T#-#-#----TT----T---#-##--------------------####-T--------TT--------------------------------------||||||||%%%--||B-|||---|||||||----#------------
-------||||||||-----TT---TT----T#---#y#--TT----T---####---------------g---#####-T----y---TT---------------------K--ggg-------gg--||||||||-|---||b-|||---|||||||----#------------
XXXXXXXXXXXXXXXXXXXXXXXXXXXXXXXXXXXXXXXXXXXXXXXXXXXXXXXXXXX-XXXX%-%%%---XXXXXXXXXXXXXXXXXXXXXXXXXXXXXXXXXXXXX%%%----XXXXXXXXXXXX%|%%%%%|%%%%%-||--|||%%-|||||||-XXXXXXXXXXXXXXXX
XXXXXXXXXXXXXXXXXXXXXXXXXXXXXXXXXXXXXXXXXXXXXXXXXXXXXXXXXXX-XXXXg--|----XXXXXXXXXXXXXXXXXXXXXXXXXXXXXXXXXXXXX-X-----XXXXXXXXXXXXg|-|g|g|-|||g-||--|||||-|||||||-XXXXXXXXXXXXXXXX
