------------------------------------------------------------------------------------------------------S-----------------------------------------------------------------------------------------
------------------------------------------------------------------------------------------------------S-----------------------------------------------------------------------------------------
------------------------------------------------------------------------------------------------------------------------------------------------------------------------------------------------
--------------------------------------------------------------------------------------SS--SSSSSSSSSSSSSSSSSSSSSS--------------------------SS---o------------------------------------------------
------------------------------------------------------------------------------------------------------------------------------------------------------------------------------------------------
-----------------------------------------------------------------------------------------------------------------------------------------------------------------------------------------o------
--------%%%%%%%%-----------------o----SSS------S-ooo---SS------SS-----SS------------------------SSSSSSSSo----SSS---------------------------o-----SS---------------------------------------------
---------||||||----------------------------#---------------------------------------------------------------------------------------------------------------------------o------------------------
---------||||||----------------------------#----------------#------------------------------------------------S-S--------------------------------------------------------------------------------
---------||||||-----------------ooo--------#----oo---------#------------------------------------S--o-------S-SoS---------------oSoo-------------ooo---------------------------------------------
------%%%%%%%%%%----------######--------##-#---------------#------US----#-----------------------S--SSSSQ-----SSS----------------SSS--------------SS-------------S-----------------TT----TT------
-------||||||||------------------------###-#-#------------###----------##-------TT-------------------------------------k#--------------TT------------------------------------#----TT----TT------
-------||||||||-----------------------####-###-----------####---------###----U--TT-------------------------------------##--------------TT----------------TT------------------#----TT----TT------
-------||||||||----------------------#####-###------g-g-#####--------####----k--TT-----------g-g---------------------####--------g-----TT-----g----------TT------------------#--g-TT--k-TT------
XXXXXXXXXXXXXXXXXXXXXXXXXXXXXXXXXXXXXXXXXX-XXXX-XXXXXXXXXXXXXXXXXXXXXXXXX----XXXXXXXXXXXXXXXXXXXXXXXXXXXXXXXXXXXXXXXXXXXXXXXXXXXXXXXXXXXXXXXXXXXXXXXXXXXXXXXXXXXXXXXXXXXXXXXXXXXXXXXXXXXXXXXXXXX
XXXXXXXXXXXXXXXXXXXXXXXXXXXXXXXXXXXXXXXXXXXXXXXXXXXXXXXXXXXXXXXXXXXXXXXXXX--XXXXXXXXXXXXXXXXXXXXXXXXXXXXXXXXXXXXXXXXXXXXXXXXXXXXXXXXXXXXXXXXXXXXXXXXXXXXXXXXXXXXXXXXXXXXXXXXXXXXXXXXXXXXXXXXXXXX
