--------------------------------------------------------------------------------------------------------------------------------------------------------------------------------
--------------------------------------------------------------------------------------------------------------------------------------------------------------------------------
--------------------------------------------------------------------------------------------------------------------------------------------------------------------------------
------------------------------------------------S-------------------------------------------------SS---SSSSSSSSS------------------------------------------------SSSSSS----------
------------------------------------------------------------------------------------------------------S--SS---------------------------------------------------------------------
---------------------------------------------------------------------------------------%--------------S-SSSS--------------------------------------------------------------------
--------%%%%%%%%---------------------------------SS------------------------SSQ---------|------------------SS------------------------S----SS------------------SS--------------SSS
---------||||||--------------------------------------oo--------------------------------|------U------------------------------------------------------------------SS-------------
---------||||||-------------------------------------------------------------------%----|-------------------------------------------------------------#----------SSSS--#----S----
---------||||||-------------------------------------------------------------------|----|S--------------r---r--rS----------------------------y-------##----------------#---------
------%%%%%%%%%%-----------------------S--------------------------S----SSSSSSS----|----|--------%%%%%%%%%%%%%%%%-----------------------------#----#-##--------------#-#---------
-------||||||||-----------------------------TT--TT--------------------------------|----|---------||||||||||||||-----------------------------##--#-#-##---TT-----#---#-#---------
-------||||||||------------B----------------TT--TT----B---------------------------|----|---------||||||||||||||----------------------------#----###-##---TT-----#---#-#---%%----
-------||||||||------------bg-g----------y--TT--TT----b-----------------ggggg-g---|----|---------||||||||||||||--------------------g-g-----#----#-#-###--TT----##---#-#---||----
XXXXXXXXXXXXXXXXXXXXXXXXXXXXXXXXXXXXXXXXXXXXXXXXXX-------XX-----XXXXXXXXXXXXXXXXXX|--X-|---X--X-%%%%%%%%%%|||||-XXXXXXXXXXXXXXXX---XXXXXXXXXXXXXXXXXXXXXXXXXXXXXX---X-X---%%%---
XXXXXXXXXXXXXXXXXXXXXXXXXXXXXXXXXXXXXXXXXXXXXXXXXX-------XX-----XXXXXXXXXXXXXXXXXX|--X-|--XX--XX-||||||||-|||||-XXXXXXXXXXXXXXXX---XXXXXXXXXXXXXXXXXXXXXXXXXXXXXX---X-X---g|----
