--------------------------------------------------------------------------------------------------------------------------------------------------------------------------------
--------------------------------------------------------------------------------------------------------------------------------------------------------------------------------
--------------------------------------------------------------------------------------------------------------------------------------------------------------------------------
-----------------------------------------------------------------SSSSSSSSSSSSSSS------------------------------------------------------------------------------------------------
-------------------g------------------------------------------------------------------------------------------------------------------------------------------------------------
------------------##------------------------------------------------------------------------------------------------------------------------------##----------------------------
--------%%%%%%%%---------------U---SSSS------------------------o-------------------------------o----------------------SS--SS--SS------SSoSSS--SS----------------------U---------
---------||||||------------------------------------------o------------------------------o---------------------------------------------------------------oooo---------%%%%-------
---------||||||-------------------------------------------------------------------------------------------------------------------------S-----------------------------||--------
---------||||||-------------------------------------------------------------------------------------------------------o-----------------------------------------------||--------
------%%%%%%%%%%-----------------------------------------------------------------Q--tt--------------------------------SS%--%----------SoS----S------------------QQQ---||--------
-------||||||||-----tt---------------------------------------------------TT---------tt-------------------TT-------------|--|------------------------tt----------------||--------
-------||||||||-----tt-------#-------#-----------------------------------TT---------ttt-----------TT-----TT-------------|--|------------S-----------tt----------------||--------
-------||||||||-g---tt--y--#-#-----ggy---------kggg-----------g----------TT---------ttt-----------TT--gg-TT-------------|--|------------------------tt----------------||-gg---g-
XXXXXXXXXXXXXXXXXXXXXXXXXXXXXXXXXXXXXXXXXXXXXXXX-XXXXXX-XXXXXXX-XXXXXXXXXXXXXXXXXXXXXXXXXXXXXXXXXXXXXXXXXXXX--XXXXXXX---|--XXXXX------XX--------XXXXXXXXXXXXXXXXXXXXXXXXXXXXXXXX
XXXXXXXXXXXXXXXXXXXXXXXXXXXXXXXXXXXXXXXXXXXXXXXX-XXXXXX-XXXXXXX-XXXXXXXXXXXXXXXXXXXXXXXXXXXXXXXXXXXXXXXXXXXX--XXXXXXX---|-XXXXXX------XX--------XXXXXXXXXXXXXXXXXXXXXXXXXXXXXXXX
