--------------------------------------------------------------------------------------------------------------------------------------------------------------------------------
-------------------------------------------------------------------------------------------------------------L------------------------------------------------------------------
--------------------------------------------------------------------------------------------------------------------------------------------------------------------------------
--------------------------------------------------------------------------------------------------------------%%----------------------------------------------------------------
----------------------------------------------------------------SS--------------------------------------------||----------------------------------------------------------------
----------------------------------------------------------------SS--------------------------------------------||--------------------------------------g-g-----------------------
--------%%%%%%%%-----------------------oSS--------------------------------------------------------------------||SSS-----------------------------Q-Q-QQQQ------------------------
---------||||||------oooo-------------------------------------------------------------------------------r-----||----------------o-S---------------------------------------------
---------||||||-------%%%%%%----------------------------------##----------------------------------%-%%%%%%%---||----------------------------------------------------------------
---------||||||--------||||----------------------------------###----------------------------------|--|||||----||-----------------K-----------------g---------1------------------
------%%%%%%%%%%-------||||---------------SSS----------#----####--TT-----------------------------%%--|||||----||--TT----------------TT-TT---------yQQ--------#------TT----------
-------||||||||--------||||----------------------------#---#####--TT---------------------TT------||--|||||-#--||--TT-#---##-----#---TT-TT-----TT------------##------TT----------
-------||||||||--------||||----------------------------#--######--TT---------------------TT------||--|||||-#--||--TT-#---##---------TT-TT-----TT-%---------###------TT----------
-------||||||||--------||||--------k--------y----------#-#######--TT----------gg-----y---TT------||--|||||-#--||--TT-###-##---gg----TT-TT-----TT-g----U-K-####K-----TT----------
XXXXXXXXXXXXXXXXXXXX---||||X---XXXXXXXXXXXXXXXXXXX-XXXXXXXXXXXXXXXXXXXXXXXXXXXXXXXXXXXXXXXXXXXXX-%%%%|||||-X-XX|XXXXXXXXXXXXXXXXXXXXXXXXXXXXXXXXXXXXXXXXXXXXXXXXXXXXXXXXXXXXXXXX
XXXXXXXXXXXXXXXXgXXX---|||XX---XXXXXXXXXXXXXXXXXX--XXXXXXXXXXXXXXXXXXXXXXXXXXXXXXXXXXXXXXXXXXXXX--||-|||||-X-XX|XXXXXXXXXXXXXXXXXXXXXXXXXXXXXXXXXXXXXXXXXXXXXXXXXXXXXXXXXXXXXXXX
