--------------------------------------------------------------------------------------------------------------------------------------------------------------------------------
--------------------------------------------------------------------------------------------------------------------------------------------------------------------------------
---------------------------2----------------------------------------------------------------------------------------------------------------------------------------------------
--------------------------------S-------------------------------------------------------------------------------SSS-------------------------------------------------------------
--------------------------------------------------------------------------------------------------------------------------------------------------------------------------------
----------------------------------------------------------------SS--------------------------------------------------------------------------------------------------------------
--------%%%%%%%%---QS----SS----S---------------------------------------------------------------o---SSSSooSS---@%------------------------------@%---ySU-----------------#--------
---------||||||---------------------------------------------------------r--------------------------------------|--------------------S----------|----------------------##--------
---------||||||--------------------------------------------------------%%%-------------%%%-------------SSSS----|S-----#--TT--------SSS---------|-------------y-------###--------
---------||||||--------------1---------------------------------o-g------|---------------|----------------------|----#-#--TT--------------------|------------y#------####--------
------%%%%%%%%%%----------------------------------------------SQQQQ--tt-|%%%%%----------|---------SS-SSSSS-----|---####--##----------#---#-----|------------##-----#####--------
-------||||||||-------------------------------TT---------------------tt-|-|||-----------|----------------------|--#####--##----------#---------#---#-------###----######--------
-------||||||||-------------------------------TT---------------------tt-|-|||-------tt--|--tt------------------|-######--##----#-----#---------#---#------####---#######--------
-------||||||||----g-K------y-----------------TT-ggg-----gggg--------tt-|-|||-------tt--|--tt-g----g-----------|#######--##----#-----#---#-----#---#-U---#####--########--------
XXXXXXXXXXXXXXXXXXXXXXXXXXXXXXXXXXXXXXXXXXXXXXXXXXXXXXXXXXXXXXXX-XXX-XX-XXX||-%%-XXXXXXXXXXXXXXXX--XXXXXXXXXXX-XXXXXXXXXXXX-XXXXXX--XXXXXXXXXXXXXXXXXXXXXXXXXX-XXXXXXXXXXXXXXX-X
XXXXXXXXXXXXXXXXXXXXXXXXXXXXXXXXXXXXXXXXXXXXXXXXXXXXXXXXXXXXXXXX-XXX-XX-XXX||-||-XXXXXXXXXXXXXXXX--XXXXXXXXXXXXXXXXXXXXXXXX-XXXXX---XXXXXXXXXXXXXXXXXXXXXXXXXX-XXXXXXXXXXXXXXX-X
