------------------------------------------------------------------------------------------------------------------------------------------------------------------------------------------------
------------------------------------------------------------------------------------------------------------------------------------------------------------------------------------------------
------------------------------------------------------------------------------------------------------------------------------------------------------------------------------------------------
--------------------------------------------------------------------------------SSSSSSSS-------S------------------------------------------------S-----------------------------------------------
-----------------------------------------------------------------------------------------------------------------------------------------------------------------------------------------o------
-------------------------------------------------------------------------------------------o----------------------------------------------------------------------------------------------------
--------%%%%%%%%------------------------------------QQQQ-------#-------SS-----------------%%%-----------------------Q---o---------------SS-----o------------------S----------------UQQQS@S---S@-
---------||||||--------------------------------------------y--##---------------------------|----------------------------------------------------------------------------------------------------
---------||||||----------------------#---------------------#####-----------#---------------|---------------------------------------------------------------#------------------------------------
---------||||||---------------------##--------------------######---------------------------|------------------------------------oo-------------------------#------------------------------------
------%%%%%%%%%%----------#####-----------------####---########----------------------------|--------------------Q#QQ---S----------------------------------##---------------------QQQ---QS----S--
-------||||||||---------------------------------####---########---------#------oo----------|-------------------------------------------------------------###------------------------------------
-------||||||||-------------------------TT---TT-####--##########-------###-----------------|----------------------------------------------#-------------####---#--------------------------------
-------||||||||-----------------g-------TT---TT-################------####-----------------|----------------kk-----k--y---k-k-----gy-----##------------######-##g-g-----------------------------
XXXXXXXXXXXXXXXXXXXXXXXXXXXXXXXXXXXXXXXXXXXXXXXXXXXXXXXXXXXXXXXXXXXXXXXXXXX--X-XX----XXXXXXXXXXXXXXXXXXXXXXXXXXXXXXXXXXXXXXXXXXXXXXXXXXXXXXXXXXXXXXXXXXXXXXXXXXXXXXXXXXXXXXXXXXXXXXXXXXXXX--XXXX
XXXXXXXXXXXXXXXXXXXXXXXXXXXXXXXXXXX-XXXXXXXXXXXXXXXXXXXXXXXXXXXXXXXXXXXXXXX--XXX-----XXXXXXXXXXXXXXXXXXXXXXXXXXXXXXXXXXXXXXXXXXXXXXXXXXXXXXXXXXXXXXXXXXXXXXXXXXXXXXXXXXXXXXXXXXXXXXXXXXXXX--XXXX
