---------------------------%----------------------%-----------------------------------------------------------------------------------------------------------------------------
---------------------------|----------------------|-----------------------------------------------------------------------------------------------------------------------------
---------------------------|----------------------|-------------------------------------------Q--------------------------------------------------------o------------------------
---------------------------|----------------------|---------------------------------------------SS-SS----------S--------SSS-----------------------------------------------------
---------------------------|----------------------|-----------------------------------------------------------------------------------------------------------------------------
---------------------------|----------------------|-----------------------------------------------------------------------------------------------------------o-----------------
--------%%%%%%%%-----------|----------------------|-------------SS------Q------o-----------K------------------SS-S------oSSQQSSS------------------------------------------------
---------||||||------%-----|----------------------|---------------------------------------------------------------------------------------oo------------------------------------
---------||||||------|-----|----------------------|------------------------------%%%%%%%%%--------S----S-------------------------------------------------TT-TT-----------%%%%%--
---------||||||------|-----|----------------------|-------------------------------|||||||--o----USS------------------------------------------------------TT-TT------------|||-oo
------%%%%%%%%%%S----|---#-|----------------------|------------------------------%%||||||--K--------------S-----%%%%---%%-%%%-S--S-------------------##--#####-#----------|||%%%
-------||||||||------|---##|-------------TT-TT--TT|---tt-------------tt----------||||||||------------------K---#-||----||--|--------K--TT-----------####-------#----------|||-|-
-------||||||||------#---#-|-------------TT-TT--TT|---tt-------------tt----tt----||||||||--------S---------S---#%||----||-%%%%%--------TT----------#####-------#----------|||-|-
-------||||||||------#---##|---------g-k-TT-TT--TT|---tt--------g----tt----tt-g--||||||||-------------------kk-#|||----||--|||g-----y--TT----------#####----------gg------k||-|-
XXXXXXXXXXXXXXXXXXXXXXXXXXXXXXXXXXXXXXXXXXXXXXXXXXXXXXXXXXXXXXXXXXXXXXXXXXXXXXXX%%%%%%%%%%---------S-------XXXXX|||----||--|||XXXXXXXXXXXXXXXXXXXXXXXXXXXX--XX-X---------XX||-|-
XXXXXXXXXXXXXXXXXXXXXXXXXXXXXXXXXXXXXXXXXXXXXXXXXXXXXXXXXXXXXXXXXXXXXXXXXXXXXXXXgg||g|||g-g----------------XXXXX|||----||--|||XXXXXXXXXXXXXXXXXXXXXXXXXXXX--XX-X---------XXX|-|-
