--------------------------------------------------------------------------------------------------------------------------------------------------------------------------------
--------------------------------------------------------------------------------------------------------------------------------------------------------------------------------
--------------------------------------------------------------------------------------------------------------------------------------------------------------------------------
----------------S-SSSSSS---------------------------------------------------------------------------------------S--SSSSS-SS--------------------------------------SSSSSSSSSS----SS
--------------------------------------------------------------------------------------------------------------------------------------------------------------------------------
-------------------------------------------------------------------------------------g------------------------------------------------------------------------------------------
--------%%%%%%%%-----------------------------Q--------------------------------------SSR--------S------------------------------------QQ--SQQQQ---------S-------------------------
---------||||||-------#----------%%%%%%%------------------------------------------SSS--------------------SS---------------------------------------------------------------------
---------||||||------##-----------|||||-------------------------------------------SS-S------------------SSS-------S-------------------------------------------------------------
---------||||||-----###-----------|||||----------------------------------------------#-----------------SSSSSSSSS------#------------g--------------------------------------------
------%%%%%%%%%%--#####--TT-----Q-QQ|||---Q-------S------------Q----------------#---##------##----S----SSS------------##----------SQQQSSSQQQ@------------------------------SSS--
-------||||||||--######--TT----##---|||-----------------------------------------#---##-----------------------------#--##---------------------------------TT-------TT------------
-------||||||||-#######--TT----#----|||--------------------------------TT-------#---##---------#-------------------#--##---------------------------------TT-------TT------------
-------||||||||-#######--TT----#----|||-------gg-----------------------TT----k--#---##---#-----------------------#-#-####-------gg------gggg--g------y---TT-------TT--#---------
XXXXXXXXXXXXXXXXXXXXXXXXXXXXXXXXXXXXXXXXXXXXXXXXXXXXXXXXXXXXXXXXXXXXXXXXXXXXXXXXX---XXXXXXX-XX-XX----XXX-----XX-XXXXXXXXXXXXXXXXXXXXXXXXXXXXXXXXXXXXXXXXXXXXXXXXXXXXXXXX-------X
XXXXXXXXXXXXXXXXXXXXXXXXXXXXXXXXXXXXXXXXXXXXXXXXXXXXXXXXXXXXXXXXXXXXXXXXXXXXXXXXX---XXXXXXX-XX-XX----XXX-----XX-XXXXXXXXXXXXXXXXXXXXXXXXXXXXXXXXXXXXXXXXXXXXXXXXXXXXXXXX-------X
