--------------------------------------------------------------------------------------------------------------------------------------------------------------------------------
-------------------------------------------------------K-----K------------------------------------------------------------------------------------------------------------------
-------------------------------------------------------------------------------------------R------------------------------------------------------------------------------------
----------------SSSSSSSSSSS---------------------oooo------SSSS%%-----SSSSSSSSSSS-------------------------------------------SSSSS----------------------------------SSSSSS----SSSS
--------------------------------------------------Q-QSS-------||----SSSSSSSSSSS-------------------------------------------------------------------------------------------------
-------------------------------------------------------%------||----kSSSSSSSSSSS------------------------------------------------------gg--------g-------------------------------
--------%%%%%%%%------------SSS------------------------|------||-SSSSSSSSSSSSSSS-SSS-------U------------Sooo--@S--------------------------------2S-S--SSS-----------------------
---------||||||------oo-------S----oo------------------|------||-----SSSS-------------------------------------------------------SSSSS-------------------------------------------
---------||||||-S-------------------------------%%%%%%%|------||------SSS-------------------------------------------------------S-----------------------------------------------
---------||||||----------------------------------|||||-|---ooSrS---o-SS-S-o---------------------------------------oo-----SSS--------##---------------------------K--------------
------%%%%%%%%%%----------------TT---------------|||%%%%-%-%%%%%--SSSSSSSSSSSSSS---------@---------------@SS------------------#----------TT---T---------------------------------
-------||||||||-----------------TT------------TT-|||-||--|--|||----S-------SSSS------g----------------------------------------#----------TT---TT--TT--------TT------------------
-------||||||||-----------T-----TT------------TT-|||-||--|--|||--SSS-SS--------------B---------------------------------TT-----#----------TT---TT--TT--------TT------------------
-------||||||||-----------T-----TT------------TT-|||-||--|-o|||-----kk-----------y-g-b-------ggg-----y---------y---k---TT-----#------#---TT---TT--TT--------TT------------------
XXXXXXXXXXXXXXXXXXXXXXX--XX----XXXX-XX----XX--XX-|%%%%%-%%%%|||-XXXXXXXXXXXXXXXXgXXXXXXXXXXXXXXXXXXXXXXXXXXXXXXXXXXX---XXXXXXXXXXXXXXXXXXXXXXXXXXXXXXXXXXXXXXXXXX---XXX-------XX
XXXXXXXXXXXXXXXXXXXXXXX--XX----XXX--XX---XXX--XX-|-|g|g-g||-|||-XXXXXXXXXXXXXXXXXXXXXXXXXXXXXXXXXXXXXXXXXXXXXXXXXXXX---XXXXXXXXXXXXXXXXXXXXXXXXXXXXXXXXXXXXXXXXXX---XXX-------XX
