-----------------------------------------------------------------------------------------------------------------------------------------Q--------------------------------------
---------------------------------------------------------------------------------------------------------------------------------------------K----------------------------------
--------------------------------------------------------------------------------------------------------------------------------------------------------------------------------
--------------------------------------SSSS-------------------------------------------------------------------------SSS----------------------------------------------------------
-------------------------------------------------------------------------------------------------------------------------------------------------------------------k------------
-------------------------------------------oo--o------------------------------------------------------------------------------------------------------------------##------------
--------%%%%%%%%-------------------------------------------------------------------SQ-------------------------------------------------------------------------------------------
---------||||||---------SSSS-----------------------------------y----------------------------------------------------S-------------------r---------------------------------------
---------||||||--------SSSS------------------------------------------------------------------y-----------------------------------%%%%%%%%-----R---------------------------------
---------||||||---------SSSSS--------------------------------2---------SSSSS-----------------2------------------------------------||||||---r-@2---------------------------------
------%%%%%%%%%%-------------------------%%%%%%%------------------------------#----y---------#----------------------#----TT------%%%||%%%%%%----#-----------------S-------------
-------||||||||--K----------------TT------|||||-------------------------------#-------------##--------------------#------TT---TT--|-||-||||--#-----------##----#----------------
-------||||||||-------------------TT------|||||-------------------------------#-%----------###------------------###-#----TT---TT-%%-||-||||-##------TT---##----#----------------
-------||||||||-k-K----g----------TT------|||||---------y-------------------###-|-----g----###---------#-----k--#-#-#y#--TT---TT-||-||-||||###------TT---##----#--------y---y---
XXXXXXXXXXXXXXXXXXXXXXXXXXXXXXXX-XXXX-----|||||-X----XXXXXXXXXX-XXXXXXXXXXXXXXXX|---------XX----XXXXXXXXXXXXXXXXXXXXXXXXXXXXXXXX-%%%||-||||X----X---XXXXXXXXXXXXXXXXXXXXXXXXXXXX
XXXXXXXXXXXXXXXXXXXXXXXXXXXXXXXX-XXXX-----|||||-X----XXXXXXXXXX-XXXXXXXXXXXXXXXX|---------X-----XXXXXXXXXXXXXXXXXXXXXXXXXXXXXXXX--|gg|-|||XX--B-X---XXXXXXXXXXXXXXXXXXXXXXXXXXXX
