------------------------------------------------------------------------------------------------------------------------------------------------------------------------------------------------
------------------------------------------------------------------------------------------------------------------------------------------------------------------------------------------------
------------------------------------------------------------------------------------------------------------------------------------------------------------------------------------------------
----------------SSSSSSSS------------------------SSSSSSSSSSSSSSSSS-------------------------------------------------------------------------------------------------------------------------------
------------------------------------------------S---SSS%----------------------------------------------------------------------------------------------------------------------------------------
-------------------------------------------------------|----------------------------------------------------------------------------------------------------------------------------------------
--------%%%%%%%%--------------------QSSQQ--------Soo---|-oooooo------------------o--------------SSSSS---------------------------------------------------------------------------SSSSSSSSSSS--SSS
---------||||||------------#---------------------------|-----------------------S---------------------------------------o---o--------------------------------------------------------------------
---------||||||----------###--------------------------SSSSSS-SSS----------------------------------------------S--------%---S---S----------------------------------------------------------------
---------||||||----------###-----------g---------o------------SS-----%%-------------------------ooooo--------ooo-------|--------------------------------------------------------o---------------
------%%%%%%%%%%--------####-----SSSSSSS--------SSS-----------SS-----||------------------##-----SSSSSSS------SSS-------|------------------%%-------------TT--------------SSS----S------------SS-
-------||||||||-------y#####-----------------------------------------||---#----#--------###----------------------------|------------------||-------------TT-------------------------------------
-------||||||||------#######-#---------------------------------------||--##------------####----------------------------|------------------||-------------TT-------------------------------------
-------||||||||------#######-#-----k-k---------------------S---------||--##----#------#####----------------------------|------------------||---o--g------TT----o-------------------k-k------k---
XXXXXXXXXXXXXXXXXXXXXXXXXXXXXXXXXXXXXXXXXXXXXXXX--XXXXXXXXXXXXXX-----XXXXXXXXXXXXXXXXXXXXXX-XXXXXXXXXXXXXXX-XXXX-XXXXXXX-SS--XXX--XXXXXX--%%%%%%XXXXXXXXXXXXXXXXXXXX--X------%%-XXXXXXXXXXXXXXXX
XXXXXXXXXXXXXXXXXXXXXXXXXXXXXXXXXXXXXXXXXXXXXXXX--XXXXXXXXXXXXXX-----XXXXXXXX-XXXXXXXXXXXXX-XXXXXXXXXXXXXX--XXXXXXXXXXXX-----XXX--XXXXXX---||||-XXXXXXXXXXXXXXXXX-XX--X------||-XXXXXXXXXXXXXXXX
