---------------------------------------------------------------------------------------------------------------------------------------K--------------------------------------------------------
---------------------------------------------------------------------------------------------------------------------------------------o--------------------------------------------------------
------------------------------------------------------------------------------------------------------------------------------------------------------------------------------------------------
-------------------------------------------------------------------------------------------------SSSSSSS--------SSSSSSSSSSSSSSS-----------------SSS-------------SSSSSSSS------------------------
------------------------------------------------------------------------------------------------------------------------------------------------------------------------------------------------
------------------------------------------------------------------------------------------------------------------------------------------------------------------------------------------o-----
--------%%%%%%%%--------------------------------------------------SS@SQQQ------------------------------------------------------S----------------------------------------%-------------Q---------
---------||||||-----------------------oo---o--------------------------------------------------------------#-----------------------------------------------------%%%%%%%-|----------------------o
---------||||||------------------------------------------------------------------------------------------##-----------------------------------------#------------|||||--|-----------------------
---------||||||------------------------------------------------------------------------------------------##----ooo-----------------------ooo--------#------------|||||--|-----------------------
------%%%%%%%%%%----------######-SS----------------------------#-SQS---QQS-------SSS--------------------###---------------------%-------%%%%--------------------%|||||--|-------QQQ---SSSSSS----
-------||||||||--------------------------------o---------TT---##--------------------------------------y###----------------------|--------||--o---------------#--||||||--|---------------------oo
-------||||||||--------------------------------S---------TT---##-------------------------------------#####---TT--------TT-------|--------||-%%%-#------#-----##-||||||--|-----------------------
-------||||||||------------------------------------ggg---TT---##------------k------k----------------######---TT------#-TT--kk---|--r-----||--|--#------#---#-#--||||||--|--k---#----------------
XXXXXXXXXXXXXXXXXXXXXXXXXXXXXXXXXXXXXXXX--------XXXXXXXXXXXXXXXXXXXXXXXXXXXXXXXXXXXXXXXXXXXXXXXXXXXXXXXXXXXXXXXXXXXXXXXXXXXXXXXX|%%%%%%%%%%--|--XXXXXXXXXXXXXXXX||||XXXXXXXXXXXX-%%%%%X-XXX--XXX
XXXXXXXXXXXXXXXXXXXXXXXXXXXXXXXXXXXXX-XXX-------XXXXXXXXXXXXXXXXXXXXXXXXXXXXXXXXXXXXXXXXXXXXXXXXXXXXXXXXXXXXXXXXXXXXXXXXXXXXXXXX|-||||||||---|--XXXXXXXXXXXXXXXX||||XXXXXXXXXXXX--X||---X-X--XXX
