--------------------------------------------------------------------------------------------------------------------------------------------------------------------------------
--------------------------------------------------------------------------------------------------------------------------------------------------------------------------------
-------------------------------------------------------------------------------------------2------------------------------------------------------------------------------------
----------------------------------------------------------------------------------------------------------------------------------SS----------S---------------------------------
-------------------------------------------------------------------------------------------------------------------------------------SS-----------------------------------------
--------------------------------------------------------------------------------------------------------------------------------------------------------------------------------
--------%%%%%%%%--SSSSS--------S---SSoooo--o--@%---------------------------------------ooooo--@-------------------------------------------------------------------SSQSSSoSQ----%
---------||||||---SSS--------------------------U-------------------------------y----------r-------------------------------------------o-r-----o--------------------------------|
---------||||||---SSSS-------------SSSSSSSSS---|-----------------------------------------SS-------------------------------TT----------%%%--------------------------------------|
---------||||||--------------------------------|------------------------------##-----------K2#----------------------------TT-----------|---o-S@S-------------------------------|
------%%%%%%%%%%#---S----##---------SS---S-y-#-|-----------------------------###o2----------##--%%%-----------#--------##-##----%%%%%%%%-%%%-%%---------U---------SQS@S-%%-y-#-|
-------||||||||----------------------------#---|----------------------------###------------###---|-----------##------------------||||||---|--||-------------------------||--##-|
-------||||||||------------------------S-SS#---|---------------------------####-----------####---|----------###------------------||||||---|--||-------------------------||-###-|
-------||||||||---------------------------##---|--------------------------#####----------#####---|---------####------------------||||||---|--||----ggg--yg-----k------y-||####-|
XXXXXXXXXXXXXXXXX---XXX--XX----X----XXXX-------XX---XXXXXXXXXXXX-XXX-XXXXXXXXXX-UX--XXXXXXXXXX-X-|XX----XXXXXXXXXXXXXXXXXXXXXXXX%|%%%%%%%%%%%||-XXXXXXXXXXXXXXXXXXXXXXXXXXXXXXXX
XXXXXXXXXXXXXXXXX---XXX--XX---XXX---XXXX-------XX---XXXXXXXXXXXX-XXX-XXXXXXXXXX-XX--XXXXXXXXXX-X-|XX----XXXXXXXXXXXXXXXXXXXXXXXXgg-|||||||g|g||-XXXXXXXXXXXXXXXXXXXXXXXXXXXXXXXX
