--------------------------------------------------------------------------------------------------------------------------------------------------------------------------------
-------------------------------------------------------------------------------------------------------------------Q------------------------------------------------------------
-----------------------------------------------------------------------------------------------------------------##-------------------------------------------------------------
----------------------------------------------------------------------------------------------------------------####-#------------------------------------------S--SSSSSSSSSSSS-
----------------------------------------------------------------------------------------------------------------######-----------g-g--------------------------------------------
-----------------------------------------------U----------------------------------------------------------------####------------%%%%%-------------------------K-----S-S----oSoo-
--------%%%%%%%%----------S-------------S-o----%----------------------------------------------@----------------------------------|||-----------------K-----o------SSSSS---------
---------||||||--------------------------------|----oo------------------------U---------------------------------%---##-----------|||----oo-------------------------SS-----------
---------||||||--------------------------------|-%%--%%%-----------------------------##-------------------------|-U--------------|||----------------------SS-------S------------
---------||||||-----------------------------y--|-||---|-----------g----SSSSo--------###-----U-----g--------o----|----------------|||----SSS-------------------------------------
------%%%%%%%%%%----------------%-----------S#-|-||---|-----------------------#----####----------%%-----------#-|-#-TT------TTT--|||-------------------------------SSS----------
-------||||||||-----------------|-----------##-|-||---|-------TT--------------#---#####----------||----------##-|---TT------TTT--|||---------------#---------------------TT-----
-------||||||||-----------------|----------###-|-||---|-------TT--------------#--#####---##------||---------###-|---TT------TTT--|||---------------#---------------------TT----#
-------||||||||--------K--------|---------####-|-||---|-------TT--------------#-#######--##------||--------####-|---TT------TTT--|||------gg-------#-k-#-----------------TT----#
XXXXXXXXXXXXXXXXXXXXXXXXXXXXXXXX|--X--XXXXXXXX-XXXXXX-|--XXX--XXXXXX-X--XXXXXXXXXXXXXXXXXXX-XX-X-||X-X--XXXXXXXXXXXXXXXXXXXXXXXXXXXXXXXXXXXXXXXXXXXXXXXXXXXXXXXXX-XXXXXXXXXXXXXX
XXXXXXXXXXXXXXXXXXXXXXXXXXXXXXXX|--X--XXXXXXXX-XXXXXX-|--XXX--XXXXXX-X--XXXXXXXXXXXXXXXXXXX-XX-X-||X-X--XXXXXXXXXXXXXXXXXXXXXXXXXXXXXXXXXXXXXXXXXXXXXXXXXXXXXXXXX-XXXXXXXXXXXXXX
