------------------------------------------------------------------------------------------------------------------------------------------------------------------------------------------------
------------------------------------------------------------------------------------------------------------------------------------------------------------------------------------------------
------------------------------------------------------------------------------------------------------------------------------------------------------------------------------------------------
------------------------------------------------SSSSSSSSSSSSSSSS------------------------------------------------SSSSSSSSSSSSSSSS------------------------------------------------SSSSSSSSSSSSS---
-----------------------------------------------------------------------------------------------------------------S------------------------------------------------------------------------------
-----------------------------------------------------------------------------------------------------------------------------------------------o------------------------------------------------
--------%%%%%%%%--------------------SSSS---------------------SS--------S-------o------------------------------------------------%%%------------S------------------------------------------------
---------||||||-------------------------------------------------SSSS--K----oo------------------#---------------------------------|------------------------------S-------------------------------
---------||||||------------------------------------------------------------------------------###---------------------------------|--------------------------------------------------------------
---------||||||-----------------------------------------------------------SSSSS------------#####------------#--------------------|-------------------------------------------------------SSS-SS-
------%%%%%%%%%%----------######-----------------------------------------------------------#####---------TT###----------------TT-|--------%%%%%%---S--------------------------------------------
-------||||||||---------------------------------------#-------TT-----------S--------------######---------TT##-----------------TT-|---------||||------------------------------------------#------
-------||||||||---------------------------------------#--#----TT---#-------S-K------------######---------TT##-----------TT----TT-|---------||||---------TT--------------------------tt--##------
-------||||||||--------------------gggg--------------##--#----TT--##-------------------y-#######--------#####-----------TT----TT-|oo-------||||---------TT-----g--oy----------------tt--##------
XXXXXXXXXXXXXXXXXXXXXXXXXXXXXXXXXXXXXXXXXXXXXXXXXXXXXXXXXXXXXXXXXXXX--XXXXX--XXXXXXXXXXXXXXXXXXXXXXXXXXXXXXXXXXXXXXXXXXXXXXXXXXX-|%%XXXXXXXXXXXX-XXXXXXXXXXXXXXXXXXXXXXXXXXXXXXX--XXXXXXXX%%%%%X
XXXXXXXXXXXXXXXXXXXXXXXXXXXXXXXXXXXXXXXXXXXXXXXXXXXXXXXXXXXXXXXXXXXX--XXXXX--XXXXXXXXXXXXXXXXXXXXXXXXXXXXXXXXXXXXXXXXXXXXXXXXXXX-|||-XXXXXXXXXXXXXXXXXXXXXXXXXXXXXXXXXXXXXXXXXXX--XXXXXXXX-|||-X
