------------------------------------------------------------------------------------------------------------------------------------------------------------------------------------------------
------------------------------------------------------------------------------------------------------------------------------------------------------------------------------------------------
------------------------------------------------------------------------------------------------------------------------------------------------------------------------------------------------
---------------------------------------------------------------------------------------------------------------------------------------------------------------#SSSSSSSSSSSSSSSS----------------
------------------------------------------------------------------------------------------------------------------------------------------------------------------------------------------------
------------------------------------------------------------------------------------------@-----------------------------------------------------------------------------------------------------
--------%%%%%%%%--------------------QQQQ-------#-----------------------QQ------o-------------------------------o--------------------------------------------------------------------------------
---------||||||--------------------------------#-----------------------------------------------------------------------------------------------#%%%%%%%-------SS--------------------------------
---------||||||-----------------------------##------------------------------------------------------------------------------------------------##-|||||-------------------------------o----------
---------||||||-----------------------------###o--------------------------SS-S-------------------o------------------------------------------####-|||||----##------------------------------------
------%%%%%%%%%%----------#########----#---####-------------------##-------------U----------------------------------SS---TT----------------#####-|||||---###----TT-------------------2----------
-------||||||||------------------------##--####------------------####---#--------------o------------------------TT-------TT----------------####--|||||--####----TT---@-------------------TT-----
-------||||||||------------------------#---####------------------####-------------------------------------------TT-------TT---------------#####--|||||-#####-#--TT------TT---------------TT-----
-------||||||||--------------------k---kk--###-----------g-----######---k----------------------------k----------TT-------TT---------------#####--|||||######----TT----k-TT--y---g------k-TT-----
XXXXXXXXXXXXXXXXXXXXXXXXXXXXXXXXXXXXXXXXXXXXXXXXX-XXXXXXXXXXXXXXXXXXXXXXXXXXXXXXXXXXXXXXX---XXXXXXXXXXXXXXXXXXXXXXXXXXX-XXX--XXXX%XXXXXXXXXXX---XXXXXXXXXXXX----XXXXXXXXXXXXXXXXXXXXXXXXXXXXXXXX
XXXXXXXXXXXXXXXXXXXXXXXXXXXXXXXXXXXXXXXXXXXXXXXXX-XXXXXXXXXXXXXXXXXXXXXXXXXXXXXXXXXXXXXXX---XXXXXXXXXXXXXXXXXXXXXXXXXXX-XXXXXXXXX|-XXXXXXXXXX---XXXXXXXXXXXX---XXXXXXXXXXXXXXXXXXXXXXXXXXXXXXXXX
