--------------------------------------------------------------------------------------------------------------------------------------------------------------------------------
--------------------------------------------------------------------------------------------------------------------------------------------------------------------------------
--------------------------------------------------------------------------------------------------------------------------------------------------------------------------------
----------------SSSSSSSSSSSSSSSS--SSSSSSSSSSSSSS--------------------------------------------------------------------------S-----------------------------------------------------
----------------SS--------------------------------------------------------------------------------------------------------------------------------------------------------------
-----------------------------S------------------------------------------------------------------------------------------------------------------------oo------------------------
--------%%%%%%%%-S----------SSS---------------------So-ooo-----%--------------------------------------------------SS------------QS-----oSSQQS--------------------------@--------
---------||||||------oo------S-------------SSSS---------------y#---------------------------------------------------------------------------------SSoo---------------------------
---------||||||---------------------------SSSS----SSSSSS-SS--g##------#---S-----------------------------------------------------------------------------------------------------
---------||||||--------------------------SSSSSSS-------------###------#-----y----------------------------------S----------------------------------------------------------------
------%%%%%%%%%%---------------------%%%SSo--%%-----SS------####---#--#-----SS---------------##-------------------SSS%%------%%%-SSQ----SoSQQ---TT----------------2----SSS------
-------||||||||-----------------------|------||------------#####--##-##---------------------###----------------------||-------|-----------------TT-------TT---------------------
-------||||||||-----------------------|-S%%%%||-SS-S------######-######------------S---##--####--------##------------||-------|-----------------TT-------TT---------------------
-------||||||||--------g--------------|---||-||--------#-#####-#-######----------k-K---##-#####--------##-----------gg|-------|---------k-------TT-------TT-----g---------------
XXXXXXXXXXXXXXXXXXXXXX---------X%-%%%%%-%%%%%%|-XX-XXXXXXXXXXXXXXXXXXXXXX-------XXXXXXXXXXXXXXXXXXXXX--XXXXXXXXXX--XXXXXXX----|-X---XXXXXXXXXXXXXX--XXXX-XX-----XXX--XXXXXXXXXXX
XXXXXXXXXXXXXXXXXXXXXX---------Xg--|||---|||g-|-XX-XXXXXXXXXXX-XXXXXXXXXX-------XXXXXXXXXXXXXXXXXXXXX-XXXXXXXXXXXX-XXXXXXX----|-X---XXXXXXXXXXXXXX--XXXX-XX-----XXX-XXXXXXXXXXXX
