----------------------------------------------------------------------------------------------------------------------------------------------------------------
----------------------------------------------------------------------------------------------------------------------------------------------------------------
----------------------------------------------------------------------------------------------------------------------------------------------------------------
----------------------------------------------------------------SSSS---------SSS--------------------------------------------------------------------------------
----------------------------------------------------------------------------------------------------------------------------------------------------------------
----------------------------------------------------------------------------------------------------------------------------------------------------------------
-------------------------------o----------------SSS-------------------------------------S--------------------------Ko----------------oo---------SSS-------------
-----r--U----------------------------------------Soooo-----------------------------------------------------------------------------SS---------------oo----------
%%%%%%%%--------------------------------------------------------------%%------------------------------------------SSS-----------SSSS-#--------------------------
-||||||------SS-------------------------------------------------------||------oo----------------------------------------------------##-#------------------------
-||||||-----%%%%QQ------------------------------TT-------TT-----------||------%%------%%%%----S-----------------------------##------##---##-----TT--------------
-||||||------||---------------------TT------TT--TT-------TT---TT------||------||-------||--------------TT--tt--------------###------##-#-##-----TT-------TT-----
-||||||------||-----tt--------------TT------TT--TT-------TT---TT------||------||-------||--------------TT--tt-------------##--------##---------#TT----tt-TT----T
-||||||------||-----tt----k---------TT-k----TT-kTT---y#-kTT---TT------||------||--y----|g--y-----------TT--tt----------#-#-#----##--##-#-#------TT----tt-TT----T
-X|||||-%%%%%%|-XXXXXXXXXXXXXXXXXXXXXXXXXXXXXXXXXXXXXXXXXXXXXXXX-XXX--||-%%---||XXXXXXXXXXXXXXXXXXXXXXXXXXXXXXXXXXXXXXXXXXXXXX-XXXX-XXXXXXXXXXXXXXXXXXXXXXXXXXXX
-X|||||--||||-|-XXXXXXXXXXXXXXXXXXXXXXXXXXXXXXXXXXXXXXXXXXXXXXXX-XXX--||-||---||XXXXXXXXXXXXXXXXXXXXXXXXXXXXXXXXXXXXXXXXXXXXXX-XXXX-XXXXXXXXXXXXXXXXXXXXXXXXXXXX
