--------------------------------------------------------------------------------------------------------------------------------------------------------------------------------
-----------------------------------------------------------------------------------------------------------K-K------------------------------------------------------------------
---------------------------2----------------------------------------------------------------------------------Q---------------------------------------------------o--------2----
-------------------------------------------------------------------------------------------------o--o-------%%---#--------------------------------------------------------------
----------------------------------------------------------------------------------------------------Q-Q-----||-----g##----------------------------------------------------------
---------------------------------------------oo----------------------------------------o---oooo-------%%%%%%||---###------------------------------------------------------------
--------%%%%%%%%---ySUSooooo--@%-------------------------S----2%------r--------------------------------||||-||----------------------------------------SQSSS--------Q-------@--2%
---------||||||----S------r----U-----------------------------U-|-----%%%--------------S--------------r-|r||-||U----------------------------------------------------------------|
---------||||||---SSSS---SS----|------#---------------------y--|------|-------------------------%%%%%%%%%%|-||------------------------------------------------------------K--2-|
---------||||||-------------2#-|S-----#--------S---------------|------|--------------------------||||||||-|-||1---1------SS----------------------------------------------------|
------%%%%%%%%%%----SS------##-#------#------------------SSSQ--|-----SS--------------------------|||||%%%%%-|%%---------------#-----------------------SSSS----SQ----------SSQQQS
-------||||||||------------###-#----#-#------------------------|------------TT-------------------|||||-|||--|||--------TT-----#--K--K--TT---------------------------------------
-------||||||||-----------##---#----#-#------------------------|---------TT-TT-------------------|||||-||%%%%||--------TT---###--------TT---------------------------------------
-------||||||||----------###---#----#-#--------------g-g-----ggg-------k-TT-TT-k-----------------|||||-||-||-||--------TT--####--------TT-------gggg-------g--g--y--------gggggg
XXXXXXXXXXXXXXXXX---XXXXXXXXXX-XX---XXXX------XXXXXXXXXXXXXXXXXXXXXXXXXXXXXXXXXXXXXXXXXXXXXXXXXX-%%%%%%%%%%%%%|-XXXXXXXXXXXXXXXXXXXXXXXXXXXXXXXXXXXXXXXXXXXXXXXXXXXXXXXXXXXXXXXX
XXXXXXXXXXXXXXXXX---XXXXXXXXXX-XX---XXXX------XXXXXXXXXXXXXXXXXXXXXXXXXXXXXXXXXXXXXXXXXXXXXXXXXX--|||g||g|gg|-|-XXXXXXXXXXXXXXXXXXXXXXXXXXXXXXXXXXXXXXXXXXXXXXXXXXXXXXXXXXXXXXXX
