-------------------------------------------------------------------------Q------------------------------------------------------------------------------------------------------
---------------------------------------------------------------------------K-K--------------------------------------------------------------------------------------------------
----------------------------------K--------R-----------------------------------U--------------------------------t---------------------------------------------------------------
----------------------------------------1-------oo-----SSSSSSSSS----------------------------------------SSSSSSSSt-----------------------------------SSSSSSSSSSSSSSSSSSSSSSSSSSSS
-------------------------------------------------------SSoo-----------Q---------------------------------SSSSSSS-t------------------------------------------------------------SSS
-------------------------------------------------------SSSS----------%%%%%%%----------------------------SSSSSSS-t---------------------------------------------------------K--SS-
--------%%%%%%%%-------------------LSo---ooo--@%----------------------|||||---------SSS---------------------SSS-----------------------------------------S------S----------------
---------||||||---------------------------r-K--|----------------------|||||---U----------------y------------------------r-------------------------------------------------------
---------||||||--------------------S-S---S--y--|%%%%%%%----------%%%%%%||||--------------------#----------------------%%%%%%%%--------------------------------------------------
---------||||||----------------------------K2--|-|||||---ooooSrS--||||-r|||r-----------------#----o------oooo-o--------||||||-----------------------------------ooo-------------
------%%%%%%%%%%--SS------------oS----------1--|-|||||------SS%%-%%%||%%%%%%%%%-----o-------###-------------SSS--------||||||----------#-------------------------------##-------
-------||||||||-----K--------------------------|-|||||--------||--|-||-|||||||-------------####------------------------||||||------------------------------------K-----##-------
-------||||||||--------------------------------|-|||||--------||--|-||-|||||||%%----------#####----------------------tt||||||----------------------------TT-TT---So----##-------
-------||||||||-----------k-y--------r---------|-|||||--------||--|-||-|||||||||---------######-------------k--------tt||||||-g------------------------k-TT-TT-k-SSk---##-----#-
XXXXXXXXXXXXXXXXXXXXXXXXXXXXXXXXXXXXXXXXXXXXXX-y-XXX||----X2--XX%%%%%%%|%%||||%|X--XXXXXXXXXXXXX-XX------XXXXXXX-XXXXXXXXXXXXXXXXXXXXXXXXXXXXXXXXXXXXXXXXXXXXXXXSXXX---XX---XXXX
XXXXXXXXXXXXXXXXXXXXXXXXXXXXXXXXXXXXXXXXXXXXXXyX-XXX||----XXX-XXgg||gg-|g|g|||||X---XXXXXXXXXXXX-XX------XXXXXXX-XXXXXXXXXXXXXXXXXXXXXXXXXXXXXXXXXXXXXXXXXXXXXXXXXXX---XX---XXXX
