------------------------------------------------------------------------------------------------------------------------------------------------------------------------------------------------
------------------------------------------------------------------------------------------------------------------------------------------------------------------------------------------------
------------------------------------------------------------------------------------------------------------------------------------------------------------------------------------------------
----------------------------------------------------------------S-----------------------------------------------SSS-------------SSSSSSSSSSSSSSSS-------------------------------o----------------
------------------------------------------------------------------------------------------------------------------------------------------------------------------------------------------------
--------------------------------------------------------oooo------------------------------------------------------------------------------------------------------------------------------------
--------%%%%%%%%-------------------------------------------------%%--------------------------------------------------------------------%%S------------------------------------------------------
---------||||||---------------------------------------------oooo-||----------------------------%---------------------------------------||---------------------------------------S#--------------
---------||||||--------------------------------------------------||-------------%%%------------|------------------------------S--------||-------------------------------------------------------
---------||||||--------------------------------o-----------------||--------------|-------------|-----------------------------SS--------||----------------------o-----------SSS------------------
------%%%%%%%%%%----------######----S------------TT----TT--------||--------------|-------------|---------------------------S-SSS-------||-----------S-------------------------------------------
-------||||||||----------------------------------TT----TT--------||--------------|--------#----|---------------------------S--------tt-||-------TT-------------------------------TT----TT-------
-------||||||||---------------------------------TT-----TT---TT---||--------------|-------##----#---o-----------------------S----%%--tt-||-------TT-------------------------------TT----TT-------
-------||||||||---------------------ggg-----k---TT-----TT---TT--%%%----k-----ggg-|-------##----#--%%%-----------#----------k-y--||--tt-||--#----TT-------------------------------TT----TT---k---
XXXXXXXXXXXXXXXXXXXXXXXXXXXXXXXXXXXXXXXXXXXXXXXXXXXXXXXXXXXXXXXXXXX-XXXXXXXXXXXX-XXXXXXXXXXX-------|---XXXXXX--XXXXXXXXXXXXXXXXX||XXXXXXXXXXX--XXXXXXXXXXXXXXXXX---------%%%%%%-XXXXXXXXXXXXXXXX
XXXXXXXXXXXXXXXXXXXXXXXXXXXXXXXXXXXXXXXXXXXXXXXXXXXXXXXXXXXXXXXX----XXXXXXXXXXXX--XXXXXXXXXX-------|---XXXXX---XXXXXXXXXXXXXXXXX||XXXXXXXXXXX-XXXXXXXXXXXXXXXXXX----------||||--XXXXXXXXXXXXXXXX
