---------------------------------------------------------------------------------------------------------------------------------------------------------------------------------------K--------
-------------------------------------------------------------------------------------------------K-------------------------------------------------------------------------------------o--------
---------------------------------------------------------------------------------------------------------------------------------------------------------------------------------------S--------
-----------------------SSSSSSS-----------------------------------#-------------------------------------SSSSSSSSS--------------------------------SSS---------------------------------------------
------------------------------------------------------------------------------------------------------------------------------------------------------------------------------------------------
----------------------------------------------------------------------------------------------------------------------------------------------------------------------------------------------%%
--------%%%%%%%%--------------------------------SSSSSSS-----SS-------QQQQS-----o-----------------SS--SS-------o--------------------------------------------------------SSS--------------------||
---------||||||-------------------------------------------------SS-------------#--------------------------##-------------------#----------------S---%%%-------K---%%%------------------o------||
---------||||||-------------------------------------------------------------------------------------------##------------------##---------------------|-------------|--------------------------||
---------||||||-----------------------------------------------------------------------------------g------##-------------------##---------------------|-------------|---------------------ooo--||
------%%%%%%%%%%-------------------------TT--------SSSS-----------------------#--#-----tt-------SSSSS----#-------------------###--TT-----------------|-------------|--------------------%%%%--||
-------||||||||----------##--------------TT----------------------------------###-#-----tt-------SSSS-SS###-------------TT----###--TT----TT----TT-----|-------#-----|---------------------||--oo|
-------||||||||----------##-------TT-----TT---------------------------------####-#-----tt------------#####------#------TT---####--TT----TT----TT-----|-#-----#-----|---------------------||-%%%%
-------||||||||---g------##-------TT-----TT--------k------k-k---------------######-----tt----g-------#####------#------TT--#####--TT----TT----TT-----|##-----#-----|---------------rr----||--||-
XXXXXXXXXXXXXXXXXXXXXXXXXXXXXXXXXXXXXXXXXXXXXXXXXXXXXXXXXXXXXXXXXXXXXXXXXXXXXXXXXXXXXXXXXXXXXXXXXXXXXXXXXXX-XXXXXXXXXXXXXXXXXXXXXXXXXXXXXXXXXXXXXXXXXXXXXXXXXXXX---XXXXXXXXXX%-X-%%%%%%%%%%%-||-
XXXXXXXXXXXXXXXXXXXXXXXXXXXXXXXXXXXXXXXXXXXXXXXXXXXXXXXXXXXXXXXXXXXXXXXXXXXXXXXXXXXXXXXXXXXXXXXXXXXXXXXXXXX-XXXXXXXXXXXXXXXXXXXXXXXXXXXXXXXXXXXXXXXXXXXXXXXXXXXX---XXXXXXXXX-|-X--|||||||||--||-
