--------------------------------------------------------------------------------------------------------------------------------------------------------------------------------
--------------------------------------------------------------------------------------------------------------------------------------------------------------------------------
--------------------------------------------------------------------------------------------------------------------------------------------------------------------------------
-------------------SSSS------------SSSSSSSSSSSSS------------------------------------------------------------------o----------------SSSSS--------SSS-----------------------------
------------------------------------------------------------------------------------------------------------------------------------------------SSS-----------------------------
--------------------------------------------------------------------------------------------------------------------------------------------------------------------------------
--------%%%%%%%%--------------------------------SoS--U--------2%----------SS---S-------------------SSQSQS-----Q@----------------------------------------------------------------
---------||||||------------SS--------------------------------U-|----------------------#---------------------------------oooooo--------------S-----S---------------oo------------
---------||||||-%---------SSSS----SS---------------------------|--SS------SS---------##-------------------------------------------------------------------TT--------------------
---------||||||-|---------SSSSSS--SS---------------------------|--------------------###----------------------1-----------------o----#---------------------TT--------------------
------%%%%%%%%%%|-------------------o--------------#------T----|-------------------####--TT--------SoSo----QQ----------------------####---------------#--###--------------------
-------||||||||-|----------------------------------------TT----|------------------#####--TT------------K---------------TT---------###-#--TT----T------#---------TT--------------
-------||||||||-|---------%%%---SS-----T---------#--#-B--##----#-------##--------######--TT----#-----------------------TT--------##-#-#--TT----T----#-#--------TTT--------------
-------||||||||-|----------|-----------T---kkk--#-----b--##----#---K---##--g----#######--TT----T---g-gg------#---k-----TT-------###-###--TT----T#---#-#--------TTT--------------
XXXXXXXXXXXXXXXX|--X------%%%---XXXXXXXXXXXXXXXXXXXXXXXXXXXXXXXXXXXXXXXXXXXXXXXXXXXXXXXXXXX-XXXXXXXXXXXXXXXXXXXXXXXXX--XXXXXXXXXXXXXXXXXXXXXXXXXXXXXXXXX--------XX--XXXXXXXXXXXX
XXXXXXXXXXXXXXXX|-XX-------|----XXXXXXXXXXXXXXXXXXXXXXXXXXXXXXXXXXXXXXXXXXXXXXXXXXXXXXXXXXXXXXXXXXXXXXXXXXXXXXXXXXXXXX-XXXXXXXXXXXXXXXXXXXXXXXXXXXXXXXXX--------XX--XXXXXXXXXXXX
