------------------------------------------------------S--------------------------------------------------------------------------------------------------------------------------------S--------
------------------------------------------------------S--------------------------------------------------------------------------------------------------------------------------------S-S------
------------------------------------------------------------------------------------------------------------------------------------------------------------------------------------------------
--------------------------------------------------S--SSSSSSSSSSS---------SSS--------------------------------------------------------------------------------------------------------------------
-------------------------------------------------------------------------------------------------------------------------------------------------------------------------o----------------------
------------------------------------------------------SS--------------------------------------------------------o-oo--------------------------------------------o----------------------SS-@-----
--------%%%%%%%%---------------o-SoSSSSSoS---SoSSSSS--SS-----SSS--------------------------------------QSoS-----o------------------------------------QQQQ---------------------S------------------
---------||||||--------------------------------------------------------------------------------------------------------------------------------#------------------------------------------------
---------||||||--SSSS--------SSo-----------------------------------------------------------------------------S----------------------------------------------------------------------------------
---------||||||-------------oS-S----------------S--oo----------So----------S-------------------------------SSS---------------------------------#-------------------------oooo--------------o----
------%%%%%%%%%%------Q-----SSSS-------------US-S--SSSS---------S--------------------2---TT-----------QQQ---SS---U-@---@-U--------------------######-------##-----------%%%%%S-------------%%---
-------||||||||--------------------------------------------------------------------------TT-------##-------------------------------------TT---######-------##------------|||---------------||---
-------||||||||--------------------------------------------------------------------------TT------###-------------------------------------TT---######------##-------------|||---------------||---
-------||||||||----------------------k---------------------------------------g----g--k---TT-----####-----------g------------------k------TT---######------##k------r-----|||---------------||---
XXXXXXXXXXXXXXXX---X------XXXXXXXXXXXXXXXXXXXXXXXXXXXXXXXXXXXXXXXXXXXXXXXXXXXXXXXXXXXXXXXXXXXXXXXXXXX-XXXXXXXXXXXXXXXXXXX----XXXXXXXXXXXXXXXXXXXXXXXXXXXXXXXXXXX-%%%%%%%%%%|------%%%%%%---||---
XXXXXXXXXXXXXXXX--XX------XXXXXXXXXXXXXXXXXXXXXXXXXXXXXXXXXXXXXXXXXXXXXXXXXXXXXXXXXXXXXXXXXXXXXXXXXXX-XXXXXXXXXXXXXXXXXXX-X--XXXXXXXXXXXXXXXXXXXXXXXXXXXXXXXXXXX--||||||||-|-------||||----||---
