------------------------------------------------------------------------------------------------------------------------------------------------------------------------------------------------
------------------------------------------------------------------------------------------------------------------------------------------------------------------------------------------------
------------------------------------------------------------------------------------------------------------------------------------------------------------------------------------------------
--------------------------------------------------------------------------------S--------SSSS---SSSSSSSS----------------------------------------SS------------------------------SSSSSSSSSSSSSSSS
------------------------------------------------------------------------------------------------------------------------------------------------------------------------------------------------
-----------------------------------------------o------------------------------------------------------------------o-----------------------------------------------o-----------------------------
--------%%%%%%%%--------------------QQQ--------------oSSSS-----o-------------------------------o--------------------------------------------------------------------------------------S------S--
---------||||||--------------------------------k-------------------------------------------##--#------------------------------------------------------------------------------------------------
---------||||||-----------------------------------------------oo---------------------------#####---------#--------------------------------------------------------------------------------------
---------||||||-----------------------------------------------------------o---------------#####----------#------------------------------------------g---------------------oo--------------------
------%%%%%%%%%%-----------------#---------SS---------------------------------------------####---------TT-------------------------------------TT---###----#-------------------------------------
-------||||||||------------------#-------------------------------------o-----------------#####--TT-----TT---TT---------------------------TT---TTTT-------##-------------------------------------
-------||||||||------------------#-#----------------------------------------------------######--TT---#-TT---TT---------------------------TT---TTTT-------TT-------------------------------------
-------||||||||------------------#-#-----------k-----gk------------#-------------#-----#######--TT---k-TT---TT-----#---------ooo---------TT---TTTT-------TT----#------------------------------g-
XXXXXXXXXXXXXXXXXXXXXXX---XX----XXXXXXXXXXXXXXXXXXXXXXXXXXXXXXXXXXXXXXXXXXXXXXXXXXXXXXXXXXXXXXX-XXXXXXXXXXXXXXXX---X------%%%%%%XXXXXXXXXXXXXXXXXXXXXXXXXXXXXXXXXo-------S---%%%XXXXXXXXXXXXXXXX
XXXXXXXXXXXXXXXXXXXXX-X---XX----XXXXXXXXXXXXXXXXXXXXXXXXXXXXXXXXXXXXXXXXXXXXXXXXXXXXXXXXXXXXXXX-XXXXXXXXXXXXXXXX---X-------||||-XXXXXXXXXXXXXXXXXXXXXXXXXXXXXXXXXXXX----------|-XXXXXXXXXXXXXXXX
