---------------------------------------------------------------------------------------K--------------------------------------------------------------------------------------------------------
---------------------------------------------------------------------------------------S--------------------------------------------------------------------------------------------------------
--------------------------------------------------------------------------------------%%--------------------------------------------------------------------------------------------------------
--------------------------------------------------------------------------------------||------------------------SSSS------SS-SSS--------------------------------SS--------------#---------------
--------------------------------------------------------------------------------------||--------------------------------------------------------------------------------------------------------
--------------------------------------------------------------------------------------||--------------------------------------------------------------------------------------------------------
--------%%%%%%%%---------------S------------------------------------------------------||-------------------------------------------------------oSooo--SSoSS--So------------------------SSo------
---------||||||-----------------------------------------------------------------------||-----------------------------#------------------------------------------------------------%%%%%---------
---------||||||----------------------------------------TT----##-----------#---TT------||-----------------------------#---------------------#---------------------------------------|||----------
---------||||||----------------------------------------TT----###---------##---TT------||----------------------------##----------oo-------------------------------------------------|||-----#----
------%%%%%%%%%%---------------------------------------TT---####--------TT----TT------||---------SS--SSSSSS---------##--------------------------S------------SSS-##----tt-------%--|||-----#----
-------||||||||--------------#-------------------------TT---####--TT----TT----TT------||-------------------------------------------------##----------------------##----tt-------|--|||-----#----
-------||||||||--------TT----#-------------------------TT---###---TT---###----TT------||--------------------------------TT--------------###----------------------##----tt-------|--|||---###----
-------||||||||--------TT----#-----------------------##TT--####---TT--####----TT------||------oo-----k----U-------------TT-----------g-#####--------------------##-----tt----k--|--|||--####----
XXXXXXXXXXXXXXXXXXXXXXXXXXXXXXXXXXXXXXX------%%-XXXXXXXXX--XXXX--XXXXXXXXXXXX-XX------%%%-%X%%%%XXXXXXXXXXXX----XXXXXXXXXXXXXXXXXXXXXXXXXXXXXXXXXXXXXXXXXXXXXXXXXXXXXXXXXXXXXXXX|-XXXXXXXXXX----
XXXXXXXXXXXXXXXXXXXXXXXXXXXXXXXXXXXXXXXX-----||-XXXXXXXXX-XXXXX-XXXXXXXXXXXXX--X-------|--|X-||-XXXXXXXXXXXXXXX-XXXXXXXXXXXXXXXXXXXXXXXXXXXXXXXXXXXXXXXXXXXXXXXXXXXXXXXXXXXXXXXXX-XXXXXXXXXX---X
