-------------------------------------------------------------------------------------------------------------------------------Q------------------------------------------------
--------------------------------------------------------------------------------------------------------------------------------------------------------------------------------
--------------------------------------------------------------------------------------------------------------------------------------------------------------------------------
--------------------------------SSSSSSSSSSSSSSSS--------------------------------------------------------------------------------------------------------------------------------
-----------------g-g----------------SSS-----SSS---------------------------------------------------------------------------------------------------------------------------------
------------------##----------------SS------------------------------------------------------------------------------------------------------------------------------------------
--------%%%%%%%%---------------------------oSSSS------------------@QQQ-QQQQ---------------------------------------------------------SS------------------------------------------
---------||||||----------------------------SS---------------------------------------------oo-------------ooo---------o----------------------------------------------------------
---------||||||-------------------S--------S-----------#--------------------------------------------------------%%---%-----------------------y----------------------------------
---------||||||-------------------S----------SS--------#--------------------------------------------------------||---|----------------------y#--------------------o-------------
------%%%%%%%%%%--S-----S-------%---SSS-SSS--S--------###---##-----QQ-----QQ-Q---------TT-----------------------||---|---%%%%%%-----K-------###-----------QQ------------------#-
-------||||||||-------------TT--|---------------------###---##-------------------------TT-----------------------||---|----||||-------------####---TT-------------------------##-
-------||||||||-------------TT--S------SSS%%-SS----#--###--####------------------------TT--------------TT-------||---|----||||------------#####---TT------------------------###-
-------||||||||---------gg--TT------------||-------#--###-#####------------------------TT--------------TT-------||k--|----||||----------K######---TT-----------------------####-
XXXXXXXXXXXXXXXXXXXXXXXXXXXXXXXX%-%%%%%-%%%%%---XXXXXXXXXXXXXXXXXXXXXXXXXXXXXXXXXXXXXXXXXXXXXXXXXXXXXXXXXXXXXXXXXXXXX|----||||-XX---XXXXXXXXXXXXXXXXXXXXXXXXXXXX---%%---X--XXXX-
XXXXXXXXXXXXXXXXXXXXXXXXXXXXXXXXg--|||---|||g---XXXXXXXXXXXXXXXXXXXXXXXXXXXXXXXXXXXXXXXXXXXXXXXXXXXXXXXXXXXXXXXXXXXXX|----||||-XX---XXXXXXXXXXXXXXXXXXXXXXXXXXXX---||---X--XXXX-
