------------------------------------------------------------------------------------------------------------------------------------------------------------------------------------------------
-------------------------------------------------------------------------------------------------------------------------------------------------K----------------------------------------------
------------------------------------------------------------------------------------------------------------------------------------------------------------------------------------------------
--------------------------------------------------S-SSSS------------------------------------------------------------------------------------------------------------------------SSSSSSSSSSSS----
------------------------------------------------------------------------------------------------------------------------------------------------------------------------------------------------
------------------------------------------------------------------------------------------------------------------------------------------------------------------------------------------------
--------%%%%%%%%------------------------------------------------S------ooo----oo------SSoSS------------------S---------------------------------------S------------------------------------------
---------||||||-------------------------------------------------S-------------------------------------------------------------------------------------------------------------------------------
---------||||||-----------------S---------------------------------------------------------------------------------------------------------------------------------------------------------------
---------||||||-------------------------------------------------S----------------------------------------------------------------------------------------------------------K-----------------oo-
------%%%%%%%%%%----------######-------------------------------------------------------------o------SS@S-----S----S-----------------------------------S---------------#--#-------------TT-------
-------||||||||---------------------------------------------------------#-----------------------------------------------------------------------SSSSS-----------------#-##------TT-----TT---TT--
-------||||||||---------------------------------------------------------#----------------------------------------------#------------------------S---------------------####------TT-----TT---TT--
-------||||||||-------------------------------oo-------k-------g------###------#---k---------------k----------------------------------k--------#k-----k---U-----------####------TT-----TT---TT--
XXXXXXXXXXXXXXXXXXXXXXXXXXXXXXXXXXXXXXXXXXXXX%%%XXXXXXXXXXXXXXXXXXXXXXXXXXXXXXXXXXXX---XXXXXXXXXXXXXXXXXX----XXX---X--XX---%----XXXXXXXXXXXXXXXXXXXXXXXXXXXXXXXXXXXXXXXXXXXXXXXXXXXXXXXXXXXXXXXX
XXXXXXXXXXXXXXXXXXXXXXXXXXXXXXXXXXXXXX-X-XXXXXXXXXXXXXXXXXXXXXXXXXXXXXXXXXXXXXXXXXXX---XXXXXXXXXXXXXXXXXX---XXXX---X--XX---|----XXXXXXXXXXXXXXXXXXXXXXXXXXXXXXXXXXXXXXXXXXXXXXXXXXXXXXXXXXXXXXXX
