------------------------------------------------------------------------------------------------------S-----------------------------------------------------------------------------------------
------------------------------------------------------------------------------------------------------------------------------------------------------------------------------------------------
------------------------------------------------------------------------------------------------------------------------------------------------------------------------------------------------
----------------------------------------------------------------------------------------------------------------------------------------------------------------------------------------------SS
------------------------------------------------------------------------------------------------------------------------------------------------------------------------------------------------
------------------------------------------------------------------------------------------------------------------------------------------------------------------------------------------------
--------%%%%%%%%-------------------------%%%----------SSS%S--SSS--------oo-----------SSSS------------------------------------S------------------------------------------------------------------
---------||||||---------------------------|-------o------|---------------------------------------------o---oo----------------------------------o-------------------------------------------o----
---------||||||---------------------------|--------------|--------------------------------------------%%------------------------------------------------------------------------------%%%-%%%---
---------||||||---------------------%%%%%o|--------------|--------------------------------------------||----SS-------------------------------------------------------------------------|---|----
------%%%%%%%%%%----------######-----|||--|--------------|-------S------------------------------------||-------S---oS-------------------------------------%%S@So-----------------------|---|----
-------||||||||----------------------|||--|--------------|--------------------------------------------||---------------------------------TT---------------||---------------------------|---|----
-------||||||||-------------------o--|||-#|--------------|---------------------#----------------------||---K-----------------------------TT------------TT-||-------------K-------------|TT-|----
-------||||||||-----------------%%%%-|||-#|--------------|--------------------gg----ggg---------------||---r--------------U--------------TT----o--gg---TT-||-------k-----------o-------|TT-|----
XXXXXXXXXXXXXXXXXXXXXXXXXXXXXXXX-||--||XXXXX---X---XXXXXXX--------XX----XXXXXXXXXXXXXXXXXXXXXXXX--XXX-||--SS%%--XXXXXXXXXXXXXXXXXXXXXXXXXXXXXXXXXXXXXXXXXXXXXXXX--XXX----X-----XXXXXXXXXXXXX-X-X
XXXXXXXXXXXXXXXXXXXXXXXXXXXXXXXX-||--||X-XXX---X---XXXXXXX--------XX----XX-XXXXXXXXXXXXXXXXXXXXX--XXX-XX----||--XXXXXXXXXXXXXXXXXXXXXXXXXXXXXXXXXXXXXXXXXXXXXXXX--XX-------------XXXXXXXXXXX-XXX
