--------------------------------------------------------------------------------------------------------------------------------------S---------------------------------------------------------
------------------------------------------------------------------------------------------------------------------------------------------------------------------------------------------------
------------------------------------------------------------------------------------------------------------------------------------------------------------------------------------------------
--------------------------------SSSSSSSSSSSSSSSS------------------------------------------------------------------------------------------------------------------------------------------------
---------------------------------o--------------------------------------------------------------------------------------------------------------------------------------------------------------
---------------------------------So----------------------------#-------------------------------------------------------------------------------------------------------------------------------o
--------%%%%%%%%----------------%%%%-------o---------QQ---------SSoS-S@SoS---SSS------SSSS----------QQQo------o---------------------------------------SSSSSSSSSS--------------------------------
---------||||||------------------||---------------------------------------------SSS-------------------------------------------------------------------------------------------------------------
---------||||||------------------||----------------------------------------------------------------------------S--------------------------------------------------------------------------------
---------||||||------------------||--%%--------------------------------g---------------------SSS---------------o--------------------------------------------------------------------------ooo---
------%%%%%%%%%%----------######%||--||----------2--------------@SQQS-SSS----SSS-----------------####-------------------------------------------------SSSSSSSS--------------------------%%%%%---
-------||||||||-----------------|||--||----------------------------------------------------------##-------------------------------------#-------------------------TT---------------------|||--oo
-------||||||||-----------------|||--||----------------#---------------------------------------#-##-------------------------------------#-------------------------TT---------------------|||-%%%
-------||||||||-----------------%%%--||--k-----#-------#----g------k--k----------------------g#####k------kkk----------k-----yg----ggg-k#--##---------------------TT-----#---------r-----|||--|-
XXXXXXXXXXXXXXXXXXXXXXXXXXXXXXXX-|---XXXXXXXXXXXXXXXXXXXXXXXXXXXXXXXXXXXXXX-XXXXXXXXXXXXXXXXXXXXXXXXXXXXXXXXXXXXXXXXXXXXXXXXXXXXXXXXXXXXXXXXXXXXXXXXXXXXXX-------XXXXXXXXX----XX-%%%%%%%%%%%--|-
XXXXXXXXXXXXXXXXXXXXXXXXXXXXXXXX-|---X-XXXXXXXXXXXXXXXXXXXXXXXXXXXXXXXXXXXX-XXXXXXXXXXXXXXXXXXXXXXXXXXXXXXXXXXXXXXXXXXXXXXXXXXXXXXXXXXXXXXXXXXXXXXXXXXXXXX------XXXXXXXXXX---XXX--|||||||||---|-
