-----------------------------------------------------------------------------------------------------------------------------------------------------%--------------------------
-----------------------------------------------------------------------------------------------------------------------------------------------------|--------------------------
-----------------------------------------------------------------------------------------------------------------------------------------------------|--------------------------
----------------S------------------------------------------------------------------------------------------------------------------------------------|--------------------------
-----------------------------------------------------------------------------------------------------------------------------------------------------|--------------------------
----------------------------------------------------------------------------------------------------------------------------------S---oooo-----------|--------------------------
--------%%%%%%%%--#------------------SSSSSSSSS------------------------USSS----2%--------------2-----------------------2------------------------------|r---------SSS---SQQQQQQSSS
---------||||||----------------------------------------------------------------|-------------------------------------------------oooS-----------oo---|--------------------------
---------||||||----------------#-----------------------------------------------|SSS--#---------------------------------------------------------------|--------------------------
---------||||||----------------------------------------------------------------|----##---------------------------------------------------------------|--------------------------
------%%%%%%%%%%---------#-###-#--SS----SSSS---------------------USS---S-------|---###-------------QQQ-------------------------------#--------TT-----|----------------@--@SS@---
-------||||||||------------###-#---------------K---------TT-----------------TT-|---###----------------------------------------------##--------TT-----|--------------------------
-------||||||||-----------######-------------------------TT-----------------TT-|-#-###---TT----#---------------------#--------------#---------TT-----|--------------------------
-------||||||||-----------######-----k----k-kk-----------TT-------------g---TT-|-#-###---TT----K---------------------#-k-##-----g---#-#-------TT-----|---k--------------------g-
XXXXXXXXXXXXXXXXX---XXXXX--XXXXXXXXXXXXXXXXXXXXXXXXXXXXXXXXXXXXXXXXXXXXXXXXXXXXXXXXXXXXXXXXXXXXX-XXXXXXXXXXXXXXXX---XXXXXXXXXX-XXXXXXXXXXXXXXXXXXXXXXXXXXXXXXXXXXXXXXXXXXXXXXXXX
XXXXXXXXXXXXXXXX----XXXX----XXXXXXXXXXXXXXXXXXXXXXXXXXXXXXXXXXXXXXXXXXXXXXXXXXXXXXXXXXXXXXXXXXXXXXXXXXXXXXXXXXXXX---XXXXXXXXXXXXXXXXXXXXXXXXXXXXXXXXXXXXXXXXXXXXXXXXXXXXXXXXXXXX
