------------------------------------------------------------------------------------------------------------------------------------------------------------------------------------------------
------------------------------------------------------------------------------------------------------------------------------------------------------------------------------------------------
------------------------------------------------------------------------------------------------------------------------------------------------------------------------------------------------
----------------------------------------------------------------------------------------------------------------S--------------S----------------------------------------------------------------
-----------------------------------------------------------------------------------------g-o----------------------------------------------------------------------------------------------------
---------------------------------------------------------------------------------------S-------------------------------------------------------------------------------------------------------o
--------%%%%%%%%---------------------QQQ------------------------#--------oo--------U---SoS----------------------%%%------------------S@SSS-SSSSS----------------------QSQS----------------------
---------||||||-----------------------------------------------------------------------------oo-------------ooo---|---------o-%%%----------------------------------------------------------------
---------||||||--------------------------------------------------------------------------------------------------|--------%%%-|-----------------------------------------------------------------
---------||||||-----------------------gg-----------------------------------------------k-------------------------|--%%%----|--|--o--------------------------------------------------------------
------%%%%%%%%%%----------##########SSSS------------------------%%S-------------------SQQ----------------#-----S%|---|-----|--|--------SS----U--%%-------%%%%----------------o---#o--------%%SSS
-------||||||||-----------------TT-SSSS-------------------------||--------------------------------TT----##------||---|-----|--|---------K----#--||--------||-------------------------------||---
-------||||||||-----------------TTSSSSS-------------------------||--------------------------------TT---###------||o--|-----|--|--------------#--||--------||-------------------------------||---
-------||||||||----------------###SS-kk---k-------g-------------||--------------------------------TT--####------%%%%-|-----|--|----ygg-------#--||-r------||-------k-kgy-----#-g---g-------||--k
XXXXXXXXXXXXXXXXXXXXXXXXXXXXXXXXXXXXXXXXXXXXXXXXXXXXXXXXXXXX-X%%X%XXXXXXXXXXXXXX--XX---------XXX-XXXXXXXXX-------||--|-X%X%%%-|-XXXXXXXXXXXXXXXX%%%%%--XXXXXX---XXXXXXXXXXXXXXXXXXXXXXXXXXXXXXXX
XXXXXXXXXXXXXXXXXXXXXXXXXXXXXXXXXXXXXXXXXXXXXXXXXXXXXXXXXXXX--||XXXXXXXXXXXXXXXX--XX--X------XXXXXXXXXXXXX-------||--|-X|--|--|-XXXXXXXXXXXXXXXX-|||----XXXXXX--XXXXXXXXXXXXXXXXXXXXXXXXXXXXXXXX
