--------------------------------------------------------------------------------------------------------------------------------------------------------------------------------
--------------------------------------------------------------------------------------------------------------------------------------------------------------------------------
---------------------------R--------------------------------------------------Q-------------------------------------------------------------------------------------------------
----------------------------------------------------------------SS----SSS%------------------------SS---------S------------------------------------------------------------------
-------------------------------------------------------------------------|------------------------------------------------------------------------------------------------------
----------------------------------##-------------------------------------%-------------------------------%---------------------------------------------------------------r------
--------%%%%%%%%---SSoSoo-----@S-----------------------------------------|-------------------------------|--oo------------------------------------@QQSSooSQS-------SQSS--S------
---------||||||----SSS----r-----####----oooo-------------------y-----oo--|----K----------------------r---|----K--------------------------oo-------------------------------------
---------||||||---SSSSSS-SS------------------------------------#-%%%%%%%-|---------------------#%%%%%%%--|----------------------------------------------------------------------
---------||||||------------KU-----------------------------K---#---|||||--|-------------------##--|||||---|---------------------------------------------------R-----o------o-----
------%%%%%%%%%%----------S----#-SS--------------------------##---|||||--|%%%%%-------------####-|||||---|%%%%%------------------oSS--------------%%--------------%%%%%----U-##-
-------||||||||------------#---#-----------tt---------------###---|||||--|-|||-------------#####-|||||---|-|||----------------------K-------------||---------#-----|||------###-
-------||||||||----------------#----tt-TT--tt--------------####---|||||--|%%%%%%----------#####--|||||---|%%%%%%---------------------------tt-----||%%%-----##-----|||-----####-
-------||||||||------g---#-----#ggg-tt-TT--tt-----K-------#####---||||go-|-||||--k-------#######-|||||---|-||||----------------------------tt-----|y-gg---####-----||g----#####-
XXXXXXXXXXXXXXXXXX-XXXXXXXXXXXXXXXXXXXXXXXXXXXXXXXXXXXXXXXXXXXXX--||||%%%%%%%%%-XXXXXXXXXXXXXXXX-|||||%%%%%%%%|-XXXXXXXXXXXXXXXXXXXXXXXXXXXXXXXX--XXXXXXXXXXXXXX--XXXXXXXXXXXXXX
XXXXXXXXXXXXXXXXXX-XXXXXXXXXXXXXXXXXXXXXXXXXXXXXXXXXXXXXXXXXXXXX--||||-|||||||--XXXXXXXXXXXXXXX--|||||-|g|g||-|-XXXXXXXXXX-XXXXXXXXXXXXXXXXXXXXX--XXXXXXXXXXXXXX--XXXXXXXXXXXXXX
