--------------------------------------------------------------------------------------------------------------------------------------------------------------------------------
--------------------------------------------------------------------------------------------------------------------------------------------------------------------------------
--------------------------------------------------------------------------------------------------------------------------------------------------------------------------------
----------------------------------------------------------------------------------------------------------------SS--------------------------------SSSSSSSSSSSSSS---SSSSSSSSSSS--
--------------------------------------------------------------------------------------------------------------------------------------------------------------------------------
-------------------------------------------------------oo-----------------------------------------------------------------------------------------------------------------------
--------%%%%%%%%-------------------------------------------------##------------------Q-@SQQS----------r---------------------------------------------------------SSoooSS-US------
---------||||||----------------------------------oo---------------SSS---------------------------%%%%%%%%%%-----------o----------------------------------------------------------
---------||||||------------------%%%-------------------------------------------------------------||||||||---------------------------------------%%-%%---------------------------
---------||||||-------------------|------ooS-----------------------------------------------------||||||||---------------------------------------||-||---------------------------
------%%%%%%%%%%------------------|------SS-----------#----------##-##------------S----SSSSSQ---QSS||||SoSS-------------------------------------||-||-%%%%%---------------------
-------||||||||-------------------|-------------------#---------#--------TT---TT-------------------||||-|--------TT------TT---------K-----------||-||--|||---------------TT-----
-------||||||||-------------------|--------------#--#-#-----%---#---#----TT---TT-------------------||||-|--------TT------TT---------------------||-||--|||---------------TT-----
-------||||||||-------g-----------|----------k--#---#-#-----|---#---#y#--TT---TT--------ggg-----ggg||||-ggggg--k-TT---g--TT----o-------#--------||-||--|||------------g--TT-----
XXXXXXXXXXXXXXXXXXXXXXX-------%---|%%------XXXXXXXXXXXXX--%%%%--XXXXXXXXXXXXXXXXXXXXXXXXXXXXXXXXXXXXXXXXXXXXXXXXXXXXXXXXXXX----XXXXXXXXXXXXXXXXX|XXX|--|||----X-XXXXXXXXXXXXXXXX
XXXXXXXXXXXXXXXXXXXXXXXX------|---|||------XXXXXXXXXXXXX---||---XXX-XXXXXXXXXXXXXXXXXXXXXXXXXXXXXXXXXXXXXXXXXXXXXXXXXXXXXXX----XXXXXXXXXXXXXXXXX|XXX|--|||---XX-XXXXXXXXXXXXXXXX
