------------------------------------------------------------------------------------------------------------------------------------------------------------------------------------------------
------------------------------------------------------------------------------------------------------------------------------------------------------------------------------------------------
------------------------------------------------------------------------------------------------------------------------------------------------------------------------------------------------
----------------SSSSSSSooo----SS---------SSSSSSS------------------------------------------------------------------------------------------------------------------------------------------------
---------------------%%%%%----------------------------------------------------------------------------------------------------------------------------------------------------------------------
----------------------|||---------------------------------------------------------o-----------------------------------------------o-------------------------------------------------------------
--------%%%%%%%%------||oo------%%%o------ooo------------------o------Qoo---------------------------------------S----S---------------------------------------SS---------------------------------
---------||||||-S-----|||-rr-----|------------------------------S----------ooo--------------------------------------------------------------------------------------------------S----------o----
---------||||||-S-----%%%%%%%----|--SSS-S--------------------------------------------------------------------------------------------------------------------------------------#S---------------
---------||||||-S------|||||-----oo----------------------------------------------------------o----------------------------------------#-----------------------oo---------------#----------------
------%%%%%%%%%%S------|||||----SSS-------------%%%--------------------###------------S-----------------------TT--SSSSSS----------------------------S--------SSS--------------##----------------
-------||||||||-o------|||||---------------------|-----------#--------###-------S-TT--------------TT----------TT------------------------------------------K--------------TT---##----------------
-------||||||||-%%-----||K||---------------------|-----------#---#---####-------S-TT--------------TT-----TT---TT---------------------------------------------------------TT---##----------------
-------||||||||-||-----||rrr-g----------------o--|-----#-----#---#-######-------S-TT--------k-SS--TT-----TT-o%%#-----k-----------------------------------------------gg--TT--###----------------
XXXXXXXXXXXXXXXX||----XX%%%%%XXX---------%%%%%%%XXXXXXXXXXX-XXX-XXXXXXXXXX-XXXXXXXXXXXXXXXXXXXXX--XXXXXX-XX--||-XXXXXXXXXXXXXXXXXXXX--XXX-XXXXXXXXXXXXXXXXXXXXXXXXXXXXXXXXXXXXXXXXXXXXXXXXXXXXXX
XXXXXXXXXXXXXXXX||----XXXXXX-XXX----------|||X|-XXXXXXXXXXX-XXX-XXXXXXXXXX-XXXXXXXXXXXXXXXXXXXXX--XXXXXX-XX--||-XXXXXXXXXXXXXXXXXXXX--XXX-XX-XXXXXXXXXXXXX--XXXXXXXXXXXXXXXXXXX-XXXXXXXXXXXXXXXX
