------------------------------------------------------------------------------------------------------------------------------------------------------------------------------------------------
------------------------------------------------------------------------------------------------------------------------------------------------------------------------------------------------
------------------------------------------------------------------------------------------------------------------------------------------------------------------------------------------------
----------------SSSSSSSSSSSSSSSS--------------------------------SSSSSSSSSSSSSSSS----------------------------------------------------------------------------------------------------------------
----------------S------------------------------------------------SS----S------------------------------------------------------------------------------------------------------------------------
-------------------------------------------------------------------------------------------------------------------------------------------------------------------------------------------ooooo
--------%%%%%%%%-------------------------------------------------------------SS-------------------------------------------------------S-------------QQQQ------oo---------------------------%%---
---------||||||--------------------------------#-------------------------------------------------#--------------------o--------------------------------------------------------o-----------||---
---------||||||---------------S----------------#-----------------------------------------------------------------%%%-%%%-------------------------------------------------------------------||---
---------||||||--------------------------------#----------------o-------------------------------------------------|---|-------------------------------------------------------------------o||---
------%%%%%%%%%%--------------------#---------##---------------------------------------------S----------TT--------|---|---------------------------##---##-------------------------------%%%%%---
-------||||||||--#-----K----------------------##---------TT------------------------------TT------TT-----TT--------|---|---------------------------##---##--------------TT----------------|||----
-------||||||||--##----------------------TT---##---------TT--------------##--------------TT------TT-----TT--------|---|-----------------##------#####--------#---------TT----------------|||----
-------||||||||--##----k---kkkk----gg----TT---##%------k-TT----#----gg---##----o---k-----TT------TT-----TT----##--|---|--------#------####------######k-----------g----TT----yg--ooo---k-|||----
XXXXXXXXXXXXXXXXXXXXXXXXXXXXXXXXXXXXXXXXXXXXXXXXXX--XXXXXXXXXXXXXXXXXXXXXXXXXXXXXXXXXXXXXXXXXXXXXXXXXXXXXXXXXXXX--%---%%%XXXXXXXXXXXXXXXXXXXXXXXXXXXXXXXXXXXXXXXXXXXXXXXXXXXXXXXX%%%%XXXXXXXX---
XXXXXXXXXXXXXXXXXXXXXXXXXXXXXXXXXXXXXXXXXXXXXXXXX---XXXXXXXXXXXXXXXXXXXXXXXXXXXXXXXXXXXXXXXXXXXXXXXXXXXXXXXXXXXX--|----|-XXXXXXXXXXXXXXXXXXXXXXXXXXXXXXXXXXXXXXXXXXXXXXXXXXXXXXXXXXX-XXXXXXXX---
