------------------------------------------------------------------------------------------------------S-----------------------------------------------------------------------------------------
------------------------------------------------------------------------------------------------------S-------------------------------------------------------------------------------S---------
------------------------------------------------------------------------------------------------S-----------------------------------------------------------------------------------------------
---------------------------------SSSSSSS--------------------------SSSSSS-SSS-----SS--SSSSSSSSSSSSSSSSSSSSSSSSSSS----------------------------------------------------------------SSSSSSSSSSSSSSSS
------------------------------------------------------------------------------------------------S-----------------------------------------------------------------------------------------------
---------------------------------------------------------------------------------------------------------------S-ooo----------------------oo----------------------------------------------------
--------%%%%%%%%-----------------Soo----o------o-----------------------------S--------------------------------------------------------------------------SSSSS-------QQQQ--------oooo---So-------
---------||||||--------------------------------------------------------------S--------------------------------------------------------------------o%%-------------------------------------------
---------||||||------------------------------------%%%-----S----------------SS---------------------------------------------------------------------||----------------------------------------S--
---------||||||-------------------------------------|-----------------------So---o-------------------------S-SS------------------------------------||----------------------------------------So-
------%%%%%%%%%%---------TT-------------------------|--------------SSSS----------------#-------------------S-----U----S----------------------------||--QQ----S---#-----------o--S------------SSS
-------||||||||----------TT-------------------------|-----------SSSSSS--TT----TT-------#-------------------------#---------------------TT----------||-------------------------------------------
-------||||||||----------TT-------------------------|-----------S-SSSSS-TT----TT-------#---#----#---###----------#---------------------TT-----TT---||--------#----------------------##----------
-------||||||||---g-g----TT----o-----k------k-------|-----------S-SSSSS-TT--k-TT-------#---y-g--#---###----k-g---#---------------gg----TT---k-TT---||--------------y---g----k---#---##-----k----
XXXXXXXXXXXXXXXXXXXXXXXXXXXX----XXXXXXXXXXXXXXXX---XXXXXXXXXXX--XXXXXXXXXXXXXXXXXXXXXXXXXXXXXXXXXXXXXXXXXXXXXXXXXXXXXXXXXXXXXXXXXXXXXXXXXXXXXXXX--XX|-XXXXXXoXXXXXXXXXXXXXXXXXXXXXXXXXXXXXXXXXXX
XXXXXXXXXXXXXXXXXXXXXXXXXXXX----XXXXXXXXXXXXXXXX---XXXXXXXXXXX--XXXXXXXXXXXXXXXXXXXXXXXXXXXXXXXXXXXXXXXXXXXXXXXXXXXXXXXXXXXXXXXXXXXXXXXXXXXXXXXX--XX|-XXXX--XXXXXXXXXXXXXXXXXXXXXXXXXXXXXXXXXXXX
