------------------------------------------------------------------------------------------------------------------------------------------------------------------------------------------------
------------------------------------------------------------------------------------------------------S---S-------------------------------------------------------------------------------------
------------------------------------------------------------------------------------------------------------------------------------------------------------------------------------------------
---------------------------------SS----------------------------------------------------------------------SSSSSSS--------------------------------------------------------------------------------
------------------------------------------------------------------------------------------------------------------------------------------------------------------------------------------------
------------------o---------------------------------------------------------------------------------------------------------------------ooo----------------------------------------------------#
--------%%%%%%%%------------------------------------QS------------------ooo----------------------------------------------------------------------------S-------SSS--SSS-------------------------
---------||||||---------------------------------------------------------------------------------------------------o----o--oo--------------------S----------------------------------------------o
---------||||||-------------------------------------------------------------------------------------------------%%%%--%%%%%%%-------------------------------------------------------------------
---------||||||-----------------------------#--#---------------------------------------------------------------o-||----|||||--------------------------------------------------------------------
------%%%%%%%%%%-------#-------------2----######SS---------SS@S----------------------------------SSSSSS--S-------||----|||||------------TT-------------------#---------------ooo-----------#----
-------||||||||---------------------------######----------------------------------TT-------------TSSSS-----------||----|||||------------TT---#---------------#---------o-------------------#----
-------||||||||-------------------------TT######----------------------------------TT----TT----TTTTSSS------------||----|||||-%-#--TT----##---#---------#---###-----------------------------#----
-------||||||||-----------------g-------TT######--ggggg--------------k---------#--TT----TT----TTTT---Skk---------||----|||||-|-#--TT----##---#---------#---###------g----------g----------##----
XXXXXXXXXXXXXXXXXXXXXXXXXXXXXXXXXXXXXXXXXXXXXXXXXXXXXXXXXXXXXXXX--XXXXXXXXXXXXXX--XXXXXXXXXXX-XXXXXXXXXXXXXXXXXX-|XXXXXX%XXX-|--XXXXXXXXXX--XXX-XXXXXXXXXXXXXXXXXXXXXXXXXXXXXXXXXXX----XXXXXXX-X
XXXXXXXXXXXXXXXXXXXXXXXXXXXXXXXXXXXXXXXXXXXXXXXXXXXXXXXXXXXXXXXX--XXXXXXXXXXXXXX---XXXXXXXXXX-XXXXXXXXXXXXXXXXXX-|XXXXXXXXXX-|--XXXXXXXXXX--XXX-XXXXXXXXXXXXXXXXXXXXXXXXXXXXXXXXXXX---XXXXXXXXXX
