------------------------------------------------------------------------------------------------------------------------------------------------------------------------------------------------
------------------------------------------------------------------------------------------------------------------------------------------------------------------------------------------------
------------------------------------------------------------------------------------------------------------------------------------------------------------------------------------------------
-----------------------------------------------------------------------------SSS-------S------------------------SSSSSSSSS-------SSSSSSSS--------SSSSSSSS--------SSSSSSSSS-----------------------
------------------------------------------------------------------------------------------------------------------------------------------------------------------------------------------------
------------------o-----------------------------------------------------------------------------------------------------------------------------------------------------------------------------
--------%%%%%%%%-%%------------------------------------------------------------------------------------------------------------------------------------------------------------S-----SSS---S----
---------||||||--||-------------------------------------------------------------------------------------------------------------------------o--------------#------------------------------------
---------||||||--||-----------------o----------------------------------------------------------------------------------------SS------------------------------SSS--------------------------------
---------||||||--||------------------%-----------o--------------------------------------------------------------------------------------------------------------S-------------------------------
------%%%%%%%%%%-||------------------2----------%%-------------------------------------------#--------------------------------------------------------------------------------------------------
-------||||||||--||------------------|--TT------||----------------------TT--------------#---##-----------TT----#----tt---#--------------------TT---------#-------------###-#--------------------
-------||||||||--||------------------|--TT------||----------------------TT-------------##---##-----------TT----#----tt---###----------tt------TT-------###---------#-#####-#-#------------------
-------||||||||--||-------------%%%--|--TT---ooo||-----k-----g-g--------TT------------###--###------ggg--TT---##----tt---###---g------tt------TT------####-#--g-##-#######-#-#-------kkk---kkk--
XXXXXXXXXXXXXXXXXX%%--X%%%%X-X-X-|---XXXXXXXXX%%XXXXXXXXXXXXXXXXXXXXXXXXXXXX-XXXXXXXXXXXXXXXXXXXXXXXXXXXXXXXXXXX-XXXXXXXXXXXXXXXXXXXXXXXXXXXXXXXXXXXXXXXXXXXXXXXXXXXXXXXXX-XXXXXXXXXXXXXXXXXXXXX
XXXXXXXXXXXXXXXXXXX|---X||-X-X-X-|--XXXXXXXXXXXXXXXXXXXXXXXXXXXXXXXXXXXXXXXX-XXXXXXXXXXXXXXXXXXXXXXXXXXXXXXXXXXXXXXXXXXXXXXXXXXXXXXXXXXXXXXXX--XXXXXXXXXXXXXXXXXXXXXXXXXXX-XXXXXXXXXXXXXXXXXXXXX
