------------------------------------------------------------------------------------------------------------------------------------------------------------------------------------------------
------------------------------------------------------------------------------------------------------------------------------------------------------------------------------------------------
------------------------------------------------------------------------------------------------------------------------------------------------------------------------------------------------
----------------SSSSSSSS--S-----SSSSSSSSS-----SS-----------------------------------------------------------------------------------------------S------------------------------------------------
------------------------------------------------------------------------------------------------------------------------------------------------------------------------------------------------
---------------------------o--------------------------------------------------------------------------------------------------------------------------------o---------------------o-------------
--------%%%%%%%%----------SS-----------------------SQS---------------------------%%-------------SSS-----------------QQQQQ------o---------------------S@S---------------oo------o----------------
---------||||||---------------------------------------------------------------oo-||---------------------------------------------SS---------------------------------------------------------o----
---------||||||------------------------------------------------------------------||-------------------------------------------------------------------------------------------------------------
---------||||||----------------------------------o-------------------------------||--------------------U------------------------------SSSSSSSSSS----------------------------------TT------------
------%%%%%%%%%%#------tt-----------------------###----------------------%%------||-------------SSQS------------####Q##------US------------SSS---SS--SSSSSS--U---####-------------TT----TT------
-------||||||||-#------tt------------------------------------------------||------||--------------------------------#---------------------------------------------###---K----------TT----TT---#--
-------||||||||-##----tt-----#--TT----------------------#----------------||------||------------#-------------------------------------------K--------------------###---------------TT----TT---#--
-------||||||||-##----tt-----y--TT--------------------#####--------------||------||------------#--ggg--------------k--gg--k----------------k-g------------------###k---k---kkk----TT--k-TT---#--
XXXXXXXXXXXXXXXXXXXXXXXXXXXXXXXXXXXX-XXXXXXXXXXXXXXXXXXXXXXXXXXX%%%%--X%X||--%%--||--XXXXXXXXXXXXXXXXXXXXXXXXXXXXXXXXXXXXXXXXXXXXXX-----XXXXXXXXXXXXXXXXXXXXXXXXXXXXXXXXXXXXXXXXXXXXXXXXXXXXXXXX
XXXXXXXXXXXXXXXXXXXXXXXXXXXXXXXXXXXX-XXXXXXXXXXXXXXXXXXXXXXXXXXX-||----X-||--||--||--XXXXXXXXXXXXXXXXXXXXXXXXXXXXXXXXXXXXXXXXXXXXXX-----XXXXXXXXXXXXXXXXX-XXXXXXXXXXXXXXXXXXXXXXXXXXXXXXXXXXXXXX
