------------------------------------------------------------------------------------------------------------------------------------------------------------------------------------------------
------------------------------------------------------------------------------------------------------------------------------------------------------------------------------------------------
------------------------------------------------------------------------------------------------------------------------------------------------------------------------------------------------
--------------------------------SSSSSSSSS--SSSSSSSSSSSSSo----SSSSSSS----------------------------SSS---------------------------------------------------------------------------------------------
------------------------------------------------------------------------------------------------------------------------------------------------------------------------------------------------
------------------------------------------------------------------------------------------------------------------------------------------------------------------------------------------------
--------%%%%%%%%-------------------------------------------------------SSSSS---o-------Q----------------------------------------------SSSSS----o-----SS-----------------------------------------
---------||||||-----------------%%%--------#----------------r------------------#---------------#---------------------------------------------------------------#--------------------------------
---------||||||------------------|---------#--------------%%%%%----------------#--------------##--------------------------#---SS--------------S----------------#--------------------------------
---------||||||------------------|-------------------------|||----------------##-------------###-----------S--------------#------------------------------------#--------------------------------
------%%%%%%%%%%----------######-|-------#-#----%----------|||----------------##-------TT---###--------------------------##-----------------SSS-----SS--------##--------------------------------
-------||||||||-----------------o|--o----#-#----|----------|||---------------###-------TT---####------------------------###----------------------------------###---------#---------------TT-----
-------||||||||-----------------%%-%%%-###-#----|----------|||-------tt----#####-------TT--####--------------K---------####----------------------------TT---####--------##---------------TT-----
-------||||||||-----------------||--|--###-#----|----------|||-------tt---######--g----TT--####--------------k--------#####-k------kgg----------g------TT---####--------##-----o---gg----TT-----
XXXXXXXXXXXXXXXXXXXXXXXXXXXXXXXX||--XXXXXX%X---X|---XXXXXXXXX|-XX-XXXXXXXXXXXXXXXXXXXXXXXXXXXXXXXXXXXXXXXXXXXXXXXXXXXXXXXXXXXXXXXXXXXXXXXXXXXXXXXXXXXXXXXXXXXXXX-oXXXXXXXXX----XXXXXXXXXXXXXXXXX
XXXXXXXXXXXXXXXXXXXXXXXXXXXXXXXX||X-XXXXXXX----X|----XXXXXXXX|-XX-XXXXXXXXXXXXXXXXXXXXXXXXXXXXXXXXXXXXXXXXXXXXXXXXXXXXXXXXXXXXXXXXXXXXXXXXXXXXXXXXXXXXXXXXXXXXXX--XXXXXXXXX-----XXXXXXXXXXXXXXXX
