-----------------------------------------------------------------------------------------------------------------------------------------------------SS--S--------------------------------------
---------------------------------K-------------------------------------------------------------------------------------------------------------------SS-SSS-------------------------------------
------------------------------------------------------------------------------------------------------------------------------------------------------------------------------------------------
------------------------------------------------#-----------------------------------------------------------------------------------------------------------------------------------------------
-----------------------------------------------------------------------------------------------------------------------------------------------o------------------------------------------------
----------------------------------------------------------------------------------------------------------------------------------o------------------@-----------------------------o----S-@-----
--------%%%%%%%%-------------------------------U-------SS------------------------oo--SSS------oo--------------------------#------%----------------------o----------------------S---2------------
---------||||||---------------------------------%%%%%------y--SS--------------------------------------------K-------------#------|--------------------------------------------------------------
---------||||||------------------------------K---|||-------##-S------------------------------------------------------------------|--------------------------------------------------------------
---------||||||---------------------g------------|||------###------------------S--k--------------------TT------------------------|----------------------SSSSSSS----------------------------o----
------%%%%%%%%%%----------######----S--------U---|||-----####-------#-----------#--------#-------------TT-------------TTTT--TTTT-|-----------------------------------------------S--SSSSSS---SS-
-------||||||||--------------------------TT------|||----####--------------S--------------##--#---------##-------------TTTT--TTTT-|---------------SS@-------------------TT-----------------------
-------||||||||--------------------------TT------|||---######-------------S-------------###--#------------------------TTTT--TTTT-|------------TT-----------------------TT-----------------------
-------||||||||--------------------k-kgg-TT------|||--######----k--------------------gg-###-##---------------k--k-----TTTT--TTTT-|----g-----k-TT---kS-------------gg---TT----------k------------
XXXXXXXXXXXXXXXXXXXXXXXXXXXXXXXXXXXXXXXXXXXXXXXXXXXXXXXXXXXX----XXXXXX----XXXXXXXXXXXXXXXXXXXXXXXXXXXXXXXXXXXXXXXXXXXXXXXXXXXXXXXXXXXXXXXXXXXXXX-XXXX--------XXXXXXXXXXXXXXXXXXXXXXXXXX-X---XXXX
XXXXXXXXXXXXXXXXXXXXXXXXXXXXXXXXXXXXXXXXXXXXXXXXXXXXXXXXXXXX----XXXXX-X----XXXXXXXXXXXXXXXXXXXXXXXXXXXXXXXXXXXXXXXXXXXXXXXXXXXXXXXXXXXXXXXXXXXXX-XXXX-XX-----XXXXXXXXXXXXXXXXXXXXXXXXXX-X---XXXX
