---------------------------------------------------------------------------------------------------------------------------------------------------S--------------------------------------------
------------------------------------------------------------------------------------------------------------------------------------------------------------------------------------------------
------------------------------------------------------------------------------------------------------------------------------------------------------------------------------------------------
----------------------------------------------------------------------------------------------------------------SSSSS-----------SSSSSSSSSSSSSSSS---------------------------------#--------------
--------------------------------------------------------------------------------------------------------------------------------SSS--SSS----SSSS------------------------------------------------
-------------------------oooo-------------------------------------------------------------@---o---------------------------------SSS--SSSS-SSSSSS------------------------------------------------
--------%%%%%%%%----------%%%---------------------o-QQQS------oS----------------SSSS----------------------------------------------So--------SSSS---------------------------------------ooo-----o
---------||||||------------|---o---------------------------y-------------------------------------------------------------------o---------------------------------------o------------------------
---------||||||------------|------------------------------##-------------------------------------------------------------------------------------%%%%%------------------------------------------
---------||||||------------|-----------------------------#----------------------------------------------------------------------Soooooo-------SS--|||-------------------------------------------
------%%%%%%%%%%---------%%%------------##--------------##-----------------------SSo---------SS--##------------------2----------SSSSSSSS-----S-S--|||----------------------------###------------
-------||||||||-----------|-------------##-------------###---------------------------------------##--------------#--------------------------------|||-----------------------#----##-------------
-------||||||||-----------|-----------####------------####---------------------------------------##----TT--------#-----------------------------#--|||----------#-----------##-----#-------------
-------||||||||-----------|-------k---#####----------#####k-----k-----------k------k------U-----###----TT----g--##-----k-----g-----------ooo-g-#--|||----------#----------###----##k---g--ggk---
XXXXXXXXXXXXXXXX%%%%%%%%%%%%%%%-XXXXXXXXXXXXXXXXXXXXXXXXXXXXXXXXXXXXXXXXXXXXXXXXXXXXXXXXX-X--XXXXXXXXXXXXXXXXXXXXXX--XXXXXXXXXXXXXXXXXXXXXXXXXXX--|||------X----XXXXXXXXXXXXXX--XXXXXXXXXXXXXXXX
XXXXXXXXXXXXXXXX-|||||||||||||--XXXXXXXXXXXXXXXXXXXXXXXXXXXXXXXXXXXXXXXXXXXXXXXXXXXXXXXXX-X-XXXXXXXXXXXXXXXXXXXXXXX--XXXXXXXXXXXXXXXXXXXXXXXXXXX--|||------X----XXXXXXXXXXXXXXo-XXXXXXXXXXXXXXXX
