--------------------------S---------------------------------------------------------------------------------------------------------------------------------------------------------------------
---------------------SS--SSS--------------------------------------------------------------------------------------------------------------------------------------------------------------------
------------------------SSSS--S-----------------------------------------------------------------------------------------------------------------------------------------------------------------
----------------SSSSSSSSSSSSSSSS--------------------------------SS--------------SSS----------SSS------------------------------------------------------------------------------------------------
-----------------------SSSSS-SSS----------------------------------------------------------------------------------------------------------------------------------------------------------------
---------------------SSS-----S-S--------------------------oo-------------------------------------------------------------------------------------oo-----oo--------------------------------------
--------%%%%%%%%-SSSSSSS----SS----------------------------------------------------------------------------------------------------------Q--------------------------------------o----------------
---------||||||-------------S---------oo---oo------------------#---------------------------------------------------------------------------------@-----------ooo--------------------------------
---------||||||-------------S---------------------------------##------------------------------------------------------------------------------------------------------------------------------SS
---------||||||--------------ooS-----------------------------###----------------------------------------------------------SSSS------gggg----------------------------##-----#--------------------
------%%%%%%%%%%---SSSSS------SS-----------------------TT---####-------------------------------------------------------##---------#######----Q----TT-2--------------##-----#--------------#-----
-------||||||||-S--S-----------------------------------TT---###--------------------------TT-------TT-------------------#--------TT####------------TT----TT-----------------###-----------##-----
-------||||||||----------------------------------------TT--####--------------------------TT-------TT----------------------------TT#---------------TT----TT------#--------TT####----------##-----
-------||||||||---------------------------------g------TT--####-----------------%%%------TT-------TT----------ko#-#----------k--TT#k------k-k-----TT----TT----###------k-TT####-----ggg####-kkk-
XXXXXXXXXXXXXXXXXXXXXXXXXXXXXXXXXXXXXXXXXXXXXXXXXXXXXXXXXXXXXXXXXXXXXXXXXXXXXXXX-|-XXX---XXXXX---XXXXXXXXXXXXXXXXXXXXXXXXXXXXXXXXXXQ-XXXXXXXXXXXXXXXXXXXXXXXXXXXXXXXXXXXXXXXXXXXXXXXXXXXXXXXXXXX
XXXXXXXXXXXXXXXXXXXXXXXXXXXXXXXXXXXXXXXXXXXXXXXXXXXXXXXXXXXXXXXXXXXXXXXXXXXXXXXX-|-XXX---XXXXX-XXXXXXXXXXXXXXXXXXXXXXXXXXXXXXXXXXXXX-XXXXXXXXXXXXXXXXXXXXXXXXXXXXXXXXXXXXXXXXXXXXXXXXXXXXXXXXXXX
