------------------------------------------------------------------------------------------------------------------------------------------------------------------------------------------------
-----------------------------------------------------------------------------------------------------------------------------------------------------------------SS---S---S---------------------
--------------------------------------------------------------------------------------------------------------------------------------------------------------------------SS--------------------
-------------------------------------------------------------------------------------------------------------SSS----------------SSSSSSSSSS----------------------SSSSSSSSSSSSSSSS----------------
-----------------------------------------g--------------------------------------------------------------------------------------S-------------------------------SS---S-----S-S------------------
----------------------------------------------------------------------------------o-------oo--------------------------------------------------------------------SS---SS----S-SSS----------------
--------%%%%%%%%-----------------------SoS---S@-------------------------------------------------------------------------------------------SS------------------------------SSSSSS----------------
---------||||||------------------------------------------------------------------------------------------------#--------------------------------------------------------------------------------
---------||||||-----------------------U--------------#---------------------------------TT----------%%%------------------------------------------------------------------------SS----------------
---------||||||-----------------------U--------------#---------------------------------TT-----------|----------#--------------------------------------------------------------SS----------------
------%%%%%%%%%%----------######----o-U------US----S##-------------------------------SoTT-----------|-------------------------------------------%SS-------------S----------o-SSS----------------
-------||||||||------------------------------------------------------------------------TT---TT------|---------oo---------#----------------------|--------------o--------##-#-----------##-------
-------||||||||------------------------------------------TT--------K------------TT-----TT---TT------|-------%%%%---------#----------------------|---------------------####-#----------###-------
-------||||||||--------------------k---------------------TT--------k------y-----TT---k-TT---TT------|---rrr--||----------#----------------#-----|--------------------#####-#----------###-------
XXXXXXXXXXXXXXXXXXXXXXXXXXXXXXXXXXXXXXXXXX--XXXXXXXXXXXXXXXXXXXXXXXXXXXXXXXXXXXXXXXXXXXXXXXXXXXX----|-%%%%%%-||-XXXXXXXXXX---%%-XXXXXXXXXXXXXXXX|--XXXXXXXX-oXXXXXXXXXXXXXXXXXXXXXXXXXXXXXXXXXXX
XXXXXXXXXXXXXXXXXXXXXXXXXXXXXXXXXXXXXXXXXX--XXXXXXXXXXXXXXXXXXXXXXXXXXXXXXXXXXXXXXXXXXXXXXXXXXXX----|--||||--||-XXXXXXXXXX---||-XXXXXXXXXXXXXXXX|--XXXXXXXX-XXXXXXXXXXXXXXXXXXXXXXXXXXXXXXXXXX-X
