----------------------------------------------------------------------------------------------------------------------S-------------------------------------------------------------------------
------------------------------------------------------------------------------------------------------------------------------------------------------------------------------------------------
------------------------------------------------------------------------------------------------------------------------------------------------------------------------------------------------
------------------------------------------------SSSSSSSSSSSSSSSS--------------------------------------------------------------------------------------------------------------------------------
-----------------------------------------------------------------------------------------------------------------------------------------------U------------------------------------------------
-----------------------------------------ooo---o-----------------------------------------------------------ooooo----------------Q------------------------------o--------------------------------
--------%%%%%%%%---------------------------------------------o----------------------------o----S--%%%------%%%%--------------------------------------QQ-----------------------------------------
---------||||||-------------------------------oo-------------------------------------------#-------|--------||---------o------------------------------------------------------------------------
---------||||||------------------------------#---------------SS---------------------------SS-------|--------||----------------------------------------------------------------------------------
---------||||||-----------------------------###-------S-SSSSSSS----------------ooo-----------------|-------o||------------SSSSSS----------oo--------------------------------------o-------------
------%%%%%%%%%%-----------##--------2------###---##-------------S##-------------------------------|---%%%%%%%%%-----------S-------------------------#----------------------------t-------------
-------||||||||--------tt--##---TT-----TT--####--###-----------------------------------------------|----|||#|||----------------------------------#---K----------------------------TT----TT----TT
-------||||||||--------tt--##---TT-----TT--####--###-----------------------------------------------|----||###|%%-----------S------TT-------------#-----TT---#---------------------TT----TT----TT
-------||||||||-g------tt-###---TT-----TT--####-####---------g-g----------k-k----------------------|----||##-|||-----------rrro---TT----k--------#-----TT---#-------------o-------TT----TT----TT
XXXXXXXXXXXXXXXXXXXXXXXXXXXXXXXXXXXXXXXXX--XXXX-XXXXXXXXXXXXXXXXXXXXXXXXXXXXXXXXXXXXXXXXXXXXXXXX%%%%XXXXXXXXX|||---X------%%%%%-XXXXXXXXXX---X-XXXXXXXXXXXXXXXXXXXXX--X---XX----XXXXXXXXXXXXX-XX
XXXXXXXXXXXXXXXXXXXXXXXXXXXXXXXXXXXXXXXXXXXXXXX-XXXXXXXXXXXXXXXXXXXXXXXXXXXXXXXXXXXXXXXXXXXXXXXXXXX-XXXXXXXX-|||--XX-------|||o-XXXXXXXXXX---X-XXXXXXXXXXXXXXXXXXXXX--X----X----XXXXXXXXXXXXX-XX
