------------------------------------------------------------------------------------------------------------------------------------------------------------------------------------------------
------------------------------------------------------------------------------------------------------------------------------------------------------------------------------------------------
------------------------------------------------------------------------------------------------------------------------------------------------------------------------------------------------
------------------------------------------------------------------------------------------------------------------------------------------------------------------------------------------------
------------------------------------------------------------------------------------------------------------------------------------------------------------------------------------------------
------------------------------------------------------------------------------------------------------------------------------------------------------------------------------------------------
--------%%%%%%%%--------------------Q------------------------------------------o-----------------------SoS--------------%%%%------------------------QQQQQ--#---o-----------S--------------------
---------||||||---------------------------------------------------------------------------------------------------%%%%%%-||--------------------------------#---------------------#--------------
---------||||||----------------------------------------------------------------------------#-----------------------||||--||------------------o------------##------------------------------------
---------||||||-------------------g-g------------------------------------------------------------------------------||||--||-------------------------------#-----------------------o-------------
------%%%%%%%%%%----------############---------------------------------##----#-----------##------oo--S@QSSS-----%--||||--||------------------U--###-----###--------------------#---------TT-----
-------||||||||-----------------TT-----TT--------TT------TT------------##----#-----------#--------------------o-|--||||--||--------------TT---@-#-##----###------------------###---------TT-----
-------||||||||-----------------TT-----TT--------TT------TT-----------###----#---------####----#----------------|--||||--||--------------TT-----#####-#####------------tt----###--------TT------
-------||||||||-----------------TT-----TT---k#---TT------TT---gog----####--###--------#####----#----------------|--||||--||---ro--kk-----TT---ko#####-#####-----k------tt---###---------TT------
XXXXXXXXXXXXXXXXXXXXXXXXXXXXXXXXXXXX-XXXXXXXXXXXXXXXXXXXXXXXXXXXXXXXXXXXXXXXXXXX--XXXXXXXXX--%%X--%%%S---------X|--||||--|%%%%%%XXXXXXXXXXXXXXXXXXXXXXXXXXX-XXXXXXXXXXXXXXXXXXX-XXXXXXXXXXXXXXXX
XXXXXXXXXXXXXXXXXXXXXXXXXXXXXXXXXXXXXXXXXXXXXXXXXXXXXXXXXXXXXXXXXXXXXXXXXXXXXXXX--XXXXXXXXX--||----|----------XX|--||||X-|-||||-XXXXXXXXXXXXXXXXXXXXXXXXXXX-XXXXXXXXXXXXXXXXXXXXXXXXXXXXXXXXXXXX
