------------------------------------------------------------------------------------------------------------------------------------------------------------------------------------------------
------------------------------------------------------------------------------------------------------------------------------------------------------------------------------------------------
------------------------------------------------------------------------------------------------------------------------------------------------------------------------------------------------
---------------------------------------------------------------------------------------SSSSSSSSS-----------------------------------------------------------------------------------------SSS----
------------------------------------------------------------------------------------------------------------------------------------------------------------------------------------------------
----------------------------------------------------------------------------------------------------------ooooo-----------------------------------oo--------------------------------------------
--------%%%%%%%%---------------------------------------------------------------------------#---------------------------oo------o--------SS---SSS%%%%------%%%------------------o--------------o-
---------||||||----------------------------------------------------------------------------#------------------oo---------------------------------||--------|------------------------------------
---------||||||---------------------------------------------------------------------------#--------------------#---------------------------------||--------|-----------------------------------S
---------||||||-------------------------------------------------------------------o----------------------------#---------------------------------||-------o|--------------------o--------------S
------%%%%%%%%%%----------######-----------------------------------------------SSS-----------------------%%%---#---------------------------SSSSS-||-----%%%%%%---#------------------------------
-------||||||||-----------------------------------------------------------------------k###----------------|----#---------------------------------||------||||----------------------------#------
-------||||||||-----------------------------------------------------------------------####------TT--------|---%%---------------------------------||------||||------------TT------------###------
-------||||||||-------------------g---------------g-------------------k-g-------------####------TT--------|---||---k-k---------g--ok-----------#-||------||||------k--g--TT-----------####------
XXXXXXXXXXXXXXXXXXXXXXXXXXXXXXXXXXXXXXXXXXXXXXXXXXXXXXXXXXXX--%%XXXXXXXXXXXX---XXXXXXXXXXX--XXXXXXXXXXXXXXXX--||XXXXXXXXXXXXXXXXXXXXXXXXXXXXXXXX%%%%%%%%%||||%--XXXXXXXXXXXXXXXXXXXXXXXXXX------
XXXXXXXXXXXXXXXXXXXXXXXXXXXXXXXXXXXXXXXXXXXXXXXXXXXXXXXXXXXX--||XXXXXXXXXXXX--XXXXXXXXXXXX--XXXXXXX--XXXXXXX--||XXXXXXXXXXXXXXXXXXXXXXXXXXXXXXXX-|||||||-|||||--XXXXXXXXXXXXXXXXXXXXXXXXXX------
