------------------------------------------------------------------------------------------------------------------------------------------------------------------------------------------------
------------------------------------------------------------------------------------------------------S-----------------------------------------------------------------------------------------
------------------------------------------------------------------------------------------------------------------------------------------------------------------------------------------------
-------------------------------------------------------------------------SSS--------------------------------------------------------------------------------------------------------------------
------------------------------------------------------------------------------------------------------------------------------------------------------------------------------------------------
------------------o-----------------------------------------------------------------------------------------------------------------------------------------------------------------------------
--------%%%%%%%%--------------------------------------------------oo----------o---r-r---%%-----------SSSQS----@----------------------------------o--------------------------------ooQS-oo-----o-
---------||||||-----------------------------------------------------------------%%%%%%%%||---%%%--------------------------#---------------------------------------------------------------------
---------||||||------------------------------------------------------------------||||||-||----|--------------------------##---------------------------------------------------------------------
---------||||||------------------------------------------------------------------||||||-||----|-----------SSSS----------###------------------------------------------------------o-----o------o-
------%%%%%%%%%%------------------#-----------------------------#--S#----##------||||||-||----|------------------------####------------TT---------------------------------------QQQS---#QS------
-------||||||||---TT-----TT----------------------------------------------##------||||||-||----|---------#--------------####------------TT----TT---------##-----------------------------------K--
-------||||||||---TT-----TT------------------------------TT------------####-----%%|||||-||----|----------------------######------------TT----TT--------###---------------##------------------#--
-------||||||||---TT-----TT-------#----------------------TT-----------#####-----|||||||-||----|-------k-------------#######--k--g------TT----TT-------####---------------##----#-------------#-#
XXXXXXXXXXXXXXXXXXXXXXXXXXXXXX-XXXXXXXXXXXXXXXXXXXXXXXXXXXXXXXXXXXXXXXXXXXXXXXXX||||||XXXXXXX-|-XXXXXXXXXX--XXXXXXXXXXXXXX--XXXXXXXXXXXXXXXXXXXXXXXXXXXXXXXXXXXX-%%%XXXXXXXXX--XXXXXXXXXXXXXXXXX
XXXXXXXXXXXXXXXXXXXXXXXXXXXXXX-XXXXXXXXXXXXXXXXXX-XXXXXXXXXXXXXXXXXXXXXXXXXXXXXX||||||XXXXXXX-|XXXXXXXXXXX--XXXXXXXXXXXXXX--XXXXXXXXXXXXXXXXXXXXXXXXXXXXXXXXXXXX--|XXXXXXXXXX-XXXXXXXXXXXXXXXXXX
