------------------------------------------------------------------------------------------------------------------------------------------------------------------------------------------------
------------------------------------------------------------------------------------------------------------------------------------------------------------------------------------------------
------------------------------------------------#-----------------------------------------------------------------------------------------------------------------------------------------------
------------------------------------------------#-------------------------------------------------------------------------------SSSSSSSSSSSSSS--------------------------------------------------
------------------------------------------------------------------------------------------------------------------------------------------------------------------------------------------------
------------------------------------------------------%%%----------------------------------------------------------------------------------o----------------------oo----------------------------
--------%%%%%%%%--------------------------------o------|----------------oo-----o----QQQQ-------o-rrr-ooSS-----oo--------------------------SSS-----------------------------------SSo--SSS-------S
---------||||||---------------------------------%%-----|-----%%%------------------------------##S%%%%%%----------------------------------------------------#o------------------o----------------
---------||||||---------------------------------||-----|------|#----------------------------####--||||----------------------------------------------------##------------------------------------
---------||||||---------------------------------||-----|---##-##---------------------------#####--||||---------------------------------------------------##-----------------------------------oo
------%%%%%%%%%%----------######-So----%%%%%%---||-----|---##--#------------S---###----TT--#####--||||----------%%--------------#------tt--------------#####-----TT--------------SSSS----------S
-------||||||||-------------------------||||----||-----|---##--------------------------TT--####---||||---#------||---------------------tt--------------#####-----TT--------------------S--------
-------||||||||-------------------------||||----||-----|--###--#---------------------#-TT--####---||||---#------||---------------------tt-------------######-----TT-------------------##--------
-------||||||||-------------------rr----||||----||o----g-###---#---k-----------g-#---#-TT--####---||||--##------||---------------------tt--gy--------#######-----TT------------------k#-#-------
XXXXXXXXXXXXXXXXXXXXXXXXXXXXXXXXX%%%%%%-||||--%%|%%%--%X%XXX---XXXXXXXXXXXXXXXXXXXXXXXXXXXXXXXX---XXXXXXXX-----XX%XXXXXXXXXXXXXXXXXXXXXXXXXXXXXXXXXXXXXXXXXX---XXXXXXXXXXXXXXXXXXXXXXXXXXXX-XXXX
XXXXXXXXXXXXXXXXXXXXXXXXXXXXXXXXXXXX||--||||--|||-|---|XXXXX---XXXXXXXXXXXXXXXXXXXXXXXXXXXXXXXX-X-XXXXXXXX-----XXXXXXXXXXXXXXXXXXXXXXXXXXXXXXXXXXXXXXXXXXXXX---XXXXXXXXXXXXXXXXXXXXXXXXXXXX-XXXX
