-------------------------------------------------------S-S-----------------------------------------------------------------------------------------------------------SSS------------------------
-------------------------------------------------------S---------------------------------------------------------K-----------------------------------------------------S------------------------
-------------------------------------------------------S------------------------------------------------------------------------------------------------------------%S%S------------------------
--------------------------------------------------------------------------------SSSSSSSS--------S------------------------SSS--------------------SSSSSSSSSSSSSSSS----|-|-------------------------
------------------------------------------------------------------------------------------------------------------------------------------------S-------------------|-|-------------------------
--------------------------------------------o-o------------------oo-------------------------------------------------------------------------------------------------|-|-------------------------
--------%%%%%%%%----------------S---QSQSQ-----------------------%%-----------------------------o----------------SS-----------So-------------------------------------|-|-------------------------
---------||||||---------------------------------S---------------||--------------------------------%%%-------------------------------------------------------------o-|-|o------------------------
---------||||||-------------------------------------------------||-------------------------#--SS---|---------------------------S---------------------------------%%%|-|%------------------------
---------||||||---------------------------------S------k--SSSSS-||---------------------------------|---------------------------o-------------------------S--------|-|-||------------------------
------%%%%%%%%%%----------######SSS--SSSSS---U---------##-------||---------------------------------|------------S-SSS----S-----S---------##-----------------------|-|-||---------SSS------------
-------||||||||-----------------------------------##---#--------||-----TT-----TT------------#------|-------#----S-SSS-S--#---------------###----------------------|-|-||------------------------
-------||||||||----------------------------------####-----------||-----TT-----TT-------###-##------|-------#---#--SSS-SS##---------------###---------tt-----------|-|-||------------------------
-------||||||||----------------------------------####------k-g--||g----TT-----TT-----####-###------|-------#--##--SSS-S-#------------ggg###----k-----tt------gg---|-|-||---rr-----g-------------
XXXXXXXXXXXXXXXXXXXXXXXXXXXXXXXXXXXXXXXXXXXXXXXXXXXXX-XXXX-XXXXXXXXXXXXXXXXXXXXXXXXXXXXXXXXXXXXX---|XXXXXXXXXXXXXXXXXXXXXX--XXXXXXXXXXXXXXXXXXXXXXXXXXXXXXXXXXXX--|-|%%%%%%%%%%%XXXXXXXXXXXXXXXX
XXXXXXXXXXXXXXXXXXXXXXXXXXXXXXXXXXXXXXXXXXXXXXXXXXXX--XXX--XXXXXXXXXXXXXXXXXX--XXXXXXXXXXXXXXXXX---|-XXXXXXXXXXXXXXXXXXXXX--XXXXXXXXXXXXXXXXXXXXXXXXXXXXXXXXXXXX--|-|-|||||||||-XXXXXXXXXXXXXXXX
