----------------------------------------------------SSSSSSS-S-----------------------------------------------------------------------------------------------------------------------------------
---------------------------------------------------SSSSSSSSS------------------------------------------------------------------------------------------------------------------------------------
-------------------------------------------------------S----------------------------------------------------------------------------------------------------------------------------------------
-----------------------------------------SSS-----------S--------SSSSSSSS---------------------------------------------------------#--------------------------------------------------------------
-------------------------------------------------------SSS----SS--------------------------------------------------------------------------------------------------------------------------------
-------------------Q----------------------------So-----SS----------------------------------------------------------------------------------------------------------------------o----------------
--------%%%%%%%%---UQQQS-----------------------#------------SS----------------------SSQ-------------------------S--------------------QQoo------o----------------S--SSSS------SSS----------------
---------||||||-------------------------------##------------S------------------------------------o---ooo--------------------------------------------------------S-------------------------------
---------||||||-----------------------------####------------S-----------------------------------------------------------------------------------------------------------------------------------
---------||||||----------ooo-U-------------#####------------So-------------------------g----------------------##-----------------o------------------------oo------------------------------------
------%%%%%%%%%%QQQoSS@@SU-------##------######--SSS--S#oSS----S--------------------SS-S-----U----------------##-SS--------------------------------------S%%SSS-----S------SSSS-----------------
-------||||||||------------------##------######-------------------TT-----------------------------------------###------K-----------------------------------||---o----------------TT--------------
-------||||||||------------------TT-----#######-------------------TT----TT----TT-----------------------------###------------------------------------------||--------------------TT--------------
-------||||||||-------K----------TT--k--#######--------------o----TT----TT----TT---k-g----k-k----------------###--------k----------k-kogk-----------------||------ggggg---------TT----gk----k---
XXXXXXXXXXXXXXXXXXXXXXXXXX--XXXXXXXXXXXXXXXXXXXX--XXX-X---------XXXXXXXXXXXXXXXXXXXXXXXXXXXXXXXXX%XXX-XXX%%X-XXXXXXXXXXXXXXXXXXXXXXXXXXXXXXXXXXX--%%%%%%--||--XXXXXXXXXXXXXXXXXXXXXXXXXXXXXXXXXX
XXXXXXXXXXXXXXXXXXXXXXXXXX--XXXXXXXXXXXXXXXXXXXX--XXX-----------XXXXXXXXXXXXXXXXXXXXXXXXXXXXXXXXXXXX--XXXXXX-XXXXXXXXXXXXXXXXXXXXXXXXXXXXXXXXXXX---||||---||--XXXXXXXXXXXXXXXXXXXXXXXXXXXXXXXXXX
