-------------------------------------------------------------------------------------------------------------------------------------------------------K----------------------------------------
------------------------------------------------------------------S------------------------------------------------------------------------------------o----------------------------------------
------------------------------------------------------------------------------------------------------------------------------------------------------%%----------------------------------------
----------------------------------------------------------------SSSSSSSS------------------------------------------------------------------------------||-------o--------------------------------
------------------------------------------------------------------------------------------------------------------------------------------------------||----------------------------------------
------------------------------------------------------------------------------------------------------------------------------------------------------||--------------------------o-------------
--------%%%%%%%%----------------------S@SS-----o-------SSo----------------------------S-S-----oo----QQQQ--------ooo---S------S--%%--------------------||-------------QQQSSSSSS-S-------Q--------
---------||||||-----------------------------------------------------------------------------------------------------------------||--------------------|o---o------------------------------------
---------||||||------------------------------S------------------------------------------------S---------------------------------%%%%%%%%%-%%%---------%%%-%%%-----------------------------------
---------||||||---------------------------SSSS-----------------------------------------------SS----------------o-----------------|||||||---|-----------|---|---------------------TT----TT-------
------%%%%%%%%%%----------------####--QQQ---SSS---------------------------------#--------#-------#Q----------U-------------------|||||||---|-----------|---|------------S---S@S--TT----TT-------
-------||||||||-----------------####---------------------#----------------------#--------#---------------------------------------|||||||---|-----------|---|---------------------##----TT-------
-------||||||||-----------------####-------------------###---#---------#--------#-###----#----------------------------#----------|||||||---|-----------|---|---------------------##----TT-------
-------||||||||---g-------g-----####--------k---------####---#---------#--------#-###k---#k-------gk------k-k--------##----------|||||||---|-----------|--rr------oy-k-k---------##----TT--kk---
XXXXXXXXXXXXXXXXXXXXXXXXXXXXXXXXXXXXXXXXXXXXXXXXXXXXXXXXXXX-XXXXXXXXXXXXXXXX-SSXXXXXXXXXXXXXXXXXXXXXXXXXXXXXXXXXXXXXXXXXXXXXXXXX-||||X%%-XXX---X------%%%%%%%%--XXXXXXXXXXXXXXXXXXXXXXXXXXXXXXXX
XXXXXXXXXXXXXXXXXXXXXXXXXXXXXXXXXXXXXXXXXXXXXXXXXXXXXXXXXXXXXXXXXXXXXXXXXXXX---XXXXXXXXXXXXXXXXXXXXXXXXXXXXXXXXXXXXXXXXXXXXXXXXX-||||-||-XXX---X-------||||||---XXXXXXXXXXXXXXXXXXXXXXXXXXXXXXXX
