---------------------------------------------------------------------------------------K--------------------------------------------------------------------------------------------------------
---------------------------------------------------------------------------------------o--------------------------------------------------------------------------------------------------------
---------------------------------------------------------------------------------------%%-------------------------------------------------------------------------------------------------------
--------------------------------SSSSS---SSSSSSSS-SSS-SSSSSSSSSSS-----------------------||---------------------------------------------------------------------------------------SSSSSSSS--------
---------------------------------------------------------------------------------------||-------------------------------------------------------------------------------------------------------
---------------------------------------------------------------------------------------||---------o---------------------------------------------------------------------------------------------
--------%%%%%%%%------QQQ------#-----------------------------ooo-----------------------||-----------------------------SSSSS-----------------------o------------------------------------SSS------
---------||||||---------------##-------------------------------------------------------||------------------------------------------------------------------------------------S------------------
---------||||||---------------##------------------------------SS-SSS-------------------||-------------------------------------------------------------------------------------------------------
---------||||||---------------##----------------o--------------------------------------||-------------------------------------------#-----------------------------------------------------------
------%%%%%%%%%%--------------##TT------TT---------------------------------------------||-%%-----#---2------------------------------------------------------SoS---------------------------------
-------||||||||-------------####TT------TT----------------g----------------------------||-||-----#-------------------------------------------#--------------------------TT-----------tt---------
-------||||||||-------------####TT------TT--------------#####------------------#-------||-||-%%%TT------------------------------#------------#--------------------TT----TT-----------tt---------
-------||||||||--------k---#####TT----k-TT----------gg-######-----------------##-------||-||--|-TT---k----#---------------------k------------------------------#--TT----TT-----------tt---------
XXXXXXXXXXXXXXXXXXXXXXXXXXXXXXXXXXXXXXXXXXXXXXXXXXXXXXXXXXXXXXXXXXXXXXXXXXXXXXXX%%%%%-%%%%%%%%%-XXXXXXXXXXXXXXXX--XXXXXXXX--XX%XXXXXXXXXXXXXXXX--%XXXXXXXXXXXXXXXXXXXXXXXXXXXXXXXXXXXXXXXXXXXXXX
XXXXXXXXXXXXXXXXXXXXXXXXXXXXXXXXXXXXXXXXXXXXXXXXXXXXXXXXXXXXXXXXXXXXXXXXXXXXXXXX-|||---|||||||--XXXXXXXXXXXXXXXX--XXXXXXXX---XXXXXXXXXXXXXXXXXX--|XXXXXXXXXXXXXXXXXXXXXXXXXXXXXXXXXXXXXXXXXXXXXX
