------------------------------------------------------------------------------------------------------------------------------------------------------------------------------------------------
-------------------------------------------------------------------K----------------------------------------------------------------------------------------------------------------------------
------------------------------------------------------------------------------------------------------------------------------------------------------------------------------------------------
------------------------------------------------SSSSSSSS-------------SSSSSSSSSSS--------------------------------------SS-------------------------SS------------S--------------------------------
------------------------------------------------------------------S--SSSSSSSSS--------------------------------------------------------------------S---------------------------------------------
------------------------------------------------------------------S--SSSSSSSSSS------------------------------ooo-------------------------------o------------------------------------------------
--------%%%%%%%%-------------SSS---------------o-----------------SSS--------SS------------------------------%%%%-------------------------------------SS----------ooo-----------S-------------ooo
---------||||||----------------------------------------------------------------------------------------------||------------------------------------------------------------------------o--------
---------||||||----------------------------------------------------------------S-----------------------------||----------------------------------------------------------%----------------------
---------||||||----------------------------S-SS-------------------ooooo------ooo---------oooo------------oooo||----------SSS-----oo--------r-----------------------------|----------------SSSSS-
------%%%%%%%%%%-----------S%%%%--o-----------------------------SSSSSSSS-S---SSS---------%%%%---%-------%%%%%||-----------------SS%------%%%%-------S--------------------|----S-SSS------#------
-------||||||||--------------||------------------#-----o#---------------------------------||----|--------|||-|oo---------#--------|-------||-----------K------------tt---|--------------##------
-------||||||||--------------||#-----------------##---------------------------------------||----|--------|||-%%%-------###--------|-------||-----------##-----------tt---|-------------###------
-------||||||||--------------|##---------#-------##---###---------------------------------||---o|--------|||--|--------###--------g-------||----------###-----So----tt---|------------####------
XXXXXXXXXXXXXXXX%%%%XXXXXXXXXXXXXXXXX-XXXX---XXXXXXXXXXXXXXXXXXXXXXXXXX---SSSXXX--XXXXX---||--%-|%%%%%%%%%||--|-XXXXXXXX@X-----XXXXXXXXXXXXXXXXXXXXXXXXXXXXXXXXXXXXXXXXXXXXXXXXX--XXXXXXX----S--
XXXXXXXXXXXXXXXX-||--XXXXXXXXXXXXXXXX-XXXX---XXXXXXXXXXXXXXXXXXXXXXXXXX------XXX--XXXX----||--|-|-|||||||-||--|-XXXXXXXXXX----XXXXXXXXXXXXXXXXXXXXXXXXXXXXXXXXXXXXXXXXXXXXXXXXXX--XXXXXXX-------
