------------------------------------------------------------------------------------------------------S-----------------------------------------------------------------------------------------
------------------------------------------------------------------------------------------------------S-----------------------------------------------------------------------------------------
------------------------------------------------------------------------------------------------------------------------------------------------------------------------------------------------
--------------------------------SSSSSSSSSSS-SSSSSSSSSSSSSSSSSSSS-----------------------------------S----------------------------SSSSSSSSS-------------------------------------------------------
-------------------------------------SS----------------------------------------------------------------------------------------o----------------------------------------------------------------
-----------------------------------------------------------------------------------------------------------------oooo-----------------------------oo---------------------oo---------------------
--------%%%%%%%%---------------------------------SS--SSS-----S---%%--------------------S------------------------------------------------o------o------------------------------------------------
---------||||||-----------------S--------------------------------||-----------%%-------------------------------------------------------------------------------o--------------------------------
---------||||||-----------------S----------SS--------------------||--#--------||----------------------------------------------------------------------------------------------------------------
---------||||||-----------------S----------S-S------o------------||-##--------||-------k----------------------------------ooo-------------------------------------------------------------------
------%%%%%%%%%%----------######S-----------------SSSSS-TT-------||-----------||------S#S------------------------2--------S------------------------------TT-----------------------------##---#--
-------||||||||-----------------o--------------------K--TT-------||-----------||-----------------------------------------------------------------TT------TT------------------TT--------###---#--
-------||||||||-----------------%%----------------------TT----TT-||----TT----#||-------------#-----------------#---------------------------------TT------TT------------------TT-------####--##--
-------||||||||-----------------||---------g-g-g-----kk-TT----TT-||----TT----###-------------#-------k--------##---------------------k------k----TT------TT----k-----kk------TT------#####--##--
XXXXXXXXXXXXXXXXXXXXXXXXXXXXXXXX||-----XXXXXXXXXXXXXXXXXXXXXXXXXX||--XXXXXXXXXXXXXXXXXXXXXXXXXXXX-XXXXXXXXXXXXXXXXXX------XXXXXXXXXXXXXXXXXXXXXXXXXXXXXXXXXXXXXXXXXXXXXXXXXXXXXXXXXXXXXXXX--XXXX
XXXXXXXXXXXXXXXXXXXXXXXXXXXXXXXX||-----XXXXXXXXXXXXXXXXXXXXXXXXXX||--XXXXXXXXXXXXXXXXXXXXXXXXXXXX-XXXXXXXXXXXXXXXXXX------XXXXXXXXXXXXXXXXXXXXXXXXXXXXXXXXXXXXXXXXXXXXXXXXXXXXXXXXXXXXXXXX-XXXXX
