------------------------------------------------------------------------------------------------------------------------------------------------------------------------------------------------
------------------------------------------------------------------------------------------------------------------------------------------------------------------------------------------------
------------------------------------------------------------------------------------------------------------------------------------------------------------------------------------------------
--------------------------------SSSSSSSSSSSSSSSS------------------------------------------------------------------------------------------------SSSSSSSSSSSSSSSS--------------------------------
------------------------------------------------------------------------------------------------------------------------------------------------SSS--SSSS---------------------------------------
---------------------------------------------------------------------------------------------------------oo-------o-----------------------------SSSSSSSS-----SoS--------------------------------
--------%%%%%%%%-----------------------------------------------o----------------------------------------------------------------------SSSS----ooSSSSSSSS----SSSS--------------------------------
---------||||||----------------------------------------------------------------------------------o--------Ky----------------------------------##S-----------------------------------------------
---------||||||-----------------------------SSS-----------------------------------------------------------##------------------------------------S-----------------------------------------------
---------||||||-----------S-------------SSSSSSS-------------------------------------------o#------------TT#-----------------------------------SSSooooooo------oo--------------------------------
------%%%%%%%%%%---------------------------SSS-------------------------------------------##-------TT----TT#--------------------------------------#SSSS-------SSS--------------------------#-----
-------||||||||----------------------------S--------------------------------------------###-------TT----TT#------------------ooo-------------#--TT-----TT---------------------TT----------#-----
-------||||||||-------------------##------------------------------------------TT-------###--------TT---####---TT-----------------------------#--TT-----TT----------------#----TT---------##-----
-------||||||||---k-----------oo#-##-------k-g-----k-k-k-------------g-k------TT------####--------TT--####----TT-------------------k--------####TT----kTT---------g--#--##----TT--g-----###-----
XXXXXXXXXXXXXXXXXXXXXXXXXXXXXX%XXXXXXXXXXXXXXXXXXXXXXXXXXXXXXXXXXXXXXXXXXXXXXXXXXXXXXXXXXX-------XXXX-XXXXXo--XXXXXXXXXXXXX-XXX-XXXXXXXXXXXXXXXXXXXXXXXXXXXXXXXXXXXXXXXXXXXXXXXXXXXXXXXXXXXXXXXX
XXXXXXXXXXXXXXXXXXXXXXXXXXXXXXXXXXXXXXXXXXXXXXXXXXXXXXXXXXXXXXXXXXXXXXXXXXXXXXXXXXXXXXXXXX------XXXXXXXXXXXXX-XXXXXXXXXXXXX-XXX-XXXXXXXXXXXXXXXXXXXXXXXXXXXXXXXXXXXXXXXXXXXXXXXXXXXXXXXXXXXXXXXX
