------------------------------------------------------------------------------------------------------------------------------------------------------------------------------------------------
------------------------------------------------------------------------------------------------------------------------------------------------------------------------------------------------
------------------------------------------------------------------------------------------------------------------------------------------------------------------------------------------------
------------------------------------------------------------------------------------------------SSSSSSSSo---SSSS------------------S---S---S-----------------------------------------------------
----------------------------------------------------------------------------------------------------------------------------------S-------------------------------------------------------------
---------------------------------------------------------------------------------ooo-----ooooooo----------------------------------S----------------------o--------------------------------------
--------%%%%%%%%----------------------USSSSSSSSS--------------------------------------------------------------------QQQQQ-------SSSSSSSSo----SSS------------------------------------------------
---------||||||---------------------------------------------------------------------------------------------r------------------------------------U----------------------------------------------
---------||||||----------------------------------------------------------------------------------------%%%%%%%%---------------------------------------------------------------------------------
---------||||||------------------o-----k-------------------------------------------------ooo------------||||||---------k--------Soooo---------oo-------------------------------------------SS---
------%%%%%%%%%%----------######SSS---SQQS---------------TT--------o---------------------%%%------------||||||--QQQ----US----S--SSSSS--------SSS--TT--------------------------------------------
-------||||||||------------------------------------------TT-------------------------------|-----o-------||||||-------------------@----------------TT----TT----TT--TT----TT----------------------
-------||||||||------------------------------------------TT-------------------------------|-----%%------||||||-------------------U----------------TT----TT----TT--TT----TT----------------------
-------||||||||---------------------------------------k--TT----o--------------------------|-----||------|||g||-----g-------------------k----k-----TT----TT----TT--TT----TT-----#----------------
XXXXXXXXXXXXXXXXXXXXXXXXXXXXXXXXXXXXXXXXXXXXXXXXXXXXXXXXXXXXXXXX-XXXXXX---------XX%XXXXXX%|-----||----XXXXXX%|-XXXXXXXXXXXX-XXXXXXXXXXXXXXXXXXXXXXXXXXXXXXXXXXXXXXXXXXXXXXXXXXXX----------XXXXXX
XXXXXXXXXXXXXXXXXXXXXXXXXXXXXXXXXXXXXXXXXXXXXXXXXXXXXXXXXXXXXXXX-XXXX-X--------XXXXXXXXX-||-----||----XXXXXX||-XXXXXXXXXXXX-XXXXXXXXXXXXXXXXXXXXXXXXXXXXXXXXXXXXXXXXXXXXXXXXXXXX----------XXXXXX
