---------------------------------------------------------------------------------------------------------------------------------------K--------------------------------------------------------
---------------------------------------------------------------------------------------------------------------------------------------o---------SS---------------------------------------------
------------------------------------------------------------------------------------------------------------------------------------------------------------------------------------------------
--------------------------------------------------------------------------------#------------------------------o--------SSSSSSS-----------------SSSSSSSSSSSS-----SSS-SSS--------SSS---SSSSSSSSSS
--------------------------------------------------------------------------------#---------------------------------------------------------------------S-------------------------------S---------
--------------------------------------------------------------------------------#------------------------------------------------------------------------------S-------------------------------S
--------%%%%%%%%---------------o-----SSSS---S----------------------------------------------------------------------------------------------------SSSSSS--SSS--SS-----------#--------------o-----
---------||||||---------------##------------------------------##-----------------o-------------#---------------------------------------------------------------------------#----S---------------
---------||||||--------------###----------------------------#--#-----------#----------------####-------------------------------------------------------------------------###-SSSS-----S---SS----
---------||||||-------------####---------------------------##-#------------#---------------#####-------%-SSSSSSS----------------------%%%%SSSSS--------------------------###----Soo-ooSo---S---S
------%%%%%%%%%%-----------#####-------S-----SSS----------###--------------#-------------####---%------|-----------------TT-----%%-----||--S------SSSS------------------####----------S---------
-------||||||||-----------######--------------------------###--o----------###------------####--#|------|-----------------TT-----||-----||-----------------------------y#####--------------------
-------||||||||-----------######-------------------------####--#--#-----#####----------######--#|------|-----------------TT-----||-oo--||---------------------------########--------------------
-------||||||||-k---gg----######--------------------gg--#####--#--g-----#####-----ggg-#######--#|------|--rrrr-----------TT---ko||-----||-------#------k-------g----########-----------------g--
XXXXXXXXXXXXXXXXXXXXXXXXXXXXXXXXXXXXXXXXXXXXXXXXXXXXXXXXXXXXX-XXXXXXXXXXXXXXXXXXXXXXXXXXXXXXX--X|------|%%%%%%%%XXXXXXXXXXXXXXXX||--%%%%%%%%%%%%XXXXXXXXXXXXXXXXXXXXXXXXXXXXXXXXXXX------XXXXXXX
XXXXXXXXXXXXXXXXXXXXXXXXXXXXXXXXXXXXXXXXXXXXXXXXXXXXXXXXXXXXX-XXXXXXXXXXXXXXXXXXXXXXXXXXXXXXX---|------|-||||||-XXXXXXXXXXXXXXXX||---||||||||||-XXXXXXXXXXXXXXXXXXXXXXXXXXXXXXXXXXX------XXXXXXX
