-------------------------------------------------------K----------------------------------------------------------------------------------------------------------------------------------------
-------------------------------------------------------o----------------------------------------------------------------------------------------------------------------------------------------
-------------------------------------------------------%----------------------------------------------------------------------------------------------------------------------------------------
------------------------------------------------S------|----------------------------------SS---------------------------------------------------------------------SS--SSSSSSS--------------------
-------------------------------------------------------|----------------------------------------------------------------------------------------------------------------------------------------
------------------------------------------------------%%%%%%-------------------------------------oo---------------------oo----------------------------------------------------------------------
--------%%%%%%%%-------------------QQQQQQS---SSSooo----||||------%%-------------SSoo-SS------S---%%------------------------------------------------------------o----oSSo-----------------------o
---------||||||----------------#------------------%%---||||--%%%-||------------#-----------------||----------------------------o---------------------------------------------------------------#
---------||||||-----------------------------------||---||||---|--||----------------------------S-||----------------------------------------------------------SS-----------------------------####
---------||||||------------------g---g-g----------||---||||---|--||-----------------g--------ooS-||----------------------------------------o-----------------------------------------------#####
------%%%%%%%%%%----------------##Q#Q#SQQ----U----||---||||---|--||----tt----------SSSS-------SS-||----TT---------------------------------------SSS----------SS----SS---------------------######
-------||||||||----------------o----------------o-||---||||---|#-||----tt-------S---S-K----------||----TT--------------------------------------------------------------------------------#######
-------||||||||----------------#---K------------%%||---||||---|#-||----tt------------------------||----TT---------o----------------------------------------------------------------------#######
-------||||||||----rr----------#---U------k-----%%%|---||||---|##||----tt----------k--k---k-----g|gggg-TT--gy--#-------------------------------------------k-----#-k--gg----------------########
XXXXXXXXXXXXXXXX-%%%%%%%%%%%---XXXXXXXXXXXXXXXXX-|-|--%XXXXX--|-X|%-XXXXXXXXX---XXXXXXXXXXX-XXXXXXXXXXXXXXXXXXXX-%%%---X-XXX---X-XXXX-K---------XXXXXXXXXXXXXXXXXXXXXXXXXXXXXXXXXXXXXXXXXXXXXXXX
XXXXXXXXXXXXXXXX--|||||||X|----XXXXXXXXXXXXXXXXX-|-|--|XXXXX--|-XXX-XXXXXXXXX---XXXXXXXXXXX-XXXXXXXXXXXXXXXXXXXX--|----X-XXX---X-XXXX-X---------XXXXXXXXXXXXXXXXXXXXXXXXXXXXXXXXXXXXXXXXXXXXXXX-
