---------------------------------------------------------------------------------------K---------------K---------------------------------------------------------------K------------------------
---------------------------------------------------------------------------------------o---------------o---------------------------------------------------------------o------------------------
------------------------------------------------------------------------------------------------------%%%-------------------------------------------------------------%%%-----------------------
--------------------------------------------------------------------------------#----------------------|---------------------------------------------------------------|------------------------
---------------------------------------------------------------o---------------------------------------|---------------------------------------------------------------|------------------------
---------------------------------------------------------------%---------------------------------------|---------------------------------------------------------------|------------------------
--------%%%%%%%%----------------SSSSSSSS--SSSSSS--------2o-----o-------SS-SSSS-------------------------|----------------------------------o-------SS---S------------r--%%%--------o-------------
---------||||||------------------------------------------------|-------------------------------o-------o---o-------------------------------r----------------------%%%%%%|----%%%----------------
---------||||||------------------------------------------------|--------------------------------%%----%%%-%%%-----------------------------S%-----------------------||||-|-----|-----------------
---------||||||-----------------Sooo---------------------------|--------------------------------||-----|---|--------------------o----------|-----------------------||||-|-----|-----------------
------%%%%%%%%%%----------######SSSS---------SSS---------------|-SS--SS@SSSSS@S----------%%-----||-----|---|-----------#-------------------|----------S@#------S---||||-|-----|-SSS-------------
-------||||||||------------------------------------------------|-------------------------||----o||-----|---|-----------#-------------------|-----------##----------||||-|-----|-----------------
-------||||||||------------------------------------------------|-------------------------||--%%%||-----|---|-%%%-------------#-------------|----------###----------||||-|--#-%%%----------------
-------||||||||------------------------kk---------o------------#-------------------------||---|-||-----|---|--|-----gg------##-------------|----------###---------o||||-|-----|-----------------
XXXXXXXXXXXXXXXXXXXXXXXXXXXXXXXXXXXXXXXXXXXXXXXX-%%%---XXXXXXXXX--%%%%%--------X-%%%---XXX|---|-||----%%%%%%%%%%XXXXXXXXXXXXXXXXXXXXXXXXXXXXXXXXXXXXXXXXX----XXX-%%%||%XXXXX--|--XXXX-X-XXXXXXXX
XXXXXXXXXXXXXXXXXXXXXXXXXXXXXXXXXXXXXXXXXXXXXXXX--|----XXXXXXXXX---|||--------XX--|----X-X|---|-||-----||||||||-XXXXXXXXXXXXXXXXXXXXXXXXXXXXXXXXXXXXXXXXX----XXX--|-|||XXXXX--|-XXXXX-X-XXXXXXXX
