-------------------------------------------------------------------------------------------------------------------------------------------------------K-------------------------------K--------
-------------------------------------------------------------------------------------------------------------------------------------------------------o-------------------------------o--------
------------------------------------------------------------------------------------------------------------------------------------------------------%%%-----------------------------%%%-------
------------------------------------------------SSSSSSSSSSSSSSSS---------------------------------------------------------------------------------------|-------------------------------|--------
------------------------------------------------SS---S----------------------------------------------------------------------------o--------------------|-------------------------------|-------o
------------------------------------------------S--------------S----------oo---------------------------------------------------------------------------|-------%-----------------------|-------%
--------%%%%%%%%-------------------------------------------S-SSS-------------------------------o-----------%%%----------o-------SSSS-----------o%%-----|-------|--------oo-----o%------|-------|
---------||||||---------------------------------------------------------------------------------%%%---------|---S-------------------------------||-----|-------|----------------|------|-------|
---------||||||-------------------------------------------------------------------------------##-|----------|------------------------------S-S--||-----|-------|-------------oo-|-----o|-------|
---------||||||-------------------------------------------------------------------------------##-|----------|SS----------------------------ooooo||-----|-ooo---|----------------|---%%%%---o---|
------%%%%%%%%%%----------######--------------------------------##--##o-----------------------##-|----------|-------------------SS-----------S--||-----|%%%%---|------------SSS-%%---||---%%---|
-------||||||||-------------------------------K---------------------------------------------####-|----------|----------K------------------------||-----|-||----|----------------||---||---||---o
-------||||||||------------------------------------------##--------------------------------#####-|----------SS----------------------------------||-----|-||-%%%%----------------||o--||---||%%%%
-------||||||||-------------------kk----------k----------##-------------------kg-----k----######-|---------r-----##----k------------------------||-----|-||--||-----------------%%%%-||---||-||-
XXXXXXXXXXXXXXXXXXXXXXXXXXXXXXXXXXXXXXXXXXXXXXXXXXXXXXXXXXXXXXXXXXXXXXXXXXXXXXXX---XXXXXXXXXXXXX-|----%%%%%%%%--XXXXXXXXXXXXXXXX--XX--------XXX-||---%%%%||--||----------XXXXXXX-||--|%%%-||-%%%
XXXXXXXXXXXXXXXXXXXXXXXXXXXXXXXXXXXXXXXXXXXXXXXXXXXXXXXXXXXXXXXXXXXXXXXXXXXXXXXX---XXXXXXXXXXXXX-|-----||||||---XXXXXXXXXXXXXXXX--XX--------XXX-||----||-||--||---------XXXXXXXX-||--|-|--||--|-
