------------------------------------------------------------------------------------------------------------------------------------------------------------------------------------------------
---------------------------------------------------------------------------------------------------------------------------------SS-------------------------------------------------------------
------------------------------------------------------------------------------------------------------------------------------------------------------------------------------------------------
---------------------------------SSSSSSSSSSSSSSSSSSSSSSSSSSSSSSS--------------------------------SSSSSSSSSSSSSSSS----------------SSS--ooSSSSSSSSS--------------------------------------SSSSSS----
------------------------------------------------------------------------------------------------------------------------------------------------------------------------------------------------
------------------------------%S----------------------------------------------------------------------------------------------------------------------------------------------------------------
--------%%%%%%%%--------------|--oo---------------------o-----SS----@S@SSS---U---------Q------o---------------------QQQQQSS--S@S--------oo--oo------QQQQQ----------------------------------#----
---------||||||---------------|-----------------SS---------------------------------------------------------------------------------------------------------------------------S------------##----
---------||||||---------------|------------S----------------------------------o--------------SS---------------------------------------S----SSSSS------------------------------------------##----
---------||||||----------oooo-|------------#------------------------------------------------oSS------------#--------------------------So---SoSoS-------g---------------------------------###----
------%%%%%%%%%%--------%%%%%-|-S----------#-------S#SS---------Q----QQQ-----SSSQQQ----------------------####---------QQQ----o-------SS-----SSSS###--#@#Q----U--------------------------####----
-------||||||||----------|||-oo-----tt-----#----TT------------------------------------------------------#####------#----------------------------###-----------------------------------y#####----
-------||||||||----------|||%%%%----tt---#-#----TT----------------------------------------------------#######------#----------------------------###-----------------------------------######----
-------||||||||----rr----|||-||-----tt--####----TT-----k-----g-g---k--------------gk--------k-------#########--#---#----------------------------###k--o-----------------#------------#######----
XXXXXXXXXXXXXXXX-%%%%%%%%%%|-||--XXXXXXXXXXX---XXX--XXXXXXXXXXXXXXXXXXXXXXXXXXXXXXXXXXXXXXXXXXXXXXXXXXXXXXXXXXXXXXXXXXXXXXX-XXXXXXX--------XXXXXXXXXXXXXXXXXXXXXXXXXXXXXXXXXXXXXXXXXXXXXXXX--XXX
XXXXXXXXXXXXXXXX--||||||||-|-||-XXXXXXXXXXX----XXXXXXXXXXXXXXXXXXXXXXXXXXXXXXXXXXXXXXXXXXXXXXXXXXXXXXXXXXXXXXXXXXXXXXXXXXXX-XXXXXXX--------XXXXXXXXXXXXXXXXXXXXXXXXXXXXXXXXXXXXXXXXXXXXXXX---X-X
