------------------------------------------------------------------------------------------------------------------------------------------------------------------------------------------------
-----------------------------------------------------------------------------------------------------------------K------------------------------------------------------------------------------
------------------------------------------------------------------------------------------------------------------------------------------------------------------------------------------------
------------------------------------------------SSSSSSS-----------------------------------------------------------------------------------------#-----------------------------------------------
-----------------------------------------------------------------------------------------------------------------------------------------------------------------------------------------------U
----------------------------------------------------------------------------------------------------------------------------------------------------------------o---------------Q-ooo-----------
--------%%%%%%%%-----------------------QQ---------------------------QQQQ-----S------------------SSSSSSS------------------------------SQo--------------------------------------------------------
---------||||||-----------------S--------------------------------------------S-------------#----------------------------------------------------------------------------------------------------
---------||||||--------------------------------------------------------------U-------------#---------------------------------------------------------------%%-----------------------------------
---------||||||------------------------g----SSS----------------o---------------------------------------------------------------o---------------o-----------#|------------ooo-----@--------o-----
------%%%%%%%%%%----------######--##--S#Q-------TT---S----------##QQ--------------TT------------S-------------S----------TT-------SS---##------S----------##|----USo-----%%%--------------------
-------||||||||-------------------##------------TT--------------------------------TT--kS#-----------------------TTTT-----TT-----------###----------------###|-------------|---------------------
-------||||||||-----------------####------------TT--------------------------------TT---###----------------------TTTT-----TT---------#####---------------####|-------------|---------------------
-------||||||||-----------------####---------###TT-----k---gy------k-kk----kk-----TT--####----------gg----------TTTT--kk-TT---------####k--------------#####|-------------|--------k------------
XXXXXXXXXXXXXXXXXXXXXXXXXXXXXXXXXXXXXXXXXXXXXXXXXXXXXXXXXXXXXXXXXXXXXXXXXXXXXXXXXXXXXXXXXXXXXXXXXXXXXXXXXXXXXXXXXXXXXXXXXXX---XXXXXXXXXXXX-XXXXXXXXXXXXXXXXXX-XXXXXXXXXXXXX---XXXXXXXXXXXXXXXXXX
XXXXXXXXXXXXXXXXXXXXXXXXXXXXXXXXXXXXXXXXXXXXXXXXXXXXXXXXXXXXXXXXXXXXXXXXXXXXXXXXXXXXXXXXXXXXXXXXXXXXXXXXXXXXXXXXXXXXXXXXXXXXXXXXXXXXXXXXXX-XXXXXXXXXXXXXXXXXX-XXXXXXXXXXXXX---XXXXXXXXXXXXX-XXXX
