---------------------------------------------------------------------------------------K--------------------------------------------------------------------------------------------------------
---------------------------------------------------------------------------------------o--------------------------------------------------------------------------------------------------------
--------------------------------------------------------------------------------------%%%-------------------------------------------------------------------------------------------------------
---------------------------------------------------------------------------------------|----------------------------------SS-SSS---------------------------------------S-SSS--------------------
---------------------------------------------------------------------------------------|-------------------------------------------------------o------------------------------------------------
---------------------------------------------------------------------------------------|-------%------------------------------------------------------------------------------------------------
--------%%%%%%%%--------------------------------------SS------------QQ-oo------U-r-----|-------|------------------o----------S------QQQQ-------------------------SoS-SS-------o-----------------
---------||||||-------------------------------%o--------------------------------%%%%---|---o-%%%---------------------------------------------------------------------------------------o--------
---------||||||-------------------------------|----------------------------------||----|--%%%-|----------------------------------------------------------------------------#--------------------
---------||||||-------------------------------|----------------------------------||----|---|--|-------------------------------------------------------------------o-----------oo----------------
------%%%%%%%%%%----------######--------------|---------S%%%SoSSS#####-------U---||----|---|--|----------------------------------#-----------US----------TT-----SSSSS---##-----S----------------
-------||||||||-------------------------------|-----------|----------------------||----|---|--|----------TT----------------------------------------------TT------------###----------------------
-------||||||||-------------------------------|-----------|------#---------------||----|---|%%%%---------TT----------------------------------------------TT-----------####----------------------
-------||||||||------------------------k------|---ggg-----|----#-#-k-------------||----|---|-||------k---TT---g--------------------k-kgg--k-k------------TT---oo-----#####----------g-----------
XXXXXXXXXXXXXXXXXXXXXXXXXXXXXXXX-----XXXXXXXXX%XXXXXXXXXXXXXXXXXXXXXXXXXXXXXXXXX-||---%%%--|-||-XXXXXXXXXXXXXXXX--XXXXXXXX-----XXXXXXXXXXXXXXXXXXXXXXXX--XX--XXXXXXXXXXXXX--XXXXXXXXXXXXXXXXXXXX
XXXXXXXXXXXXXXXXXXXXXXXXXXXXXXXX-----XXXXXXX--|XXXXXXXXXXXXXXXXXXXXXXXXXXXXXXXXX-||----|---|-||-XXXXXXXXXXXXXXXX--XXXXXX-X----XXXXXXXXXXXXXXXXXXXXXXXXX--X---X--XXXXXXXXXX--XXXXXXXXXXXXXXXXXXXX
