------------------------------------------------------------------------------------------------------------------------------------------------------------------------------------------------
------------------------------------------------------------------------------------------------------------------------------------------------------------------------------------------------
------------------------------------------------------------------------------------------------------------------------------------------------------------------------------------------------
------------------------------------------------------------------------------------------------SSSSSSSS----------SSSSSSSSSSSS-S-----------------------SSSSSS--S--------------------------------
------------------------------------------------------------------------------------------------------------------------------------------------------------------------------------------------
-----------------oo-------oo--------------------------------------------------------------------------------------------------------------------------------------------------------------------
--------%%%%%%%%%%%--------------------UQ-------%%%%------%%%%----------------------------------------------------------------------------------------------------------------------------------
---------|||||||||------------oo-----------------||--------||-------------------------------------------------------------------S----ooo---o----------------------------------------------------
---------|||||||||--------------------TT---------||--------||-------------------------------------------------------------------S----------%----------------------------------------------------
---------|||||||||--------------------TT----SSS--||------o-||-----------------------------------------------------o------------------------|--------g-----S-------------------------------------
------%%%%%%%%%%||-------%%%----------##o---oS---||-----%%%%%------------TT--------------TT-----------------------S-------------%%%--------|------SSS-S-------------------------SSS---S2--------
-------||||||||-||--------|--o-------------------||------|||-------------TT--------------TT-------TT-----TT---TT-------TT--------|---------|------SS-----g---------------------o----------------
-------||||||||-||--------|--%%%-------------K---||------|||%%%%---------TT--------------TT----g--TT-----TT---TT-------TT--------|---------|------SS-----#--------------------------------------
-------||||||||-||--------|---|----k---------U---||------|||-||----k-----TT--------------TT---###-TT--kk-TT---TT--g----TT----g---|---------|----------SS##-----#--------------------------------
XXXXXXXXXXXXXXXX|%%%----%%%---|-XXXX------XXXXXX-%%%%%%%%%%%%%%-XXXXXXXXXXXXXXXXXXXXXXXXXXXXXXXXXXXXXXXXXXXXXXXXXXXXXXXXXXXXXXXX-|XXXXXXXXXXoX-X-XXXX-X-XXX-XXXX-%%%%%%%%-------XXXX--XXXXXXXXXX
XXXXXXXXXXXXXXXX|-|------|----|-XXXX------XXXXXX--||||||||||||--XXXXXXXXXXXXXXXXX-XXXXXXXXXXXXXXXXXXXXXXXXXXXXXXXXXXXXXXXXXXXXXX-|XXXXXXXX-X-XXXXXXXXXXXXXX-XXXX--||||||--------XXXX--X-X-XXXXXX
