------------------------------------------------------------------------------------------------------------------------------------------------------------------------------------------------
------------------------------------------------------------------------------------------------------------------------------------------------------------------------------------------------
------------------------------------------------------------------------------------------------------------------------------------------------------------------------------------------------
--------------------SSS-------------------------S-SSSSS-----------------------------------------------------------------------------------------------------------------------------------------
----------------------------------------------------------------------------------------%%------------------------------------------------------------------------------------------------------
----------------------------------------------------------------------------------------||--------------------------------------------------------o--------------------------o------------------
--------%%%%%%%%------------S--------------------SSSSSS---------------------------------||----------------------------------------------o-------%%%%-------------SSSSSS------S------------------
---------||||||-------------SS-----------------o---------------------------o------------||rrrr-----------------SS--------------#S----------------||------------#--------------------------------
---------||||||-------------S------------------------------------------------------%%%%%%%%%%%%--------------------------------------------------||-----------##--------------------------------
---------||||||----------------------------------------------------------------o----||||||||||------%%-----------o-------------------------------||-----------##-------------ooo---------------o
------%%%%%%%%%%---------#-------###-#----------------------------------------------||||||||||------||----------SSS------------------------------||--2------####----S--------SSS----------------
-------||||||||----------#----TT-###------#-------------TT--------TT----------------||||||||||------||-----------------------------------TT------||---------####--------------------------------
-------||||||||----------#----TT-TT------##-------------TT----TT--TT----------------||||||||||------||-----------------##----------------TT-----oo|--------#####--------------------------------
-------||||||||-------#--#----###TT-----###-#-------ggg-TT----TT--TT----g-----------||||||||||ro#---||-k---------------##----------------TT------||-------######----------k--------------#------
XXXXXXXXXXXXXXXX-XXXXXXXXXXX---XXXXXXXXXXXXXXXXXXXXXXXXXXXXXXXXXXXXXXXXXXX---XXX----|XXX||||%%%%XXX-XXXXXXXXXXXXXoXXXXXXXXXX---XXXXXXXXXXXXXXXXXX||--X-XXXXXXXXXXXXXXXXXX-XXXXXXXXXXXXXX-X-----X
XXXXXXXXXXXXXXXXXXXXXXXXXXX----XXXXXXXXXXXXXXXXXXXXXXXXXXXXXXXXXXXXXXXXXXX---XXX----|-XX||||-||-XXX--XXXXXXXXXXXXXXXXXXXXXXX-XXX-XXXXXXXXXXXXXXXX||--X-XXXXXXXXXXXXXXXXXX-XXXXXXXXXXXXXX-X-X---X
