------------------------------------------------------------------------------------------------------------------------------------------------------------------------------------------------
------------------------------------------------------------------------------------------------------------------------------------------------------------------------------------------------
------------------------------------------------------------------------------------------------------------------------------------------------------------------------------------------------
------------------------------------------------------------------------------------------------------------------------------------------------------------------------------------------------
------------------------------------------------------------------------------------------------------------------------------------------------------------------------------------------------
----------------#-------------------------------------------------------------------------------------------------------------------------------------------------------------------------------
--------%%%%%%%%#--------------------SSSSS---------------------------------------%%%------------------SSSS--------o-----o------o------------------------------o------SSSSS----------------------
---------||||||---------------------------------------------------o---------------|--------------------------------------------#-----------o----------------------------------------------------
---------||||||-------------------------------------------------%%%%--------------|----------------------------------------#-#------------%%%-------------#-------------------------------------
---------||||||--------------------------------------------------||---------------|----------------------------------------#---------------|-------------##S-------------------------------S----
------%%%%%%%%%%---------%%%%%So--QQ----------------------%SS@S--||---------------|------TT------------------------------###-#-------------|------------###-----QS----SS-----U---SQ-------------
-------||||||||-----------|||-----------------------------|------||---------------|------TT------------------------------###-#-#-----------|-----------####----------------------------##-------
-------||||||||-----------|||-----------------------------|------||---------------|------TT-----------------------------####-###--------##-|----------#####---------------------------###-------
-------||||||||-----------|||---------------------ggggg---|------||-------------%%|------TT----#---k----------------k--#####-###-------###-|---------######--------k------------------###-------
XXXXXXXXXXXXXXXX%%%%%%%%XXXXXXXXXXXXXXXXXXX--XXXXXXXXXXXXXXXXXXX-|XXX%%%---%%%%%XX|-XXXXXXXXXXXXXXXXXXXXXXXXXXXXXXXXXXXXXXX-XXXXXXXXXXXXXXXXXXXX-XXXXXXXXXX----XXXXXXXXXXXXXXXXXXXXXXXXXXX--XXXX
XXXXXXXXXXXXXXXXX||||||-XXXXXXXXXXXXXXXXXXX--XXXXXXXXXXXXXXXXXXX-|XX--|-----|||-X-|-XXXXXXXXXXXXXXXXXXXXXXXXXXXXXXXXXXXXXXX-XXXXXXXXXXXXXXXXXXXXXXXXXSXXXX----XXXXXXXXXXXXXXXXXXXXXXXXXXXX--XXXX
