------------------------------------------------------------------------------------------------------------------------------------------------------------------------------------------------
-------------------------------------------------------------------------------------------------------------------------------------------------K----------------------------------------------
------------------------------------------------------------------------------------------------------------------------------------------------------------------------------------------------
--------------------------------SSSSSSSSSSSSSSSS----------------SSSSSSSSSo-----S----------------SSSSSSSSSSSSSSSS--------------------------SS--------------------------------------oooooooooo-SSS
--------------------------------SSS-SSSS---------------------------------------------------------------------------------------------------------------------------------------------%%%%-------
--------------------------------SSS----------SSS--------------------------------------------------------------------------------------------------------------------------------------||--------
--------%%%%%%%%------------------SSS--------SS---------------------------------------oo----------------------------------------------------------------------------------------------||--o-----
---------||||||----------------------------------#---------o---------------------#-----------------------------------------ooo--------------------------------------------------------rr--rr----
---------||||||--------------------------------S#----------%%--------------#------------------------------------------------------------------S------------------------------ooo---S%%%%%%%%----
---------||||||-----------------ooooooo-------oo-----------#|--------------#----------------------------------------------oo-------------------o-------------------------------------||||||-----
------%%%%%%%%%%----------######SSSSSSSS------SS-----------#|--------------#---------------------TT---------------------#%%%-------------#-----S--SS-------------S---SU------SS------||||||-----
-------||||||||--------------------------SS--------------###|-------o----#-#---------------------TT-----TT-------------##-|-------------##-------------------------------------------||||||-----
-------||||||||------------------------------------------##-|------%%%-#####------#--------------TT-----TT------------####|-----------####-------------------------------------------||||||-----
-------||||||||------------------------------------------##-|-------|--#####-----##k----#-k------TT-----TT---#-------####-|-----------####-----------kk--k--k------k-------kkkk------||||||-----
XXXXXXXXXXXXXXXXXXXXXXXXXXXXXXXXXXXXXXXXXXXXXXXXXXXXXXXXXXXX|--X-XX-XXXXXXXX---XXXXXXXXXXXXXXXXXXXXXXXXXXXXXXXXX-oXXXXXXX-|-----XXXXXXXXXX--XXXXXXXXXXXXXXXXXXXXXXXXXXXXXXXXXXXX--XXX||||%%%%%--
XXXXXXXXXXXXXXXXXXXXXXXXXXXXXXXXXXXXXXXXXXXXXXXXXXX-XXXXXXXX|--XXXX-XXXXXXXX--XXXXXXXXXXXXXXXXXXXXXXXXXXXXXXXXXX--XXXXXXX-|-----XXXXXXXXXX--XXXXXXXXXXXXXXXXXXXXXXXXXXXXXXXXXXXX--XXX||||-|||---
