------------------------------------------------------------------------------------------------------------------------------------------------------------------------------------------------
------------------------------------------------------------------------------------------------------------------------------------------S-----------------------------------------------------
------------------------------------------------------------------------------------------------------------------------------------------S---So------------------------------------------------
--------------------------------------------------------------------------------SS---SS-----------------------------------------SSSSSSSS--S---SS------------------------------------------------
--------------------------------------------------------------------------------------------------------------------------------SSS-SS----SS--SS------------------------------------------------
----------------------------------o---------------------------------------------------------------------------------------------SSSSSSSS--SoSSSS------------------------------------------------
--------%%%%%%%%-----------#---------------------------------oo-----------------------------------------------------------------SSSSSSSS--SSSSSS------------------------------------------------
---------||||||-----------##-------------------------------------------------------------------------------------o-------------------------------------------------------------------------o----
---------||||||----------####-SS------------------------------S---------------------------------------------------------------------------------------------------------------------%%%---------
---------||||||----------####-----------------------------SS-SS-------------------------------------------------------------------ooooo-------oo----------oo---o---------------------|----------
------%%%%%%%%%%--------####------#----------------------#-------------------------------------------2------------TT--------------SSSSS------SSS-------------------------#-----------|----------
-------||||||||-------y#####------#---------------------##-------------TT-------------------------------TT--------TT----TT------TT---SS-TT------------------------------##-----------|----------
-------||||||||------#######----TT#----------K---------###-------------TT--------TT-------------TT------TT--------TT----TT------TT------TT-----------------------------###-----------|----------
-------||||||||-----########----TT#----------#---------###-------------TT---#----TT-------------TT------TT---ggg--TT----TT------TT----k-TT----------------------------####-----------|----------
XXXXXXXXXXXXXXXXXXXXXXXXXXXXXXXXXXX---XXXXXXXXXX-oXXXXXXXX------XXXXXXXXXXXXXXXXXXXXXXXXXXXXXXXXXXXXXXXXXXXXXXXXXXXXXXXXXXXXXXXXXXXXXXXXXXXXXXXXXXXXXXXXX-------XXXXXXXXXX--XXXXXXXXXXXXXX---%%%
XXXXXXXXXXXXXXXXXXXXXXXXXXXXXXXXXXX--XXXXXXXXXXXXXXXXXXXXX------XXXXXXXXXXXXXXXXXXXXXXXXXXXXXXXXXXXXXXXXXXXXXXXXXXXXXXXXXXXXXXXXXXXXXXXXXXXXXXXXXXXXXXXXX-------XXXXXXXXXX--XXXXXXXXXXXXXX----|-
