------------------------------------------------------------------------------------------------------------------------------------------------------------------------------------------------
------------------------------------------------------------------------------------------------------------------------------------------------------------------------------------------------
------------------------------------------------------------------------------------------------------------------------------------------------------------------------------------------------
--------------------------------SSSSSSSSSSSSSSSS##------------------------------#-------------------------------------------------------------------------------SSSSSSSSS-SSSSSS-S--------------
--------------------------------S---------------------------------------------------------------------------------------------------------------------------------------------------------------
--------------------------------------------oSSS-----------------oo------------------------------------------------------------o----------------------------------------------------------------
--------%%%%%%%%-----------------SSSSSSSSSSSSSSS----------------%%%-------------------------------------------------QQQQQ--------------QQS------------------------------------------------------
---------||||||-----------------------------------------------##-|----------------%%%---------##------------------------------------------------------------------------------------------------
---------||||||--------------------------------------------#####-|-----------------|-------#####----------------------------------------------------------------S---#---------------------------
---------||||||-------------------------------oo-----------#####-|-----------------|------####-------------------------g---------------g----------------------------#---------------------------
------%%%%%%%%%%----------######S------------SSS----------######-|-----tt----------|-----#####-------------------#---S@SSS---USS####--##----S----------------#----------------------------------
-------||||||||-------------------------------------------######-|-----tt----------|----######-------------------#----------------##-------------------------##---------------------------------
-------||||||||-------------------------------------------######-|-----tt----TT----|---#######-----------TT------#----------------#--------------------tt---###---------------------------------
-------||||||||----------------------k----#--------------#######-|k----tt----TT-k--|--########-----------TT------#-k------k-------#k-------------------tt--####-#------k-----ggg--------------o-
XXXXXXXXXXXXXXXXXXXXXXXXXXXXXXXXXXXXXXXXXXXXXXXXX%%XXXXXXXXXXXXXXXXXXXXXXXXXXXXXXXXXXXXXXXXXX---------XX-XXX---XXXXXXXXXXXXXXXXXXXXX----XXXXXXXXXXXXXXXXXXXXXXXXXXXXXXXXXXXXXXXX-----%%---XXXXXX
XXXXXXXXXXXXXXXXXXXXXXXXXXXXXXXXXXXXXXXXXXXXXXXXXXXXXXXXXXXXX-XXXXXXXXXXXXXXXXXXXXXXXXXXXXXXX----------X-XXX---XXXXXXXXXXXXXXXXXXXXX----XXXXXXXXXXXXXXXXXXXXXXXXXXXXXXXXXXXXXXXX-----||---XX-X-X
