-------------------------------------------------------------------------------------%------------------------------------------------------------------------------------------
-------------------------------------------------------------------------------------|------------------------------------------------------------------------------------------
-------------------------------------------------------------------------------------|--------------------------------------------------------Q---------------------------------
---------------------------------------------------SSSSSSS-SSSSS---------------------|----------------------------------------------------------SSSSSSSSSSSSSSSS----------------
-------------------------------------------------------------------------------------|------------------------------------------------------------------------------------------
-------------------------------------------------------oo---SSS----------------------|------------------------------------------------------------------------------------------
--------%%%%%%%%-----SSSoooo--2%---------------------SSS----SSS----------------------|r---------------------------SSS-----------------------------------------------------------
---------||||||----------------|----------------------------------o-------------S---%%%%%%----------------------------------------------o-----U----------------------o----------
---------||||||-----------S-y--|--------------------------------------#--------------||||-------------------------------------------%%%%%%------%-----#-------------------------
---------||||||-------------@--|-------------#------------------------#--------------||||-------------SSSS----o----------------------||||-------|-----#-------------------------
------%%%%%%%%%%---------------|-------S----##-#S---------------------#--------------||||-----------%%%%%S----%%---------------------||||-------|-----#-------SS----------------
-------||||||||----------------|-----------###-#---------TT-----------#--------------||||------------|||------||---------#-----y-----||||-------|-----##--------TT--------------
-------||||||||----------------|----------####-#---------TT---------#-#-------------T||||------------|||------||---------#-----#-----||||-------|-##--###-------TT--------------
-------||||||||--------k-------|---------#####-#---------TT-----#---#-#-------------T||||------------|||--gg--||------g--#-----#-----||||--y----|-##--###----k--TT----g---------
XXXXXXXXXXXXXXXXXXXXXXXXXXXXXXXXXXXXXXXXXXXXXXXXXXXXXXXXXXXXXXXXXX--XXX-----%%--XXXXXXXXXXXXXXXXXX---|||--XX--||XXXXXXXXXXXXXXXX-----%%||--2XXX-XXXXXXXXX--XXXXXXXXXXXXXXXXXXXXX
XXXXXXXXXXXXXXXXXXXXXXXXXXXXXXXXXXXXXXXXXXXXXXXXXXXXXXXXXXXXXXXXXX--XXX-----||--XXXXXXXXXXXXXXXXXX---|||--XX--||XXXXXXXXXXXXXXXX-----||||-XXXXX-XXXXXXXXX--XXXXXXXXXXXXXXXXXXXXX
