-----------------------------------------------------------------------------------------------------------------------------------------------------------------------------------------SS-----
-----------------------------------------------------------------------------------------------------------------------------------------------------------------------------------------SS-----
------------------------------------------------------------------------------------------------------------------------------------------------------------------------------------------------
--------------------------------SSSSSSSS--SSSSSSSSSSSSSSSSSSSS---------------------------------------------S---S--------------------------------------------------------------------------------
------------------------------------------------------------------------------------------------------------------------------------------------------------------------------------------------
-----------------------------------------------------------------------------------------------------------------ooo-----------------------------------------------------ooo----S---------------
--------%%%%%%%%-------------------------------S--------------------------------%-------------------------##--o---------------------------------------QQQ------o--------------------------------
---------||||||-------------------------------------------------S----------o----|-----oo------------------##-------------------------------#---------------------#---------oooooS---------------
---------||||||---------------------------------------------#-------------------|------------------------###------------------------------##--SS-----------------#------------------------------
---------||||||--------------------------------------------##----S--#-----------|--------ooo-------------###-----------------------------###----------------------------------------------------
------%%%%%%%%%%-------------o----------------------------###-------------------|-------%%%%-------S----####-----------#----------------####-----##----##--------------TT--------SSSSSSS-SS-----
-------||||||||------------------------------------------####----------TT-------|--------||--oo-------y####--#-TT----------------------#####----####---------#---------TT----#--SSSSSSSS--------
-------||||||||----------------------------#------------####---#-------TT----#--|--------||-%%%%-----######--#-TT-----------------##########----####--------##--TT-----TT---##--SSSSSSSS------S-
-------||||||||-------------kk------------##---------#######---#-------TT----#--|--------||--||------######--#-TT----------------#-##########---####-------k-#--TT-----TT---##--SSSSSSSS-----oSo
XXXXXXXXXXXXXXXXXXXXXXXXXXXXXXXXXXXXXXXXXXXXXXXXXXXXXXXXXXXX--XXXXXXXXXXXXXXXXXX|%%%%X%%%||--||-XXXXXXXXXXX-XXXXXXXXXXXXXXXXXXXXXXXXXXXXXXXXXXXXXXXX-XXXXXXXXXXXXXXXXXXXX--XX@X-XXXXXXXXXXXXXXXX
XXXXXXXXXXXXXXXXXXXXXXXXXXXXXXXXXXXXXXXXXXXXXXXXXXXXXXXXXXXXX-XXXXXXXXXXXXXXXXXX|-||---|-||--||-XXXXXXXXXXX-XXXXXXXXXXXXXXXXXXXXXXXXXXXXXXXXXXXXXXXX-XXXXXXXXXXXXXXXXXXXXXXXXX--XXXXXXXXXXXXXXXX
