-----------------------------------------------------------------------K------------------------------------------------------------------------------------------------------------------------
-----------------------------------------------------------------------o------------------------------------------------------------------------------------------------------------------------
----------------------------------------------------------------------%S------------------------------------------------------------------------------------------------------------------------
----------------------------------------------------------------------|--------o-----------------------------------------------------------------------K------------------------SSSSSSSSSSSSSSSS
----------------------------------------------------------------------|--------S----------------------------------------------------------------------------------------------------------------
----------------------------------------------------------------------|--------------------------------------------------------o----------------------%%%---------------------------------------
--------%%%%%%%%----------------SSSSSS--------------------------------|-----------------------------------SS----------------------o------------o-%%----|----------------------------------------
---------||||||-------------------------------------------------------|-----------------------------------------------------------------------##-||----|-----%%%--------------------------------
---------||||||-------------------------------------------------------|---------------------------------------------------------------------####-||----|------|---------------------------------
---------||||||------------------ooo---------ooo----------------------|------S------------oo-------------------------------------ooo-------#####o||----|------|---------------------------------
------%%%%%%%%%%----------######SSSSS----SSSSSSS----------------------|-------------------------###---------#-#-##---#-------o------------######%%|----|---#--|#-----------------------TT--#-#--
-------||||||||-------------------------------------------------------|-------------------------###--------##-#-##-----K----#-------------######o||----|---#--#---TT----TT------TT-----TT--#-#--
-------||||||||-------------------------------------------------------|-------------------------###--------##-####----------#------------#######%%|----|---##%%%--TT----TT------TT---#####-###--
-------||||||||---------------------gg-----------------------------rr-|-----rr-o--kk------------#-#----k--###-####-----k----kk----------########|||----|--##--##--TT----TT------TT---#####-###--
XXXXXXXXXXXXXXXXXXXXXXXXXXXXXXXXXXXXXXXXXXXXXXXXXXX---XXXXXX-----%%%%%%%%-%%%%%%XXXXXXX---XXXXXXXXX-XXXXXXXXXXXXXXXXXXXXXXXXXXXXXXXXXXXXXXXXXXX-|||---XXXXXX----XXXXXXXXXXX--X-XXXXXXXXXXXXXXXX-
XXXXXXXXXXXXXXXXXXXXXXXXXXXXXXXXXXXXXXXXXXXXXXXXXXX----X--XX---X--||||||---||||-XXXXXXX---XXXXXXXXX--XXXXXXXXXXXXXXXXXXXXXXXXXXXXXXXXXXXXXXRXXX-|||----XXXXX----XXXXXXXXXXX--X-XXXXXXXXXXXXXXXX-
