-------------------------------------------------------------------------------------K-S--------------------------------------------------------------------------------------------------------
---------------------------------------------------------------------------------------o--------------------------------------------------------------------------------------------------------
------------------------------------------------------------------------------------%%%%%-------------------------------------------------------------------------------------------------------
----------------------------------------------------------------SSS------------------|||-----------------------------------------S--------------SSS-SSSSSSSSSSSSSSSSSSSSSSSSSSSSSSSSSSSS--------
-------------------------------------------------------------------------------------|||------------------------------------------------------------------------SSS-SSSSSS----------------------
--------------------------------------------------o----------------------------------|||------------------------------------------------------------------------SSSSSSSS------------------------
--------%%%%%%%%-----------------%%%----------------------------%%%------------------|||-----------S---SSSS-----------------------------------------------------SSSSSSSS--S-----------%%%%SS----
---------||||||-------------------|------------#-U---------o-----|-------------------|||-----------------------------------------#-----------------------------------------------------||-------
---------||||||-------------------|------------#-----------------|--------%%%--------|||-----------------------------------------------------------------------------------------------||-------
---------||||||-------------------|-%---------##-----------------|---------|---------|||------------------------------------------------------------------------ooooo------------------||-------
------%%%%%%%%%%----------######--|-|---------##--TT------------%%---------|---------|||-------------SSS----SSSS------------------TT---TT---------TT----TT------SSSSS------------------||-------
-------||||||||-------------------|-|----TT---##--TT------------||---------|---------|||--------------------------TT--------------TT---TT-----TTTTTT----TT----------------------o------||-------
-------||||||||-------------------|-|----TT--###--TT----TT---TT-||----tt---|---------|||--------------------------TT-----TT-------TT---TT-----TTTTTT----TT---------------------------tt||-------
-------||||||||-------------------|-|--g-TT--###--TT----TT---TT-||----tt---|-g-g-----|||--------------------------TT-----TT-------TT---TT-----TTTTTT----TT--------------------##-----tt||------#
XXXXXXXXXXXXXXXXXXXXXXXXXXXXXXXXX%%-XXXXXXXXXXXXXXXXX-XXXXXXXXXX%|---XXXXXXXXXXX-----|%%%---%%%--%%%%---XXXXXXXXXXXXXXXXXXXX-X---XXXXXXXXXXXXXXXXXXXXXXXXXXXXXXXXXXXXXXXXXXXXXXX--XXXXXXXXXXXXXX
XXXXXXXXXXXXXXXXXXXXXXXXXXXXXXXXX||-XXXXXXXXXXXXXXXXX-XXXXXXXXXXX|---XXXXXXXXXXX-----|-|-----|----||----XXXXXXXXXXXXXXXXXXXX----XXXXXXXXXXXXXXXXXXXXXXXXXXXXXXXXXXXXXXXXXXXXXXXX--XXXXXXXXXXXXXX
