--------------------------------------------------------------------------------------------------------------------------------------------------------------------------------
--------------------------------------------------------------------------------------------------------------------------------------------------------------------------------
--------------------------------------------------------------------------------------------------------------------------------------------------------------------------------
-------------------------------------S------------------------------------------------------------------------------------------------------------------------------------------
-------------------g------------------------------------------------------------------------------------------------------------------------------------------------------------
----------------%-------------------------------------o-------------kkgo--ooooo-----------------------------------------------------kk------------------------------------------
--------%%%%%%%%|--------------%------o-SSSS---%--###--------------SSSS-----------SSSSSSSSSSS-@%-------#-----------QQQSUSS@----%----SSK-----------------------------Q-r---------
---------||||||-|--------------|---------------|------------------SSSSS------S-----------------|------##-----------------------U--------------------------------%-%%%%%%%%------
---------||||||-|--------------|----------SS---|-------------------SSS-------------------------|-----###--TT-------------------|--------------------------------|--||||||-U-----
---------||||||-|--------------|---------------|-------------------SSS-------------------------|----####--TT-----------------1-|--------------------------------|--||||||-------
------%%%%%%%%%%|-SS---SUS-----|-SS---SSoSSSS--|-------TT-----------SS------------SSo-SSoS-----|----####--##------SS---SSSSQQ#-|----------------------SS--------ooo||||S|-------
-------||||||||-|--------------|---------------|-------TT-----#--------------------------------|--#-####--------------------##-|-K--------------------------TT--|--||||-|-------
-------||||||||-|--------------|---------------|-------TT-----#----------TT--------------------|###-###-------------------####-|----------------------------TT--%%-||||-|-------
-------||||||||-|-------gk--##-|--------gg--y--|-------TT-----#--------k-TT-----gg-gggggggggg-gg###-#####-----------------####-|--k-------k--------------y--TT--gggggg|gg---y---
XXXXXXXXXXXXXXXXXXXXXXXXXXXXXXXXXXXXXXXXXXXXXXXXXXXXXXXXXXXXXXXXX---XXXXXXXXXXXXXXXXXXXXXXXXXXXXXXXXXXXXXXXXXXXXXXXXXXXXXXXXXXXXXXXXXXXXXXXXXXXXXXXXXXXXXXX-XXXXXXXXXXXXXXXXXXXX
XXXXXXXXXXXXXXXXXXXXXXXXXXXXXXXXXXXXXXXXXXXXXXXXXXXXXXXXXXXXXXXXX---XXXXXXXXXXXXXXXXXXXXXXXXXXXXXXXXXXXXXXXXXXXXXXXXXXXXXXXXXXXXXXXXXXXXXXXXXXXXXXXXXXXXXXX-XXXXXXXXXXXXXXXXXXXX
