------------------------------------------------------------------------------------------------------------------------------------------------------------------------------------------------
---------------------------------------------------------------------------------------------------------------------------------K--------------------------------------------------------------
------------------------------------------------------------------------------------------------------------------------------------------------------------------------------------------------
--------------------------------SSSSSS----------------------------------------------------------------------------------------------------------------------------------------------------------
-----------------------------------------------------------------------------------------------------------------------------------------------o------------------------------------------------
------------------------------------------------------------------------------------------------------------------------------------------------------------------------------------------------
--------%%%%%%%%-%%-----------------------------oooo---So-----oo----------------------Q-----------------------------------------------------------------------------QQQQQS-----S-oo-------------
---------||||||--||----------------------------------------------------------------------------------------------------------------------------------------------------------------------------#
---------||||||--||---------------------------------------------------------------------------------------------------------------------------------------------------------------------------##
---------||||||--||-%%%%-o----------------------------------------------------------gggg--------------------------------------------------------------#----------o----------------------------##
------%%%%%%%%%%-||--||--T---------------------------------------S--------------#######S---------SS---S--S----------------S--------------TT-----------#----------S-----S-----S----------------##
-------||||||||--||--||--TT-------------S------------------------------TT-----K-TT---SS------#--S--------R-------------------------------TT----------------------------------------------TT---##
-------||||||||--||--||--TT------#-------------------------------------TT-------TT-----------#-----------TT------------------------------TT----------------------------------------------TT--###
-------||||||||-%%%--||--TT----k-#----k----kkk--------g-gok---------gkkTT---k---TT-----------#--k-----k--TT--------------------------kk--TT---k--------------ooo---ggg---------g---k----###--###
XXXXXXXXXXXXXXXX-|---||X-XXXXXXXXXXXXXXXXXXXXXXXXXXXXXXXXXX-XXXXXXXXXXXXXXXXXXXXXXXXXXXXXXXXXXXXXXXXXXXXXXXXXXXX-----%-------%--XXXXXXXXXXXXXXXX--X-------XXXX-XXXXXXXXXXXXXXXXXXXXXXXXXXXXXXXXX
XXXXXXXXXXXXXXXX-|---||X-XXXXXXXXXXXXXXXXXXXXXXXXXXXXXXXXXX-XXXXXXXXXXXXXXXXXXXXXXXXXXXXXXXXXXXXXXXXXXXXXXXXXXXX-----|-------|--XXXXXXXXXXXXXXXX---X------XXXX-XXXXXXXXXXXXXXXXXXXXXXXXXXXXXXXX-
