------------------------------------------------------------------------------------------------------------------------------------------------------------------------------------------------
------------------------------------------------------------------------------------------------------------------------------------------------------------------------------------------------
------------------------------------------------------------------------------------------------------------------------------------------------------------------------------------------------
-----------------------------------------------------------------------------------------------------ooo----------------------------------------------------------------------------------------
------------------------------------------------------------------------------------------------------------------------------------------------------------------------------------------------
-----------------------------------------------------------------ooo------ooooo-----------------------------------------------------------------------------------------------------------------
--------%%%%%%%%------------------------------------------------%%%%-------%%------------------o---------------------------------------------SSS------------------------------------------------
---------||||||--------------------------------------------------||--------||---------------------------------------------------S--------------------------------------------------------------o
---------||||||---------------------------------S----------------||--------||----------------SS----S--S-----------------------------------------------------------------------------------##----
---------||||||---------------------------------S----------------||-------o||----------------S---------------------------------#--ooo----------------------------------------------------###----
------%%%%%%%%%%----------######----------------%----------------||--S%%%%%%%%%%-------------SS--------------------------%%----#--SSSSSS----SSo-----------------------------------------####----
-------||||||||---------------------------------|----------------||----||||||||---#--------------------------------------||----#S----------------------------------------U-------------#######--
-------||||||||---------------------------------|----------------||----||||||||---#-----------------------------o--------||----#-----------------------------------------#------------########--
-------||||||||---------------------------------%----------------||----||||||||-###k--ky----kg---------------------------||----#---------------g------------k------------#--k--------#######-#--
XXXXXXXXXXXXXXXXXXXXXXXXXXXXXXXX--XXXXXXXXXX---X|--------XXXX%-XXX%%%X-|X%XX|||-XXXXXXXXXXXXXXXXXXXX---------XXX%%%%-----XXX---XXXXXXXXXXXXXXXXXXXXXXXXXXXXXXXXXXXXXXXXXXXXXXXXXXXXXXXXXXXXXXXXX
XXXXXXXXXXXXXXXXXXXXXXXXXXXXXXXX--XXXXXXXXXX---X|--------XXX-|-XXXX|-X-|-|XX|||-XXXXXXXXXXXXXXXXXXXX---------XXX-||------XXX----XXXXXXXXXXXXXXXXXXXXXXXXXXXXXXXXXXXXXXXXXXXXXXXXXXXXXXXXXXX-XXXX
