------------------------------------------------------------------------------------------------------------------------------------------------------------------------------------------------
-------------------------------------------------K-K-----SS-------------------------------------------------------------------------------------------------------------------------------------
------------------------------------------------------------------------------------------------------------------------------------------------------------------------------------------------
--------------------------------------------------------SSSSSSSS--------------------------------------------------------------------------------------------------------------------------------
------------------------------------------------------------------------------------------------------------------------------------------------------------------------------------------------
-------------------------------------------------------------------------------------------------oo---------------------------------------------------------------------------------------------
--------%%%%%%%%S-SSSSSS-------------------------------------S---------------------------------------------------------------------------S---SSS-------%%-----------------------------o---------
---------||||||----------------------------------------------S-----------------o------------------------------------------------------------------%%%%%%|----%%%--------------------------------
---------||||||----------------------------------------------S-------------------------------------------------------------------------------------||||-|-----|---------------------------------
---------||||||-So----------------------------------g---------oo---------------------------------------------------------------------g-------------||||-|-----|---------------------------------
------%%%%%%%%%%SS-----------SSS----------------SSSSSSS----------------------------------2--------------TT--------------TT-------#-SSS#-----S@S----||||-|-----|---------------------------------
-------||||||||--------------------------TT-----SSSSS-@--TT---------------------------------------------TT---###--------TT----------------------o--||||-|-----|-------------------------------K-
-------||||||||--------------------------TT-----SSSSSS---TT-------TT-----##-----------------------------TT---###--------TT----------------------%--|||tt|-----|---------------------------------
-------||||||||--------------------k-----TT---ggSSSSSSkS-TT-------TT----###----------k------k-----------TT---###---k----TT--------oy------k-k---|--|||tt|----#|---------------------ggk-----kk--
XXXXXXXXXXXXXXXXXXXXXXXXXXXXXXXXXXXXXXXXXXXXXXXXXXXXXXXXXXX--XXXXXXXXXXXXXXXXXXXXXXXXXXXXXXXXXXXXXXXXXXXXXXXXXXXXXXXXXXXXXXX--XXXXXXXXXXXXXXXXXX|%X||XXXXXXXXXXX-XXXXXXXX----XXXXXXXXXXXXXXXXXXX
XXXXXXXXXXXXXXXXXXXXXXXXXXXXXXXXXXXXXXXXXXXXXXXXXXXXXXXXXXX-XXXXXXXXXXXXXXXXXXXXXXXXXXXXXXXXXXXXXXXXXXXXXXXXXXXXXXXXXXXXXXX---XXXXXXXXXXXXXXXXXX||-||XXXXXXXXX-X-XXXXXXXXX----XXXXXXXXXXXXXXXXXX
