-----------------------------------------------------------------------------------------------------------------------------------------------------------------------------------------S------
---------------------------------S----------------------------------------------------------------------------------------------------------------------------------------------------SSSSS-----
------------------------------------------------------------------------------------------------------------------------------------------------------------------------------------------------
---------------------------------------SSSSSSSSS----------------SSSS----------------------------##----------------------------------------------------------------------------------------------
---------------------------------------------------------------------------------------------------------------------------------------------------------------------------------------S--------
---------------------------------------------------------------------------------------------------------------------------------------------------------------------------------------S--------
--------%%%%%%%%---SSSSS---SSS-S------------------------------------------------oooo---------oo----------------------------------------------ooo---------------------------------2---2SS-----S--
---------||||||-----------------------------------%%%%%%-----%%%---%%%%-----------------------------------------------------------------------------------------------o-------------------------
---------||||||------------------------------SSS---||||-------|-----||-----------------------SSS-------------------------------------------#--SS------------------------------------------------
---------||||||----------------------------------o-||||-------|-----||----------S---------SS-SSo------------------------------------------#----o-------------------------oooo-------------o-----
------%%%%%%%%%%QSS--SSSSSSS-@%#-----SS--TT------%%||||-------|-----||----------S---------------------------------------------------------#------------------------------%%%%----SSo--SSSS---SSS
-------||||||||--------------#|-SSSSSS---TT------||||||-------|r----||-------------------------------------------------------------------##-------------------------------||----S---------------
-------||||||||-------------###-S-TT-----TT------||||||------%%%----||---------------------------------TT----------------K--------------###-------------------------------||--------------------
-------||||||||-------------##--S-TT-SkS-TT------||||||-------|#----||---------o------------k-----g----TT--#------------------oo----ggg####-------g------------g---r------||--------------------
XXXXXXXXXXXXXXXXXXXXXXXXXXXXXXX-XXXXXXXXXXX---XX-%%%%%|XoXX---|-XXXX|XXXXXXX%%%%XXXXXXXXXX--XXXXXXXXXXXXXXXXXXXX---------%%-%%%%XXXXXXXXXXXXXXXXXXXXXXXXXXXXXXXX--%%%%%%--||-%%%-XXXXXXXXS---U-X
XXXXXXXXXXXXXXXXXXXXXXXXXXXXXXXXXXXXXXXXXXXXX-XX--|||-|XXXX---|-XXX-|XXXXXXX-||-XXXXXXXXXX--XXXXXXXXXXXXXXXXXXXX---------||--||-XXXXXXXXXXXXXXXXXXXXXXXXXXXXXXXX---||||---||--|--XXXXXXXX-----XX
