-----------------------------------------------------------------------------------------------------------------------S------------------------------------------------------------------------
------------------------------------------------------------------------------------------------------------------------------------------------------------------------------------------------
------------------------------------------------------------------------------------------------------------------------------------------------------------------------------------------------
------------------------------------------------#-----------------------------------------------------------------------------------------------------------------------------------------------
-----------------------------------------------##-----------------------------------------------------------------------------------------------------------------------------------------------
---------------------------------oo---------------------------o-------------------------------------------------------------------------------------------------Q-------------------------------
--------%%%%%%%%------------------------------------------%%%%%%-SSS@SSS-----------------------#SS---S------------------------------QQQQ------o----------------------Q--------------------------
---------||||||--------------------------------------------||||-------------------------------##------------------------------------------------------------------------------------------------
---------||||||----------------------------------%%%-------||||----------------------------#####----------------K-------------------------------------------------------------------------------
---------||||||--------------S--------------------|--------||||#---------------oo----------#####---------------o----%%%%------------------------------------------------------------------------
------%%%%%%%%%%----------------------------------|------%%%%%|#----S--S-----US-----------######SSSS-----------U%----||---------Q#Q#---##------------------------#---SSS------------------------
-------||||||||-----------------------------------|-------|||-|#-------------------------######o----------------|----||-------------------------------------------------------------------------
-------||||||||-#---------------------------------|-------|||-##------------------------########----------------|o---||----------------------------------------#--------------------------------
-------||||||||-#----------------------------ooo--rr----rr|||-##----------k-k-----kk---#########----gg#-#-------%%%--||------ooo---k--gg----k---------g-------##--------------------------------
XXXXXXXXXXXXXXXXX%%%--XXXXXXXXXXXXXXXXXXXXXXX%%%%%%%%%%%%%%%|-XXXXXXXXXXXXXXXXXXXXXXXXXXXXXXXXXXXXXXXXXXXX---XXX-|---||----X%%%%XXXXXXXXXXXXXXXXXXXXXXXXXXXXXXXXXXXXXXXXXXXXXXXX---------XXX----
XXXXXXXXXXXXXXXXX-|---XXXXXXXXXXXXXXXXXXX-XXXX|||||||||||XXX|-XXXXXXXXXXXXXXXXXXXXXXXXXXXXXXXXX-XXXXXXXXXX---XXX-|---||------||-XXXXXXXXXXXXXXXXXXXXXXXXXXXXXXXXXXXXXXXXXXXXXXXX---------XXX----
