-------------------------------------------------------------------------------------------------------------------------------------------------------k----------------------------------------
-------------------------------------------------------------------------------------------------------------------------------------------------------S----------------------------------------
-------------------------------------------------------------------------------------------------------------------------------------------------------S----------------------------------------
------------------------------------------------SSSSSSSSSSSSSSSS------------------S--SSSSSSSSSSSSSSSSSSSSSSSSSSS--------------------------------------------------------------------------------
------------------------------------------------------------------------------------------------------------------------------------------------------------------------------------------------
---------------------------o--------------------------------------------------------------------------------------------------------------------------------ooo-----------------------------o---
--------%%%%%%%%-------Q-------------------#---o--------------------------------SSSS---------SSS-------------------------@-------ooo---oo-----So--------------------Q--oSS----oo----------------
---------||||||---------------------------##--------------------SSS%%---------------------------------------------------------------------------------------------------------##----------------
---------||||||--------------------------###--------------------S--||-------------------------------------------------------------------------------------------------------####----------------
---------||||||--------g---------o------####-----------------------||-------------ooo-------------------------------------------oooo------------------------------k--------#####----------------
------%%%%%%%%%%-----S##S----#---------####--#----------TT----TT---||-----------S-SSS-----------------------------------------o-------------SoS-------%%%%%%%S--##-------#######-----SS--SSSSS--
-------||||||||--------------#--------####--##----------TT----TT---||--------------------TT-------------------------------K----------------------------|||||--------------######----------------
-------||||||||--------------##------#####-###----------TT----TT---||--------------------TT------------------------------------@-----------------------|||||-------------#######----------------
-------||||||||--------------###----######-###----------TT----TT---||----------#---------TT-------------------g---ggg--k-------g---k-kg----------------|||||-------k---g########----------------
XXXXXXXXXXXXXXXXXX%%-----XXXXXXXXXXXXXXXXX-XXXXXXXXXXXXXXXXXXXXXXXXXXXXXXXXXXXXXXXXXXXXXXXXXXXXXXXXXXXXXXXXXXXXXXXXXXXXXXXXXXXXXXXXXXXXXXXXXXXXX-%%%%%%%%%||-%%%XXXXXXXXXXXXXXXX--%%%%%--%%%%%%-
XXXXXXXXXXXXXXXXXXX|-----XXXXXXXXXXXXXXXX--XXXXXXXXXXXXXXXXXXXXXXXXX-XXXXXXXXXXXXXXXXXXXXXXXXXXXXXXXXXXXXXXXXXXXXXXXXXXXXXXXXXXXXXXXXXXXXXXXXXXX--|||||||-||--|-XXXXXXXXXXXXXXXX---|||----||||--
