---------------------------------------------------------------------------------------------------------------------------------------k--------------------------------------------------------
-------------------------------------------------K----------------------------------------------------S----------------------------------------------------------------------------------S------
------------------------------------------------------------------------------------------------------------------------------------------------------------------------------------------------
----------------------------------------------------------------SSSSSSSSSSSSSSSS-----------------SS------SSSSSSS--------------------------------------------------------------------------------
------------------------------------------------------------------------------------------------------------------------------------------------------------------------------------------------
------------------o---------------------------------------------------------------------------------------------------------------------------------------------------------------o-----S-oooooo
--------%%%%%%%%-----------------------SSS-----------S-----------------------------------------------------------------SS----SSS--------%%%%%%%-----SSSQ----------------------------------------
---------||||||--------------------------------------------------------------------------------------------------------------------------|||||--------------------------------------------------
---------||||||-----------------------------------------------------------------------------------------------------------------%%-------|||||--------------------------------------------------
---------||||||-----------oo---------------------------------------------------------------##-------------SS-SS-----------------||-------|||||--------gg-------o--------------------------o-----
------%%%%%%%%%%----------%%---S------Q-----oo-----------TT-------------------------------###-------------------S-----------SSSS||----%%%%%%%|------SSSS-------------------------2---SU---------
-------||||||||-----------||----------------------K------TT-------------------TT-----------#-------------#----------------------||-----|||||-|--TT----------------------------------------------
-------||||||||-----------||-----------------------------TT-------------------TT----------##-------------#-K--------------------||-----|||||%%%%TT----------------TT----TT----TT----------------
-------||||||||-----------||-------------------------kk--TT----------k--------TT----------###--#---------#-o--------ggk-----k---||-----|||||-||-TT--------k-k-----TT----TT----TT---------------k
XXXXXXXXXXXXXXXXXXXX-----%||---XXXXXXXXXXXXXXXXXXXXXXXXXXXXXXXXX-XXXXXXXXXXXXXXXX%XXXXXXXXXXX--X--XXX-XXXX%S%S--XXXXXXXXXXXXXXXX%%%%%%%%%%%|-||-XXXXXXXXXXXXXXXX-XXXXXXXXXXXXXXXXXXX--------XXXX
XXXXXXXXXXXXXXXX--XX-----|||---XXXXXXXXXXXXXXXXXXXXXXXXXXXXXXXXXXXXXXXXXXXXXXXXXXXXXXXXXXXXXX-XX--XXX-XXXX|-|---XXXXXXXXXXXXXXXX-|||||||||-|-||-XXXXXXXXXXXXXXXX-XXXXXXXXXXXXXXXXXX--------XXXXX
