---------------------------------------------------------------------------------------------------------------------------------------------------@------S-------------------------------------
------------------------------------------------------------------------------------------------------------------------------------------------------------------------------------------------
------------------------------------------------------------------------------------------------------------------------------------------------------------------------------------------------
----------------------------------------------------------------SSSSSSSSSSSSSSSS--------------------------------SSSSSSSSSSSSSSSSSSSSSSSSSSSSSSSS------------------------------------------------
----------------------------------------------------------------------------------------------------------------S-------------------------------------------------------------------------------
--------------------------------------------------------------o---------------------------------------------------------------------------------------------------------------------------------
--------%%%%%%%%--------------------QSQSSS-----------------------------------S-----------------o-------SSSSSS-----------------------------------------------------------------------------------
---------||||||----------------------------------------o--oooooo----------------------------------o--------------------------------------------------------------------------------------------#
---------||||||---------------------------------------%%%------------------------------------------%-------------------------------------------------------S------------------------------------
---------||||||----------------------------------------|----------------------------------S--------|------------------------------------------------------oSoSS---------------------------------
------%%%%%%%%%%----------######Q###QQQQS----U---------|--------------------------##---------------|--------SSS---------TT----TT-----------#----------------SS----------------------------------
-------||||||||--------------------#-------------------|----------------#--------###---------------|--------------TT----TT----TT---------#-#-#-----------------------------------------------ooo
-------||||||||------------------#---------------------|----%%%%-------##-------#####---##---------|--------------TT----TT----TT---###-###-#-#-----------------------------------------------#--
-------||||||||------------------#-k--k----------------|-----||--------##-------#####---##---------|--------------TT--k-TT----TT##--########-#--------------------------------oo---r------------
XXXXXXXXXXXXXXXXXXXXXXXXXXXXXXXXXXXXXXXXXXXXXXXX-%%%--%%%%%%-%%%XXXXXXXXXX------XXXXXXXXXXXXXXXX---|--%%-----X--XXXXXXXXXXXXX-XXXXXXXXXXXXXXXXXX---%%%%SSS%%%SS--%%-------%%%%%%XX%%--XXXX---XXX
XXXXXXXXXXXXXXXXXXXXXXXXXXXXXXXXXXXXXXXXXXXXXXXX--|----X|||---|-XXXXXXXXXX------XXXXXXXXXXXXXXXX---|--||----XXX-XXXXXXXXXXXXX-XXXXXXXXXXXXXXXXXX----||-----|-----||--------||||-XXXX--XXXX---XX-
