---------------------------------------KS-----------------------------------------------------------------S-------------------------------------------------------------------------------------
---------------------------------------o--------------------------------------------------------------------------------------------------------------------------------------------------------
--------------------------------------%%%%------------------------------------------------------------------------------------------------------------------------------------------------------
---------------------------------------||-----------------------------------------------------------------------SSSSSSSSSSS---S-----------------------------------------------------------------
---------------------------------------||------o---------------------------------------------------------o--------------------------------------------------------------------------------------
---------------------------------------||-----%%----------------------------------------------%%------------------------------------------------------------------------------------------------
--------%%%%%%%%-----------------------||-----||------------------------------------------%%%%%|-------SSS---oo-----------SS--------------------------SooS----oo--------------------------------
---------||||||--------o---o----%%-----||----%%%-------------------------------------------|||-|-------------------------------------------#-----------------------------------#-------------S--
---------||||||-------%%%-%%%---||-----||-----|--------------------------------------------|||-|-------------------S----------------------##----------------------------------##----------------
---------||||||--------|---|----||-----||-----|----------ooo-------------------------------|||-|-------k--SSSSS--------------------------###--------------------------------#-##----------------
------%%%%%%%%%%-------|---|----||-----||-----|---------%%%%----TTTT--S------------------%%%||-|-ooo---S-S-------------------------------####------------------------------#####----------------
-------||||||||--------|---|----||-----||-----|----------||-----TTTT----------------------|-||-|-------------------------------#--TT----#####------------#----------------######--TT-----#------
-------||||||||--------|---|----||-----||---%%%%---------||-----TTTT----------------------|-%%%%---------------------#---------#--TT--#######------#----##--------------TT######--TT----##------
-------||||||||--------|---|----||-----||----||----r-----||-----TTTT--k-------------------|--||------------k---------#---g-----#--TT--######---k---#----##------%-------TT######k-TT----##--k---
XXXXXXXXXXXXXXXXXXXXXXXXXXXXXX-X||----%%%%%--||--%%%%%%%%%%-----XXXXXXXXXXXXXXXX-%%%%%%%%%%%%||---XX-SS------S--XXXXXXXXXXXXXXXXXXXXXXXXXXXXXXXXXXXXXXXXXXXXXXXXXXXXXXXXXXXXXXX-XXXXXXXXXXXXXXXX
XXXXXXXXXXXXXXXXX-XXXXXXXXXXXXXX||-----|||---||---||||||||------XXXXXXXXXXXXXXXX--||||||||||-||---XX------------XXXXXXXXXXXXXXXXXXXXXXXXXXX-XXXXXXXXXXXXXXXXXXXXXXXXXXXXXXXXXXX-XXXXXXXXXXXXXXXX
