-----------------------------------------------------------------------------------------------------------------------------------------------------------------------S------------------------
-----------------------------------------------------------------------------------------------------------------------------------------------------------------------S------------------------
------------------------------------------------------------------------------------------------------------------------------------------------------------------------------------------------
---------------------------------------------------------------------------------#--------------SSSSSSSSS---------------------------------------------------------------------------------------
------------------------------------------------------------------------------o--2--------------------------------------------------------------------------------------------------------------
-------------------------------------------------------------------------------------------------------------------------oo------oo-----------------------------o-oo-------------oo-----oo------
--------%%%%%%%%----------------------oQ----------------------------SSSSSSS--------------------------------#------------------------------------------SSSS---SS------------------%%-------------
---------||||||--------------------------------o--------------------------------SS-------------#----------##-----#-------------o-------------------------------------------------||------------o
---------||||||-----------------------------------------------------------------S-------------###-------####--SS-----------------------------------------------------------------||-------------
---------||||||---------------------------------------------------------------------##--------##--------###--------------------------------------------------------------ooo-----||-------------
------%%%%%%%%%%----------######--------------------------------------------SoS-----##-------###---------------------2------------------TT----TT------SSSS%SSSS----------%%%-----||--2----------
-------||||||||------------------------------------------------------------------------------###-------###------TT-----TT---------TT----TT----TT----------|---------------|------||-------------
-------||||||||------------------------#-----------------------------------------------TTTT-####------####--TT--TT-----TT---------TT----TT----TT----------|---------------|------||----tt---##--
-------||||||||------------------------#-----------ggg-------------kgg---------g-------TTTT-####-----#####--TT--TT-----TT----##---TT-k--TT----TT----------|---------------|---ooo|g----tt---####
XXXXXXXXXXXXXXXXXXXXXXXXXXXXXXXXXXXX-XXXXXXXXXXXXXXXXXXXXXXXXXXXXXXXXXXXXXXXXXXXXXXXXXXXXXXXXXXXXXXXXXXXXXXXXXXXXXXXXXXXXXXXXXXXXXXXXXXXXXXXXXXX--X%X%X-X-|--X%%-%%%%%%%%-|--%%%XXXXXXXXXXXXXXXX
XXXXXXXXXXXXXXXXXXXXXXXXXXXXXXXXXXXX-XXXXXXXXXXXXXXXXXXXXXXXXXXXXXXXXXXXXXXXXXXXXXXXXXXXXXXXXXXXXXXXXXXXXXXXXXXXXXXXXXXXXXXXXXXXXXXXXXXXXXXXXXXX--XX-|--X-|---||--||||||--|---|-XXXXXXXXXXXXXXXX
