-------------------------------------------------------------------------------------------------------------------------------------------------------------------------------------SSS--------
-------------------------------------------------------------------------------------------------------------------------------------------------------------------------------------SSS--------
-------------------------------------------------------------------------------------------------------------------------------------------------------------------------------------SSS--------
--------------------------------------------------------------------------------------------------------------------------------SSSSSSSSS-----------------------SSSSSSSSSSSSSSSS----------------
------------------------------------------------------------------------------------------------------------------------------------------------------------------------------------------------
-----------------------------------------------------------------oo---------------------------------------------------------o-------------------------------------------------------------------
--------%%%%%%%%-------------------------------------------------%%------------------QQQQ------#Sooo--USo--K---------------%S----------SSS-----o------SSS------o--r---------------------%--S----
---------||||||----------------------------#-----#---------------||---------------------------##-----------S---------------|--------%%--------------------------%%%%%%-----------%%%---o|--o----
---------||||||---------------------------##---------------------||----TT--------------------###-----------S-S-------------|--------||-----y##-------------S--SS-||||-------%%%---|-----|-------
---------||||||---------------------------###--------------------||----TT---------#---------####-------o---SoSoo-----------|--------||-----##--------------------||||--------|----|-----|-------
------%%%%%%%%%%----------######----------###--------------------||----##-------####---#---#####SS----SSS--SSSSS-----So----|--------||----###-----------------SS-||||--------|----|-----|-------
-------||||||||-------------------------#####----------tt--------||-------------####-------#####-----------K---------------|--------||---####-------------------o|||oo-----#-|----|-----|-------
-------||||||||------------------------######----------tt--------||-------------###--------#####-----------#---------------|--------||--######-#----------------%%|%%%---#-#-|----|-----|-------
-------||||||||-------------------g-gg#######----------tt---k----||-------------###--------#####-----------#----#----------|k-------||-#########-----k-----k----|||-|----#-#-|----|-----|--rrr--
XXXXXXXXXXXXXXXXXXXXXXXXXXXXXXXXXXXXXXXXXXXXXXXXXXXXXXXXXXXXXXXXXXXXXXXXX-XX----XXX---XXXXXXXXXX--XX-------X-XXXX--------XXXXXXXXXXXXXXXXXXXXXXXXXXXXXXXXXXXXXXX|||-|XXXXXXX%|-X%%%%-%%%%%%%%%%%
XXXXXXXXXXXXXXXXXXXXXXXXXXXXXXXXXXXXXXXXXXXXXXXXXXXXXXXXXXXXXXXXXXXXXXXXX-XXX---XXX--XXXXXXXXXX---XX---------XXXX--------XXXXXXXXXXXXXXXXXXXX-XXXXXXXXXXXXXXXXXX|||-|-XXXXXX||-X-||---|||||||||-
