-------------------------------------------------------K----------------------------------------------------------------------------------------------------------------------------------------
-------------------------------------------------------o----------------------------------------------------------------------------------------------------------------------------------------
------------------------------------------------------%S----------------------------------------------------------------------------------------------------------------------------------------
------------------------------------------------------|---------------------------------------------------------SSS-------SSSSSSS---------------SSSSSSS-----------------------------------------
------------------------------------------------------|----------------------------------------------------------------------------------------------SS-----------------------------------------
------------------------oooo--------------------------|-----------------------------------------------------------------------------------------------------------------------------------------
--------%%%%%%%%----------------%%%%------%%%%%%------|---------Sooo----oo---SSS-----------------------SS%S--------------------o-----------#-------o----oo---o----------------------------------
---------||||||------------------||--------||||-------|--------------------------------------------------|---------------------#----------##-------------------S-----------------o---------ooo--
---------||||||------------------||--------||||-------|--------------------------------------------------|--------------------##----------##------SSS---SSSSSSSS----TT--------------------------
---------||||||------------------||--------||||-------|--ooo----S----------------------------------------|--------o-----------##----------###---------------SSSS----TT--------------------------
------%%%%%%%%%%-----------------||----%%%%%%%%%------|-%%%%----S---------------#------------------------|---SS---------------##-TT---TT--####--------------SSSS----##-------------------#------
-------||||||||------------------||-----|||||||-------|--||--o-------------------------------------------|--------------------##-TT---TT---###-------------------------------------------#------
-------||||||||------------------||-----|||||||-------|--||-%%%----------------#-----------#-------------|-------------------###-TT---TT---###---------------------------TT------------###------
-------||||||||------------------||-----|||||||----rr-|--||--|----------------##-----gg---##-------------|------------------####-TT---TT---###-------------y-------------TT---k-------####------
XXXXXXXXXXXXXXXXXXXXXXXXXX------%%%%%%%%|||||||--%%%%%%%%%%%-|----XXXXXXXXXXXXXXXXXXXXXXXXXXXXXX-%%%-XXXXX-X-%%%XXXXXXXXXXXXXXXXXXXXXXXXXXXXXXX------XXXXXXXXXXXXXXXXXXXXXXXXXXXooXXXXXXXX------
XXXXXXXXXXXXXXXXXXXXXXXXXX-------||||||-|||||||---|||||||||--|----XXXXXXXXXXXXXXXXXXXXXXXXXXXXXX--|---XXXX-X-X|XXXXXXXXXXXXXXXXXXXXXXXXXXXXXXXX------XXXXXXXXXXXXXXXXXXXXXXXXXXXXXXXXXXXXX------
