--------------------------------------S--------------------------------------------------------------SSS----------------------------------------------------------------------------------------
--------------------------------------S--------------------------------------------------------------SSS----------------------------------------------------------------------------------------
-------------------------------------SS--------------------------------------------------------------SSS----------------------------------------------------------------------------------------
--------------------------------SSS-------------------------------------------------------------SSS---------------------------------------------------------------------------------------------
--------------------------------------------------------------------------------------------------------------------------------------------------------------------------------#---------------
-----------------------------------------------------------------------------------------------------------------------------------------------------------------------------------------------o
--------%%%%%%%%---------------------------SSS---------------------------------------S-----------------SS------------QQQQ------o----------------------SSSS-----------------S--------------------
---------||||||-----------------------------S--------------#----------oo------------------------S%%%%%%oo--ooo-----------------#----------------------------------------------------------------
---------||||||-----------------------------SS------------##--------------------------------------||||------------------------------------------------------------------------------------------
---------||||||-----------------------------SSS-----------###-----------------------o-------------||||------------------------------------------------------------------------------------------
------%%%%%%%%%%----------######------##---SSSS--------TT-####------------------------------------||||------------#------------------------------------------SSS---------------------------##---
-------||||||||-----------------------#----S----------TT--####----------------------------K-------||||------------##---------------------TT-----------------------------------------------###---
-------||||||||-------------------###-#----S-K--------TT--##TTTT----------------------------------||||------------##---------------------TT-----------------------------------------------###---
-------||||||||-----------------#-###-k----k-y----g---TT--##TTTT----g-------------g-----------ko--||||------------##---------------------TT----o-----k----------k-----------------g-----#-##----
XXXXXXXXXXXXXXXXXXXXXXXXXXXXXXXXXXXXXXXXXXXXXXXXXXXXXXXXXXXXXXXXXXXXXXXXXXXXXXXXXXXXXXXXXXXXXXXX--X||XXXXX-X-%%SXXXX--XXXXX-XXXXX-XXXXXXXXXXXXXXXXXXXXXXXXXXXXXXXXXXXXXXXXXXX---XXXXXXXXXXXXX--X
XXXXXXXXXXXXXXXXXXXXXXXXXXXXXXXXXXXXXXXXXXXXXXXXXXXXXXXXXXXXXXXXXXXXXXXXXXXXXXXXXXXXXXXXXXXXXXXX--X||-XXXX-X-||-XXXXX-XXXXX-XXXXX-XXXXXXXXXXXXXXXXXXXXXXXXXXXXXXXXXXXXXXXXXXX---XXXXXXXXXXXXX--X
