----------------------------------------------------------------------S--------------------------------------------------------------------------------S---------------S------------------------
----------------------------------------------------------------------S--------------------------------------------------------------------------------S----------------------------------------
-------------------------------------------------------------------------------------------------------------------------------------------------------S----------------------------------------
----------------------------------SSS--------------------------------SSS----------------------------SSSSS---------------------------------------------------------------------------------------
------------------------------------------------------------------------------------------------------------------------------------------------------------------------------------------------
------------------o--------o---------------------------------------------------------------------------------------------------------------------------------------------------%----------------
--------%%%%%%%%---------------------SS------S--%%%-------------SSSSSSSS-----SS-SSS-------oo---o-----------------------SSSSS%%-o----------------------SSSSS-----%--------------|-------QQ-------
---------||||||----------------------------------|--------------------------------------------------------#-----------------||-----------------o----------------|--------------|-------------ooo
---------||||||----------------------------------|----------------------------------------SS--o----------##-----------------||##-----------------------------S--|--------------|----------------
---------||||||---------------------g------------|------------------------------o-----------------------##------------------||##-----------------------o--SSSSSS|--------oooo--|----------------
------%%%%%%%%%-TT---S-------------SSS----------SSS-------%%----SSSSS----------SS------------S----------##-------------SS---||##----------------SS----SSS--SSS--%o------%%%%%--|--##------------
-------|||||||--TT----------------------------------------||-------------------------------------------###---#--------------||##---------------#----------------|--------|||--o|--##------------
-------|||||||--TT-----------K----------TT----------------||-%%%-------------------------TT-----------####---#--------------|###---------------#----------------|--------|||-%%%--##------------
-------|||||||--TT-----------y--k-----k-TT---------rr-----||--|-------k------------------TT----------#####---k--------------|###----------#----#-----------k----|--rr----|||--|--###-----##----#
XXXXXXXXXXXXXXXXXXXXXXXXXXXXXXXXXXXXXXXXXXXXXXXX%%%%%%%%%%||--|--XXXXXXXXXX-XXXXXXXXXXXXXXXXXXXXXXXXXXXXXX--XXXX%%%%%%%%%%%oXXXX--XXXXXXXXXXXXXX-------------S%o|%%%%%%%%|%|-%%%XXXXXXXXXXXXXXXX
XXXXXXXXXXXXXXXXXXXXXXXXXXXXXXXXXXXXXXXXXXXXXXXX-||X|||||-||--|--XXXXXXXXXX-XXXXXXXXXXXXXXXXXXXXXXXXXXXXXX-XXXXX-|||||||XXX-XXXX---XXXXXXXXXX-XX-------------X|X|-||||||-|||--|-XXXXXXXXXXXXXXXX
