-----------------------------------------------------------K------------------------------------------------------------------------------------------------------------------------------------
------------------------------------------------------------------------------------------------------------------S-----------------------------------------------------------------------------
------------------------------------------------------------------------------------------------------------------------------------------------------------------------------------------------
--------------------------------------------------------------------------------SSSSSSS----S--SS----------------SSS-------------------------------------------------------------SSSSSSSS--------
---------------------------------------------------------------------------------------------------------------------SS-------------------------------------------------------------------------
------------------------------------------------------------------------------o------------------oo-------oo----------------SoSS----------------------------------------------------------------
--------%%%%%%%%---------------------------------------%%%%---------SSS----S%%%------------------%%--------------------------SS------------------------------------------------------------S---S
---------||||||-----------------SSS----------------%%%%-||-------------------|--%%%%-------------||----------------------------------------oooo-------------------------------------------------
---------||||||-------------------------------------||--||-------------------|---||-------%%-----||---------------------------------------------------------------------------------------------
---------||||||-----------------SSS----------SS-----||--||-------------------|---||-------||-----||-----------------oo--------oo----------------------------------------------------------------
------%%%%%%%%%%----------######-----------S-S------||--||----------S--SSSSSSSSS-||-------||-----||----tt----------SSSS------SSS-------------------------------------2---TT----------------#-#--
-------||||||||----------------------------S--------||--||----------------------o||-------||-----||----tt-----TTTT---------------------#---------------TT----------------TT----------------###--
-------||||||||----------------------------S-K------||--||----------------------%%|%%%----||-----||----tt-----TTTT---------------------#-----#---------TT----------------TT---TT-----------###--
-------||||||||-----------------#---------SS-U------||--||---------gggg---------|||-|-----||-r---||----tt-----TTTT--------k-kkko-------#-----#--g-gg---TT---------y--k-k-TT---TT-------k---####-
XXXXXXXXXXXXXXXXXXXXXXXXXXXXXXXXXXXX--XXXXXXXXXX----||XXXXXXXX-XXXXXXXXXXXXXXXXX|||-|--X%%%%%%%XXXXXXXXXXXXXXXXXXXXXXXXX-XXXXXXXXXXXXXXXXXXXXXXXXXXXXXXXXXXXXXXXXXXXXXXXXXXXXXXXXXXXXXXXXXXXXXX-
XXXXXXXXXXXXXXXXXXXXXXXXXXXXXXXXXXXX-XXXXXXXXXXX----||XXXXXXXX-XXXXXXXXXXXXXXXXX|||-|--XXX|X|X-XXXXXXXXXXXXXXXXXXXXXXXX--XXXXXXXXXXXXXXXXXXXXXXXXXXXXXXXXXXXXXXXXXXXXXXXXXXXXXXXXXXXXXXXXXXXXXX-
