------------------------------------------------------------------------------------------------------------------------------------------------------------------------------------------------
-----------------------------------------------------------------------------------------------------------------K------------------------------------------------------------------------------
-----------------------------------------------------------------#------------------------------------------------------------------------------------------------------------------------------
----------------------------------------------------------------##-------------------------------SS--SSSSSSSSSSS--------------------------------------------------------------------------------
------------------------------------------------------------------------------------------------------------------------------------------------------------------------------------------------
--------------------------------------------------------------------------------------------------------------SS-------------------------------------------------------------------------------%
--------%%%%%%%%--------------------------------------------------------------------------------S----SSS--SSSSSS---------------------------------------SSS-----S-----QQ---------%--------------|
---------||||||------------------#------------%%-------------------------------#------------------------------##-----------y-----o----------------------------------------------|--------------|
---------||||||-------------------------------|#-----o-----------------------###----------------------------####---------##-----------------------------------------------------|--------------|
---------||||||-------------------------------|#-----%----------------------####----------------ooo--------#####--o------##----o------------------------------------------------|---------oooo-|
------%%%%%%%%%%----------######--------------|#-----|---------------------#####--TT----TT------SSSS---TT--#####--SS----##---------------------o------------S@So-##-------------|-------%%%%%%-|
-------||||||||------------------------------###-----|--------------------######--TT----TT-----TT------TT--#####-------###--------TT-----------------------------##----tt----#--|--------||||--o
-------||||||||--------------------------#---###-----|-------------------#######--TT----##-----TT------TT--#####------####--------TT----#------------------------##----tt----#--|--------|||%%%%
-------||||||||-------------------------##-----#-----|---------#-----k--########--TT----##-----TT------TT--#####-----#####--------TT----#---oooo--ggg-----------###----tt--#-#--|--rr----|||-||-
XXXXXXXXXXXXXXXXXXXXXXXXXXXXXXXXX%XX-XXXXXXX-----%%%-|-%%XXXXXXXXXXXXXXXXXXXXXXX-XXXXXXXXXX----XXXXXXXXXXXXXXXXXXXXXXXXXXX--XXXXXXXXXXXXXX---XXXXXXXXXXXXXXXXXXXXXXX-XXXXXXXXXXX|%%%%%%%%%%%-||-
XXXXXXXXXXXXXXXXXXXXXXXXXXXXXXXXX|X--XXXXXX-------|--|-||--X-XXXXXXXXXXXXXXXXXXXXXXXXXXXXXX----XXXXXXXXXXXXXXXX-XXXXXXXXXX--XXXXXXXXXXXXXXX--XXXXXXXXXXXXXXXXXXXXXXX-XXXXXXXXXXX|-|||||||||--||-
