------------------------------------------------------------------------------------------------------------------------------------------------------------------------------------------------
------------------------------------------------------------------------------------------------------------------------------------------------------------------------------------------------
------------------------------------------------------------------------------------------------------------------------------------------------------------------------------------------------
--------------------------------SSSSSSSSSSSSSSSS--------------------------------------------------------------------------------SSSSSSS---------SSSSSSSSSSSSSSSS----------------SSSSSSSSSSSSSS--
--------------------------------S---------------------------------------------------------------------------------------------------------------------------------------------------------------
--------------------------------------------o--------------------------------------Q---S----------o---------------------------------------------------------------------------------------------
--------%%%%%%%%----------------------------SS---------------------------------------Q-Q-----------------------------QQQQS-----------------#----------------------------------------------------
---------||||||-----------------------------S----------o---o-------------------------------------------------------------------------------#---------------#------------------------------------
---------||||||-----------------------------------%%%%%%---%---------------------------------US---------------------oo--------------------####-------------#------------------o----------SSS-SSS
---------||||||----------ooo-----------TT----------||||----|------------------------------ooSS---------TT---------------------------------###---S---------#---SS--------------------------------
------%%%%%%%%%%-ooo------%------------TT-----TT---||||----|-------------TT-----Q##---@#----SSS------SoTT--------##--SS-----S@S----------####------------#-------------------SS-----------------
-------||||||||-----------|------------TT-----TT---||||----|-------------TT-----###-------------TT-----TT---TT---#-----K--------o---o---####-----------###--------------------------------------
-------||||||||-----------|------------TT-----TT---||||--K-|-------------TT-----###-------------TT-----TT---TT------------------%------######---------####---#----------------------------------
-------||||||||-----------|----------k-TT-----TT---||||----|---o---k-----TT-----####--------k---TT---k-TT---TT-----k---k----k---|-----######---------#####---#-----k-----------------------kkkk-
XXXXXXXXXXXXXXXXXXXXXXXXXXXXXXXXXXXXXXXXXXXXXXXX---||||--%%%%%%%XXXXXXX-XXXXXXXXXXXXX-XXXXX-XXXXXXXXXXXXXXXXXXXXXXXXXXXXXXXXXXXXXXXXXXXXXXXX---XXXXXXXXXXX-X-XXXXXXXXX------XXXXXXXXXXXXXXXXXXXX
XXXXXXXXXXXXXXXXXXXXXXXXXXXXXXXXXXXXXXXXXXXXXXXX---||||---|||||-XXXXXXX-XXXXXXXXXXXXX-XXXXX-XXXXXXXXXXXXXXXXXXXXXXXXXXXXXXXXXXXXXXXXXXXXXXXX---XXXXXXXXXXX---XXXXXXXXX-----XXXXXXXXXXXXXXXXXXXXX
