-----------------------------------------------------------------------------------------------------S-SSS--------------------------------------------------------------------------------------
----------------------------------------------------------------------------------------------------SS-SSS--------------------------------------------------------------------------------------
---------------------------------------------------------------------------------##--------------------S----------------------------------------------------------------------------------------
------------------------------------------------SSSSSSSSSSSSSS--------SSS--SSSS-##------------------------------SS--------------SSS------------S------------------------------------------------
------------------------------------------------S-------------------------------##--------------g------SSSS-------------------------------------------------------------------------------------
------------------------------------------------------------------------------------------------#Q-@-@SSSS@-------------------------------------------------------------------------------------
--------%%%%%%%%--------------------------SSS-----------o------o-------------------------------#-----------------Soo---ooo-----o------------------------------------------------%%%%------------
---------||||||--------------------------------------------------o--------##------------------##--------------------------------SS------------S%---------------------------------||-------------
---------||||||-----------------------------------------------------------##---------------#####-----------------------------------------------|---------------------------------||-------------
---------||||||----------------------------------------------------------###------g-#------#####----------ooo------o-----------o----#----------|-------------------------o-o-----||-%%%%%%------
------%%%%%%%%%%----------######--------------##------------------TT-----###-#----####----######-U-o--U@-----------S-----------------------#-###TT-------------------------------||--||||-------
-------||||||||-------------------------------##------------------TT--y####--#---TT------#######--------------------------------o----------#-###TT----K-TT----K------------------||--||||-------
-------||||||||-----------------------tt-----###------------------TT--########---TT------#######--------------------------------#------#-#-#####TT------TT-----------------------|o--||||-----TT
-------||||||||-----------------------tt-----###-----g------------TT#######-##---TT------#######-----------------#---kok--g-----#-----##########TT----k-TT--k-------------------%%%%-||||-----TT
XXXXXXXXXXXXXXXXXXXXXXXXXXXXXXXXXXXXXXXXXXXXXXXXXXXXXXXXXXXXXXXXXXXXXXXXXXX-XXXXXXXXXXXXXXXXXXXXXXXXXXK---------XXXXXXXXXXXXXXXXXXXXXXXXXXXXXXXXXXXXXXXXXXXXXXXXXXXXXXXXXXXXXXXX-||--XXXXXXXXXXX
XXXXXXXXXXXXXXXXXXXXXXXXXXXXXXXXXXXXXXXXXXXXXXXXXXXXXXXXXXXXXXXXXXXXXXXXXXX-XXXXXXXXXXXXXXXXXXXXXXXXX-X---------XXXXXXXXXXXXXXXXXXXXXXXXXXXXXXXXXXXXXXXXXXXXXXXXXXXXXXXXXXXXXXXX-||--XXXXXXXX--X
