------------------------------------------------------------------------------------------------------------------------------------------------------------------------------------------------
------------------------------------------------------------------------------------------------------------------------------------------------------------------------------------------------
------------------------------------------------------------------------------------------------------------------------------------------------------------------------------------------------
--------------------------------------------------------------------------------------------------------------------------------SSSSSSSSSSSSSSSS------------------------------------------------
------------------------------------------------------------------------------------------------------------------------------------------------------------------------------------------------
----------------------%%%%%%-----------------------------------------------------------------------------------------------o--------------------------------------------------------------------
--------%%%%%%%%%%%----||||-----------------------------------------QQQQQS----------------------------------------------------------------------------------------------------------------------
---------|||||||||-----||||--%%%-----------------------------------------------------------------------------------------------------------------------------------------------#----------------
---------|||||||||-----||||---|-----------#--------------------------------------------------------------------------------------------------------------------------------#--------------------
---------|||||||||--%%%%|||---|-----------#--------------------------------------------o---SSSSS---------------------------------------------------------------------------#--------------------
------%%%%%%%%%%%|---||-|||---|---------###----------------------##----#Q-------------SS---SS-----#--------------------------------------SS-----------------SoS--###-----###--------------------
-------|||||||||o|---||-|||#--|--------####----------------------##------------------------S-----##--------------------------------------SS----------------------###----###---------------------
-------|||||||||%o---||-|###--|-------#####----------------------###-----------------------S-----###-------------------------------------TT----------------------##----####---------------------
-------|||||||||%%%%-||-|###--##-----#####------------------k-k--###--k--------------------S---#-###-------k--------------##------k------TTooooo--ggg----------k-##k--#####----k-------------g-g
XXXXXXXXXXXXXXXX-||--|XXXXXXXXXX-XXXXXXXXX------XXXXXXXXXXXXXXXXXXXXXXXXXXXXXXXX-----S----SSSS-XXXXXXXXXXXXXXXXXXXXXXXXXXXXXX-XXXXXXXXXX-XX--XXXXXXXXXXXXXXXXXXXXXXXXXXXXXX-XXXX----------XXXXXX
XXXXXXXXXXXXXXXX-||--|XXXXXXX-XXXXXXXXXXXX------XXXXXXXXXXXXXXXXXXXXXXXXXXXXXXXX-------------X-XXXXXXXXXXXXXXXXXXXXXXXXXXXXXX-XXXXXXXXXX-X---X-XXXXXXXXXXXXXXXXXXXXXXXXXXXX-XXXX----------XXXXXX
