-----------------------------------------------------------------------------------------------------------------------------------------------------S-S----------------------------------------
-----------------------------------------------------------------------------------------------------------------------------------------------------SSS----------------------------------------
----------------------------------------------------------------------------------------------------------------------------------------------------%%%-----------------------------------------
-----------------------------------------------------------------------------------------------------------------------------------------------------|------------------------------------------
-----------------------------------------------------------------------------------------------------------------------------------------------------|------------------------------------------
-----------------------------------------------------------------------------------------------------------------------------------------------------|------------------------------------o-----
--------%%%%%%%%-------------------------------o---------------------------------------------------------------#-----------------------%S------------|-------------------------o----------------
---------||||||--------------------------------------------------------------------------------#---------------#%%%----------------%%%-o---------%%%-|oo---oo-------------------------------K---
---------||||||-------------------------------SS-----------------------------------------------#--------------##-|------------------|--|----------|--|%%%-%%%%---------------o------------------
---------||||||--------------------------------------##---------------------------------------##-o------------##-|------------------|--|----------|--|-|---||-----------------------------------
------%%%%%%%%%%----------######--------------S-------#--------------------------------------###--------------##-|------------------|--|----------|--|-|---||---%----------SSS------------------
-------||||||||-------------------------------------------------------------------------TT---###-------------###-|------------------|--|----------|--|-|---||---|-------------------------------
-------||||||||--------------------------TT---------------------------------------TT----TT--####-------------###-|------------------|--|----------|--|-|---||---|-------------------------------
-------||||||||--------------------k-----TT--------------------------------kkk----TT----TT--####------------####-|--------#----#----|--|-------#--|--|-|--rr|--#|-------------------------------
XXXXXXXXXXXXXXXXXXXXXXXXXXXXXXXXXXXXXXXXXXXXXXXXXXXXXXXXXXXXXXXXXXXXXXXXXXXXXXXXXXXXXXXXXXXXXXXXXXXXXXXXXXXXXXXX-|---XXXXXXXXXXXXXXXXXXXXXXXXXXX-SS--|%X%%%%%--X|%%%%%%%---XXXXXXXXXXXXXX-------
XXXXXXXXXXXXXXXXXXXXXXXXXXXXXXXXXXXXXXXXXXXXXXXXXXXXXXXXXXXXXXXXXXXX-XXXXXXXXXXXXXXXXXXXXXXXXXXXXXXX-XXXXXXXXXX--|---XXXXXXXXXXXXXXXXXXXXXXXXXXX-----||X-XXX--XX|-|||||----XXXXXXXXXXXXXX-------
