------------------------------------------------------------------------------------------S-----------------------------------------------------------------------------------------------------
-------------------------------------------------------------------k-----------------SS---------------------------------------------------------------------------------------------------------
------------------------------------------------------------------------------------------------------------------------------------------------------------------------------------------------
--------------------------------------------------------------------------------------------------------------------------------------------------------------------------------SSSSSSSSSSSSSSSS
--------------------------------------------------------------------------------------------------------------------------------------------------------------------------------S---------------
--------------------------------------------------------------oo--------------------------------------------------------------------------------------------------------------------------------
--------%%%%%%%%--------------------------------%%%-------%%%%%%-----S-------S--S--2---------S-----QQQQQQ------------------S----------------------------oo---S-S--------------------------------
---------||||||----------------------------------|---------||||---------------------------------------------------------------------------------SS----------------------------------------------
---------||||||----------------------------------|---------||||-------------------------------o-----------------------------------------------------oo--------------------------S---------SS----
---------||||||----------------------------------|-------oo||||----------------o----------------------------------------------------------oo---------g------------------------------------------
------%%%%%%%%%%-------------------------TT------|-----%%%%%%%K-SSSSSSSS-S-------------------SS-####---#-------------S-----------------------------S##S-----------------------------------------
-------||||||||----------#---------S-----TT------|------|||||-|-S--SS----------------------------##---------------------------------------------------------------------------------------------
-------||||||||--------###---------------TT----#-|------|||||-|-S--SS--S------------------------------------------------------------------------------------------------------------------------
-------||||||||------#-###-----------kkk-TT----#-|-r----|||||-|----k-kkS--U-k------k--------k------k--------k---g-----------------------#----------k------g--------k-----------------k-------gg-
XXXXXXXXXXXXXXXX-XXXXXXXXXXX----XXXXXXXXXXXXXXXX-%%%%%%%%||||-|-XXXXXXXXXXXXXXXXXXXXXX------XXXXXXXXXXXXXXXXXXXXXXXXXXXXXXXXXXXXXXXXXXXXXXXXXX--XXXXXXXXXXXXXXXXXXXXXXXX-XXXXXXXXXXXXXXXXXXXXXXX
XXXXXXXXXXXXXXXXXXXXXXXXXXXX----XXXXXXXXXXXXXXXX--||||||-||||-|-XXXXXXXXXXXXXXXXXXXXXX-----XXXXXXXXXXXXXXXXXXXXXXXXXXXXXXXXXXXXXXXXXXXXXXXXX-X--XXXXXXXXXXXXXXXXXXXXXXXX-XXXXXXXXXXXXXXXXXXXXXXX
