-----------------------------------------------------------------%---%%---------------------------------------------------------------------------------------------------------
-------------------------------------------K---------------------|---||------------------------------------------------------------------------------------------------K-----K--
-----------------------------------------------------------------|---||--------------------------------------------------------------------------------------------------------U
--------------------------------SoooS--%%%----S------------------|---||-------------------------------------------------------------------------------------------------------%-
------------------------------------Q-o-|------------------------|---||-----------------------------------------------------------------------------------------------S-------|-
---------------------------------------%%%%----------------------|---||-------------------------------------------------------------------------------------------------------|-
--------%%%%%%%%---QQQSSSSo-------------||------%%%--------------|---|r---------------oo-ooo--2%----------------------------------SSSSSSSSS---SS---------Q-QQQ----------------|-
---------||||||----------------------r--r|-------|---o-----------|%%%%%%%%----------------r--U-|---------------y---------ooo--------------------------------------------------|-
---------||||||-----------------%%%%%%%%%%-------|---------------|-||||||----------------------|-------S----------------------------------------------------------------------|-
---------||||||--------------1---||||||||----SrS-|---------------|-||||||-------------------U--|--------------##--------------------------o----------------------------r---r--@-
------%%%%%%%%%%-----------------||||||||%%%%%%%-|TT-------------2-||||||@S-----o-----------t--|-------------###-------TT---------SSSS----------QQQ-----SSSS----%%%%%%%%%%%%--%-
-------||||||||------------------||||||||-|||||--TT--------------|-||||||---TT------TT------TT-|------------###--------TT----------------------------tt----------||||||||||---|-
-------||||||||------------------||||||||-|||||--TT--------------|-||||||---TT------TT------TT-|-----------####--------TT-----#----------------------tt----------||||||||||---|-
-------||||||||------K----##-----||||||||-|||||--TT--------------|-||g||gg--TT------TT-k----TT-k---k------######-------TT---kk#----g-kR--------------tt-------g--||||||||||---|-
XXXXXXXXXXXXXXXXXXXXXXXXXXXXXXXX-|||||%%%%%%%%|-XXXXXXXXXXXXXXXXXXXXXXXXXXXXXXXXXXXXXXXXXXXXXXXX---X---XXXXXXXXXXXXXXX-XXXXXXXXXXXXXXXXXXXXXXXXXXXXXXXXXXXXXXXXX%|%%%%%||||X--|-
XXXXXXXXXXXXXXXXXXXXXXXXXXXXXXXX-|||||-||||||-|-XXXXXXXXXXXXXXXXXXXXXXXXXXXXXXXXXXXXXXXXXXXXXXXX---X---XXXXXXXXXXXXXXX-XXXXXXXXXXXXXXXXXXXXXXXXXXXXXXXXXXXXXXXXXg|-|||-||||X--|-
