-----------------------S------------------------------------------------------------------------------------------------------------------------------------------------------------------------
------------------------------------------------------------------------------------------------------------------------------------------------------------------------------------------------
------------------------------------------------------------------------------------------------------------------------------------------------------------------------------------------------
------------------------------------------------------------------------------------------------------------------------------------------------------------------------------------------------
--------------------------------------------------------------------------------------------------------------------------------#---------------------------------------------------------------
-----------------------------------------------------------------------------------------------#----------------------------------------------o-------------------------------------------------
--------%%%%%%%%--------------------------------------S--------------S---------o----------------%------%%%%S%%----------------------------------------------------------------------QQQQoSS---SS
---------||||||-------------------------------S%------o----ooo---------------------------------o|-o-----||--||-------------------oo------------o------------------------------------------------
---------||||||-----------------------------####--------------------------------------------#---|%%%----||--||------------------%%%%------------------------------------------------------------
---------||||||----------------------------#####----------SS--------------------------------#---|-|-----||--||-------------------||-------------------------------------------------------------
------%%%%%%%%%%-------------------------#######---------------------------------------###-###--|-|----%%%%%%%K%-----------------||-------%%----SSoo--------------------------------QQQQQS--S@S-
-------||||||||--------------------------#######-------------------------#-------------###-###--|-|-----|||||--|-----------------||-------||---------------------------TT----#------------------
-------||||||||-------------------------########-------------------------##-----------########--|-|-----|||||%%%-TT--------------||-------||-%%%-----------------------TT-----------------------
-------||||||||--------k---------------#########---------------o-----ggg-##----------#########--|-|-----|||||-|--TT--------------||-------#|--|---------k---------ggg--TT---kk-----k--------k---
XXXXXXXXXXXXXXXX%%%--XXXXXXX%%%%XXXXXXXXXXXXX-XX--XXXXXX----%%%%XXXXXXXXXXXXXXXXXXXXXXXXXXXXXX--%%%%%-%XXXX||-|-XXXXXXXXXXXXXXXXXXXXXXXXXXXX--|-XXXXXXXXXXXXXXXXXXXXXXXXXXXXXXXXXXXXXXXXXXXXXXXX
XXXXXXXXXXXXXXXXX|X---XXXXXX-||-X-XXXXXXXXXXX-XX--XXXXXX-----||-XXXXXXXXXXXXXXXXXXXXXXXXXXXXXXXX-|||--|XXXX||-|-XXXXXXXXXXXXXXXXX-XXXXXXXXXX--|-XXXXXXXXXXXXXXXXXXXXXXXXXXXXXXXXXXXXXXXXXXXXXXXX
