---------------------------------------------------------------------------------------------------%%%--------------------------------------------------------------------------
----------------------------------------------------------------------------------------------------|----------------------------------------K----------------------------------
----------------------------------------------------------------------------------------------------|---------------------------------------------------------------------------
----------------SSSSSSSSSSSSSSSS----------------SSSSSSSSSSSSSSSS------------------------------------|----------------------------------------S%S--------------------------------
---------------------S--------o-----------------SSSSSSS---------------------------------------------|---------------------------------S-------|---------------------------------
------------------------------S-----------------SSSSS-----------------------------------------------|----------------------------------S%%%---|---------------------------------
--------%%%%%%%%----------------------Soo------%SSS-----------S-------------------------------------|------------------------------------|----|----K----------SS--------------SS
---------||||||--------------------------------B------------------------------------------------oo--|--------------------------------r---|----|---------------------------------
---------||||||------------S-----------SSSS--y-#SSS-------------------------------------------------|---------------------------%%%%%%%%-|----|---------------------------------
---------||||||---------------S-------------y###------------------------SSS-------------------------|----------------------------||||||--|-r-SS---------------------------------
------%%%%%%%%%%%--------------------SSS----####SS----------------------------#---------------------|--TT------------------------||||||--%%%%%%--------------------------------Q
-------||||||||-|--------------------------#####-----------------------------##-T-------------------TT-TT------------------------||||||---||||----------------------------------
-------||||||||-S---------%%--------------#######--------##-----------------###-T-------------------TT-TT--------------TT--B-----||||||---||||-------------------------TT--tt---
-------||||||||-----------||-------------########--------------------------####-T-----g-------------TT-TT-----------y--TT--b-----||||||---||||-------------------------TT--tt-g-
XXXXXXXXXXXXXXXX%-%%%%----%%--------XXXXXXXXXXXXX---XXX---------XXXXXXXXXXXXXXXXXX--XX---XXX---XXXXXXXXXXXXXXXXXXXXXXXXXXXXXXXXX-X||||%%%%%%%|--------X-----XXXXXXXXXXXXXXXXXXXX
XXXXXXXXXXXXXXXXg--||-----||--------XXXXXXXXXXXXX---XXX---------XXXXXXXXXXXXXXXXXX--XX--XXXX---XXXXXXXXXXXXXXXXXXXXXXXXXXXXXXXXX-X||||-|||||-|------X-X-----XXXXXXXXXXXXXXXXXXXX
