------------------------------------------------------------------------------------------------------------------------------------------------------------------------------------------------
------------------------------------------------------------------------------------------------------------------------------------------------------------------------------------------------
------------------------------------------------------------------------------------------------------------------------------------------------------------------------------------------------
---------------------------------------------------------SSSS-----------------------------------SSSSSSSSSSSSSSSS--------------------------------SSSSSSSSSSSSSSSS--------------------------------
------------------------------------------------------------------------------------------------------S-----------------------------------------------------------------------------------------
---------------------------------------------------------------------------------------------------------------S--------------------------------------------------------------------------------
--------%%%%%%%%---------------------------------ooo--SSoS-------------SSS-----------------------SSo------oo------------------------------------------------------So----------------------oo----
---------||||||----------------------------------------------------%%%%--------------------------------------------------------------------------------------------------------------------r----
---------||||||-----------------------------------------------------||----------------------------------S--S---S-------------------------------------------#-SSS----------------K--------%%%%---
---------||||||------------------------------------------------#----||--------------------------------SS---SSSoS-------------------------ooooo------------#----------------o--------------||----
------%%%%%%%%%%----------######----------%%----S--------------#----||-----------#--------------SS----------SS-----------TT-------------%%%%%%-----------###-----------------SSS%---------||----
-------||||||||---------------------------||--------------#---##----|tt----------@--------------------------------TT-----TT---TT---------||||-----------####------------------oo|---------||----
-------||||||||---------------------------||-------------##--###----|tt--#----------------------------------------TT-----TT---TT---------|||%%%%-------#####--------------------|---------||----
-------||||||||---------------------------||--------g---###-####----|tt--#-----#---k----------ko------------------TT-----TT---TT---------|||-||------#######-------------------k|---------||----
XXXXXXXXXXXXXXXXXXXXXXXXXXXXXXXX--%%%%%%%%%%%%%-XXXXXXXXXXX-XXXXXXXXXXXXXXXXXXXXXXXXXXXXXXXXXXXXXXXXXX---X-XXX--XXXXXXXXXXXXXXXX--%%-%%XXX||-||-XXXXXXXXXXXX---X-XXXXXXXXXX-XXXX|--------XXXX%%%
XXXXXXXXXXXXXXXXXXXXXXXXXXXXXXXX---|||||||||||--XXXXXXXXXXXXXXXXXXXXXXXXXXXXXXXXXXXXXXXXXXXXXXXXXXXXXX---X-XXX-XXXXXXXXXXXXXXXXX--||-||XX-||-||-XXXXXXXXXXX---XX-XXXXXXXXXX-XXXX|------X-XXXXX|X
