--------------------------------------------------------------------------------------------------------------------------------------------------------------------------------
--------------------------------------------------------------------------------------------------------------------------------------------------------------------------------
--------------------------------------------------------------------------------------------------------------------------------------------------------------------------------
----------------SSS-----------SS-------------------SS---------------------------------------------------------------------------------------------------------------------------
----------------S---------------------------------------------------------------------------------------------------------------------------------------------------------------
--------------------------------------------------------------------------------------------------------------------------------------------------------------------------------
--------%%%%%%%%---------------------------------------#-------S--------------------------o-----------r--r--------SQQQSSSSQS---%--------------------------------SS-------oo-----
---------||||||--------------------------oooo----------#----------------------------------------%%%%%%%%%%---------------------|--------------------------o---------------------
---------||||||---------------------------------S-----##--S-------------------------------S------||||||||----------------------|-------S----------------------------------------
---------||||||---------------oo---------------------###-----------------------------------------||||||||--------------------1-|------------------------------------------------
------%%%%%%%%%%--------------%%--TT-----------------###--S--------------------------------------||||||||---TT----SSooSSSSSQQ--|-------S-----#----------------------------------
-------||||||||---------------||--TT---TT----------#####----------TT-----------------------------|||TT|||---TT-----------------|------------##---------TT-----------------------
-------||||||||---------------||--TT---TT---------######----------TT-----------------------------|||TT|||---TT-----------------|-----------###------TT-TT-----------------------
-------||||||||---------------||--TT---TT--------#######----------TT-----------------------------|||TT|k|---TT--K----gg-g-##-#-|--kk---y--####------TT-TT-------------g-------gg
XXXXXXXXXXXXXXXXXXXXX-----%%--||XXXXXXXXXXXXXXXXXXXXXXXXX---XX-XXXXXXXXX--------X---XXXXX---XX-XXXXXXXXXXXXXXXXXXXXXXXXXXXXXXXXXXXXXXXXXXXXXXXXXXXXXXXXXXXXXXXXXXXXXXXX--X-----Q
XXXXXXXXXXXXXXXXXXXXX-----||--||XXXXXXXXXXXXXXXXXXXXXXXXX---XX-XXXXXXXXXX-------X---XXXXX---XX-XXXXXXXXXXXXXXXXXXXXXXXXXXXXXXXXXXXXXXXXXXXXXXXXXXXXXXXXXXXXXXXXXXXXXXXXX-XX-----
