--------------------------------------------------------------------------------------------------------------------------------------------------------------------------------
-----------------------------------------------------------------------------------------------------------------------------------------------------------------------------K--
--------------------------------------------------------------------------------------------------------------------------------------------------------------------------------
-----------------------------------------------------------------------SSS-----------------------------------------------------------2------------------------------------------
-----------------------------------------------------------------------------------k--------------------------------------------------------------------------------------------
---------------------------------------------------------------------SS---S----o--##--------------------------------------------------------------------------------------------
--------%%%%%%%%---2--@-----QSQ------------------------------------SSSSSSSS---SS------------------USQSSSSSSSSSSS-----------------------------o----------------------------------
---------||||||---------------------------------------------------------------------------------------------------------oooo--------------------------------------------r-------
---------||||||-------------------------------------------K--------SSSS---------------------------------------------------------%%%%%-----------------------------------%-------
---------||||||----g-----------------------------------------------SSSS---ooo----------------------------------------------------|||-----------------------------------r|-------
------%%%%%%%%%%--SQ------%%---S------------------------------------SSSS-SSSSSSS--------------------------%-2SS------------------|||------%%%%%--------SQoSSQ---%%%%%%%%%%%-%%%-
-------||||||||-----------||--------------T-------------------------------------------------##------------|----------------------|||-------|||-------------------|||||||||---|--
-------||||||||-----------||-------------TT---------tt-----------SSSSS----------------------##------------|----------------------|||-----%%%%%%%-----------------|||||||||--%|--
-------||||||||--g--------||---g-------k-TT-----K---tt-------------k---k--------gg------y-####------ggg---|---k----------T-------|||------|||||-----------y--ggg-|||||||||g-||--
XXXXXXXXXXXXXXXXXXXXXXXXXXXXXXXXXXXXXXXXXXXXXXXXXXXXXXXXXXXXXXX-X-SXXXXXXXXXXXXXXXXXXXXXXXXXXXXXXXXXXXXXXXXXXXXXXXXXXXXXXXXXXXXX-|||----%%%%%%%-X---XXXXXXXXXXXX-|||||||||-%%%--
XXXXXXXXXXXXXXXXXXXXXXXXXXXXXXXXXXXXXXXXXXXXXXXXXXXXXXXXXXXXXXXXX--XXXXXXXXXXXXXXXXXXXXXXXXXXXXXXXXXXXXXXXXXXXXXXXXXXXXXXXXXXXXX-|||-----|||||--X---XXXXXXXXXXXX-|g|||||||--gg--
