-------------------------------------------------------------------------------------------------------------------------------------------------------K----------------------------------------
-------------------------------------------------------------------------------------------------------------------------------------------------------o----------------------------------------
-------------------------------------------------------------------------------------------------------------------------------------------------------%%---------------------------------------
-------------------------------------------------------------------------------------------------------------------------------------------------------||----------------------S----------------
-------------------------------------------------------------------------------------------------------------------------------------------------------||---------------------------------------
-------------------------------------------------------------------------------o--oo------oooooo--------------------------------ooooo-------oooo-------||---------------------------------------
--------%%%%%%%%------------------------------------------------S---------------%%%%%-----%%%%------------o--------------------------------------------|%%--------------------------------------
---------||||||------------------------o----oo------------------------oo---------|||-------||--------------r---------------o----------------------%%%%%%||------SSS--------o--------------------
---------||||||------------------------#-------------U---------------------------|||-------||-------------%%---------------------------------------||||-||----------------%%--------------------
---------||||||------------------------------------------------------------o-----|||-----oo||-------------||-------------#SS-------------oo--------||||-||----------------||--------------------
------%%%%%%%%%%----------######---------------------------------SSo-----%%%-----|||--%%%%%%%%%%----------||------------##---------------%%%%%--%%-||||-||----------------||--------------------
-------||||||||-----------------------------------------------TT----------|------|||---||||||||-----------||-----------##-----------------|||---||-||||-||----------o-----|SS-------------------
-------||||||||------------------------------------------TT---TT----------|------|||---||||||||-----------||----------####----------------|||---||-||||-||---------%%%----|---------------------
-------||||||||---------------------------------k--------TT---TT--or------|------|||---||||||||-----------||---o-----#####---k------------|||---||ro|||-||----------|-----ooo-------------------
XXXXXXXXXXXXXXXXXXXXXXXXXXXXXXXXXXXXXXX---X-----XXXXXXXXXXXXXXXX-%%%%%%%--X--%%%%%%%%%%%%XXX|||---XXXX----||-%%%XXXXXXXXXX--XXXXXX%XXXXXXXXXXXXX%%%%%%%%%|%%%%%%XXXX|XXXX%%%%%--XXXX--XXXXXXXXXX
XXXXXXXXXXXXXXXXXXXXXXXXXXXXXXXXXXXX-XX---X----XXXXXXXXXXXXXXXXX--XX|||-------||||||||||--XX|||---XXXX----||--|-XXXXXXXXXX--XXXXXXXXXXXXXXXXX-X--|||||||-|-||||-XXXX|XXXX-|||--XXXXX--XXXXXXXXXX
