------------------------------------------------------------------------------------------------------------------------------------------------------------------------------------------------
------------------------------------------------------------------------------------------------------------------------------------------------------------------------------------------------
------------------------------------------------------------------------------------------------------------------------------------------------------------------------------------------------
----------------------------------------------------------------------------------------------------------------------------------------------------------------SSSSSSSSSSSSSSSS----------------
------------------------------------------------------------------------------------------------------------------------------------------------------------------------------------------------
----------------oooo------------------------------------------------------------------------------------------------------------------SS--------------------------------------------------------
--------%%%%%%%%-------------------Q-----------o--oo----------------------------------------------------------------------------------SS-----------------------------------------------SSS------
---------||||||-----------------------------------------------------------------------------------------------%%----------------------2----ooo---------o------------------------------oo---ooo--
---------||||||------------------------------S----------------------------------------------------------------#|--------------------------------------------------------------------------------
---------||||||----------------------------------------------------------------o-------------------------------|-------------------------#SS-SS-------------------------------------------------
------%%%%%%%%%%-----2---------###Qo---------S--SS---------------SSSSS#------S-----SS------------------#-----#-|---------TT-------------##---------------------------------------------QQ-------
-------||||||||---------TT----TT------------------------------------------------S--SSSSSS------------------#-#-|---------TT------------###------------------------------------------------------
-------||||||||---TT----TT----TT--------------------------------TT-----------------SSSS-#------------------#-##|---------TT-----------####-------------------K----------------------------------
-------||||||||---TT----TT----TT---k-g--------------------------TT--------U-----SSSSSSS-#--------------------##|---------TT--------#--####-------------k---k-k--k-k------k----g-----------------
XXXXXXXXXXXXXXXXXXXXXXXXXXXXXXXXXXXXXXXXXXXXXXXX-XXXX-XXXX---XXXXXXXXXXXXXXXXXXXXXXXXXXXXXX-XXXXXX%%---XXXXX-XX|XXXXXX--XXXXXXXXXXXXXXXX@X-----XXXXXXXXXXXXXXXXXXXXXXXXXXXXXXXXXXXXXXXXXXX---XXX
XXXXXXXXXXXXXXXXXXXXXXXXXXXXXXXXXXXXXXXXXXXXXXXXXXXXX-XXX----XXXXXXXXXXXX-XXXXXXXXXXXXXXXXX-XXXXXX||---XXXXX--X|XXXXXX--XXXXXXXXXXXXXXXXXX-----XXXXXXXXXXXXXXXXXXXXXXXXXXXXXXXXXXXXXXXXXXX--XXXX
