------------------------------------------------------------------------------------------------------------------------------------------------------------------------------------------------
------------------------------------------------------------------------------------------------------------------------------------------------------------------------------------------------
------------------------------------------------------------------------------------------------------------------------------------------------------------------------------------------------
---------------------------------------------------------------------SSSSSSS----SSSSSSSSSSSSSSSS----------------SSSSSSSSSSSSSSSS----------------SSSS--------------------------------------------
--------------------------------------------------------------------------------SS--SSSS--------------------------------------------------------------------------------------------------------
--------------------------------------------------o-----------------------------SSS--SS------SSS------------------------------------------------------------------------------------------------
--------%%%%%%%%--------------------------%%%%%%------------------------o--------SSSSSS-----oSSS--------------------------------------SS--------------------------------o-----------------------
---------||||||----------------------------||||-------------------------------------------------------------------------------------------------------------------------------------------------
---------||||||----------------------------||||----------------------------------------------------------------------------#--------------------------------------------------------------------
---------||||||----------------------------||||---------------------------------TTooo------------oo------------------------#----S---------------------------#-----------------------------------
------%%%%%%%%%%----------######-------%%%%%%%%--------------------SS---###-----TTSSSS-----------------------#------------##------------------------------####--QQQo-SSQS-----------------------
-------||||||||-------------------------||||||----TT--------------------###-----TT---K--TT-------------TT----#-----------###-----------o-----------------#####----------------------------------
-------||||||||-------------------------||||||----TT------------------#####-----TT------TT-------------TT---##----------####----------##---------------#########--------------------------------
-------||||||||-------------------------||||||----TT------------------#####-----TT---kk-TT--k-----g--#-TT---##----g----#####-------#--##--------g-----########-#--------------------------------
XXXXXXXXXXXXXXXXXXXXXXXXXXXXXXXX%%%%%X%XXXX|||--XXXXXXXXX-XXXXXXXXXXXXXXXXXXXXXXXXXXXXXXXXXXXXXXXXXXXXXXXXXXXXXXXXXXXXXXXXXXX-XXXXXXXXXXXXXXXXXXXXXXXXXXXXXXXXXX--XX--XXX----XXXXXXXXXXXXXX--XXX
XXXXXXXXXXXXXXXXXXXXXXXXXXXXXXXX-|||--|-XXX|||--XXXXXXXXX-XXXXXXXXXXXXXXXXXXXXXXXXXXXXXXXXXXXXXXXXXXXXXXXXXXXXXXXXXXXXXXXXXXX-XXXXXXXXXXXXXXXXXXXXXXXXXXXXXXXXXX--XX--XXX----XXXXXXXXXXXXXX--XXX
