---------------------------------------------------------------------------------------------------------------------------------------------------------------------------------------k--------
--------------------------------------------------------------------------------------------------------------------------S---------------------------------------------------------------------
--------------------------------------------------------------------------------------------------------------------------S---------------------------------------------------------------------
----------------SSSSSSSSS------S----------------------------------SSSSSSSSSSSSSS--------------------------------SSSSSSSSSSS---SS--------------------------------SSS-----------------------------
----------------S-----------------------------------------------------------------------------------------------SS-----S--S--SSS---------------------------------------------------------------o
----------------------------------------------------------------------------------------------------------------SS---S----oooSSS---------------------------------------------------------------%
--------%%%%%%%%--------%--S--------------------------SSSS-------So----------------------------------------------SS-SSSS--SSSSSS---------------------------------------S-------S%%--------%%%%-|
---------||||||---------|--------------------------------------#--------------------------------------------K-------------------------oo--oooo----------------o-----------------||---------||--|
---------||||||-#-------|------------------#------------------##-------------SSS-----------------------------------------------------------------S------------------------------||---------||--|
---------||||||---------|------------------#------------------##-----------------------------------------------------------------S------------------------------S---#-----------||-----oooooo--|
------%%%%%%%%%%--------|------------------#-------------------#---SS----#-----------------------S-------------------2----------------------------------------------------------%%----%%%%%%%--|
-------||||||||-o-------|--------------o#--#------------------##---------#--------------------------------------TT--------------------------------SSSSS----------------------#--||-----|||||---|
-------||||||||-%-----tt|--------------##--#-#----------------##--------##-----------------------------TT-------TT-----TT-------------------------SSSSSSS-@-----------------###-||-----|||||---|
-------||||||||-|-----tt|--#---------####--------------------###-------###--k----------------oo--------TT-------TT-----TT---#-#------------r------SSSSSSS-U----------------#####||rrr--|||||---|
XXXXXXXXXXXXXXXXXXX-XXXXXXXXX--XXoXXXXXXXXXXXX--XXXXXXXXXXXXXXXXXXXXXXXXXXX-XXXX-XXXXXX------%%XXXXXXXXXX-XX-X--XXXXXXXXXXXXXXXX--S%----S%%%%SSSXXXXXXXXXXX-XXXXXXXXXXXXXXXXXXXX%%%%%%%%%|||%%%%
XXXXXXXXXXXXXXXXXXX-XXXXXXXXX--XXXXXXXXXXXXXXX--XXXXXXXXXXXXXXXXXXXXXXXXXXXXXXXX-XXXXXX------||XXXXX-XXXX-XX-X--XXXXXXXXXXXXXXXX---|------||----XXXXXXXXXXX-XXXXXXXXXXXXXXXXXXXX-|||||||-|||-||-
