---------------------------------------------------------------------------------------------------------------------------------------------------------------------SS-S-----------------------
---------------------------------------------------------------------------------------------------------------------------------------------------------------------SSSSSS---------------------
------------------------------------------------------------------------------------------------------------------------------------------------------------------------------------------------
----------------SSSSSSSSSSSSSSSS--------------------------------SSSSSSSSSSSSSSSSSSSSSSSS---SSSSS-------------------------------------------------SSSSSSSSSSSSSSS----------------SSSS------------
----------------S----SS%----------------------------------------------------------------------------------------------------------------------------------------g------S------------------------
----------------S-o----|---------oo------o------o--------------o-------------------------------------------------------------------------------------------#-----Q-Q---SS-@---------------------
--------%%%%%%%%-%%%---|--oo------------------------QQQQ---------------SSSSS------------------------------------------------------o------------------------#--o---------------------------------
---------||||||---|----|----------------------------------------------------------------------------------------------------------------------------------##--#------------oo-------------------
---------||||||---|----|------------------------------------------------------------#------------------TT------------------------------------------------###------------------------------------
---------||||||---|----|------------------------------------------------------------#------------------TT-----------------oo----------------------------####---o-----------o--------%%%%--------
------%%%%%%%%%%%%|----|----------TT-U--TT-------2----------S------------------------------------------##---------------%%%%%%-----------#-------------#####---S-------@-------------||---------
-------||||||||||-|----|----------TT----TT-------------------------------------------------------------------------------||||--o---------#------------y#####-#-----------------------||---------
-------||||||||||-|----|----------TT----TT---TT----------------------------#---#--------##-------------------------------||||-------#----------------#######-#-----------------------||---------
-------||||||||||-|----|-------#--TT----TT---TT---gggggg-------k----------##---#------####-----#-------------------------||||-------#---------------########-#------------------%%%--||-------kg
XXXXXXXXXXXXXXXX|-|----XXXXXXXXXXXXXXXXXXXXoXXXXXXXXXXXXXXXXXXXXXXXXXXXXXXXXXXXXXXXXXXXXXXXXXXXXXXXXXXXXXXXXXXXX%%%%%%%%%%XX|-XXXXXXXXXXXXXXXXXXXXXXXXXXXX--XXXX--XX--X--S-------|---XXXXXXXXXXX
XXXXXXXXXXXXXXXX|-|----XXXXXXXXXXXXXXXXXXXXXXXXXXXXXXXXXXXXXXXXXXXXXXXXXXXXXXXXXXXXXXXXXXXXXXXXXXXXXXXXXXXXXXXXX-||||||||-X-|-XXXXXXXXXXXXXXXXXXXXXXXXXXXQ---XXX-XXX-------------|---XXXXXXXXXXX
