------------------------------------------------------------------------------------------------------------------------------------------S-----------------------------------------------------
---------------------------------------------------------------------------------------------------------------------------------K-K------------------------------------------------------------
------------------------------------------------------------------------------------------------------------------------------------------------------------------------------------------------
----------------------------------------------------------------------------------------------------------------SSSSSS--------------------------------------------------------------------------
------------------------------------------------------------------------------------------------------------------------------------------------------------------------------------------------
-------------------------------------------------------------------------o----------------oooooo------------------------------------------------------------------------------------------------
--------%%%%%%%%------SSSS----oo-------o-------o--------------------------------%--------%%%%%%-------SSS--------SSSSSSS---#---SSSSSSSSS-----SSS-------S%S--------S@-------------------oo------S
---------||||||----------------------------------------o---r-------------------o|---------||||-----------------------------#----------------------------|-----------------------S---------------
---------||||||------------------------------SSS------%%%%%%%-------------------|---------||||-#---------------------------#---S------------------------|---------------------------------------
---------||||||-----------------------------oS---------|||||--------------------|---------o|||-#S--------------S--ooo-----##--oo---ggg-------ooo--------|-ooor-------------------o--------------
------%%%%%%%%%%----------------####--QQQ---SSSS-------|||||--------------------|------%%%%%%|-SS-------#------SSSSSSS----##----SSSSSSS------SSS%-------%%%%%%S-QSQQ-SS@SSSSS@S--SS-------------
-------||||||||-----------------####-------------------|||||--------------------|-------||||-|---------##----------------###----S---S-----------|--------||||-oo--------------------------------
-------||||||||---###-----------####-------------------|||||--------------------|-------||||-%%%-----####----U-----------##------------S--------|--------||||%%%-----------------#--------------
-------||||||||---###-----------####------kkk----------|||||---o--g-------------|-oo---rr|||--|-----#####----#--------g####-----------kS----k---|--------||||-|------------------#-k--------k---
XXXXXXXXXXXXXXXXXXXXXXXXXXXXXXXXXXXX-XXXXXXXXXXX--XXXXXXXXXXX%%%X%XXXXXXXXXX----%%%%%%%%%%%%--|-XXXXXXXXXX-XXXXXXXXXXXXXXXXXXXXXXXXXXXXXXXX-XXXX|----%%--||||-|--XXXXXX-XXX-XXXXXXXXXXXXXXXXXXXX
XXXXXXXXXXXXXXXXXXXXXXXXXXXXXXXXXXXX-XXXXXXXXXXX--XXXXXXXXXX--|-XXXXXXXXXXXX-----||||||||||---|-XXXXXXXXXX-XXXXXXXXXXXXXXXXXXXXXXXXXXXXXXXX-XXXX|----||--||||-|--XXXXXX-X-X-XXXXXXXXXXXXXXXXXXXX
