------------------------------------------------------------------------------------------------------------------------------------------------------------------------------------------------
----------------------------------S-------S-----------------------------------------------------------------------------------------------------------------------------------------------------
------------------------------------------------------------------------------------------------------------------------------------------------------------------------------------------------
--------------------------------SSSSoooooooo---SSSSSSSSS------------------------SSSS----------------------------------------------------------------------------SSSSSSSS--S----S----------------
-----------------------------------%%%%%%%%%----------------------------------------------------------------------------------------------------------------------------------------------------
------------------------------------|||||||----------------------------------------------------------------------oo-----------------------------------------------------------------------------
--------%%%%%%%%--------------------|||||ooS----------------------------o---------------oo-------------S--------%%%---------------------SSSSSS--------------------------------------------------
---------||||||---------------------|||r|||-------------------------------------S--------------------------------|---------------------------------------------o--------------------------#-----
---------||||||--------------------SSS%%%%%%%%S---------------------------------S--------------------------------|-----------------------------------------#-----------------------------##-----
---------||||||-----------------S------||||||--------------------------------------------------------------------|----------------------------------------###---------------------TT----###-----
------%%%%%%%%%%----------######SS-----||||||-----------------------------------------------------------SS%S-----|-------------------------SSS-----------TT-----------------------TT----TT------
-------||||||||------------------------||||||----#-----o--------------------------------------------------|------|---------------------------------------TT----o--------TT--------TT----TT--TTTT
-------||||||||------------------------||||||----##-------------------------------------------------------|-----oo------------TT-------------------------TT--#----------TT----TT--TT--####--TTTT
-------||||||||------------------------||||o|---###---kk----gggg-----kkk--g-k-k-------------kggg---r------|-----%%------g-----TT--------------------ggg-########--g-----TT----TT--TT--####--TTTT
XXXXXXXXXXXXXXXXXXXXXXXXXXXXXXXX-----XXXXXXXX--XXXXXXXXXXXXXXXXXXXXXXXXXXXXXXXXXXXXXXXXXXXXXXXXX--%%%-XXX-|-----|%---XXXXXXX--XX--%%%%%%%%%%%%%%XXXXXXXXXXXXXXXXXXXXXXXXXXXXXXXXXXXXXXXXXXXXXXXX
XXXXXXXXXXXXXXXXXXXXXXXXXXXXXXXX-------X-XXX--XXXXXXXXXXXXXXXXXXXXXXXXXXXXXXXXXXXXXXXXXXXXXXXXXX--XX--XXX-|-----||---XXXXXXX---X---||||||||||||-XXXXXXXXXXXXXXXXXXXXXXXXXXXXXXXXXXXXXXXXXXXXXXXX
