------------------------------------------------------------------------------------------------------------------------------------------------------------------------------------------------
------------------------------------------------------------------------------------------------------------------------------------------------------------------------------------------------
-------------------------------------------------------------SSS--------------------------------------------------------------------------------------------------------------------------------
------------------------------------------------SSSSSSSSSSSSSSSS--------------------------------SSS------------S--------------------------------------------------------------------------------
------------------------------------------------SSS---SS------------------------------------------------------%%---------g-----------------------------------------------------2----------------
-----------------------------------------------------SSS---SSSSS----------------------------------------------||--------------------------------------------------------------------------------
--------%%%%%%%%SSS-----------------------------S-----------SSSS-------------------------------#--------------||------SSSS----@-----------------SSSSSSSS-------------------------------%%-------
---------||||||---------------------------------------------------------------------------#y--##%%%-----------|%-------o-------------ooo---o-------------------------------------------||-------
---------||||||--------S%%%%-----------TT----------------------S--------------------------######-|---o----%%%%%|----------------------%%%----------------------------------------------||-------
---------||||||-o--------||----o-------TT--SSSS-Soooo--------ooo-------------------------#######-|--%%%----|||-|-------k---------------|--oo------------------oo----------oooS---------||--o-SS-
------%%%%%%%%%%---------||------------##--S----SSSSSS-------SSS---------TT-------------########K|---|-----|||-|-ooo---Q-----SS--------|--%%--------S--------SSSSSS-------SSSS---------||-%%%---
-------||||||||----------||----------------S----S------------------------TT------------#########o|---|-----|||-|-----------------------|--||-------------------------------------------||--|----
-------||||||||----------K|----------------S----S------------------------TT-----------#########-%%---|-----|||-|-----------------------|--||-K-----------------------------------------||--|----
-------||||||||-----gk---#|-------#--------k----k-------k--------g-ggg---TT----------##########-||---|-----|||ro---k----------------r--r--||--------------k--------------------r--%%%--||--|----
XXXXXXXXXXXXXXXX--XXXXXXXXXXXXXXXXXX------------XXXXXXXXXXXXXXXXXXXXXXXXXXXXXXXXXXXXXXXXXXXXXXX-||---|---X%%%%%%XXXXXXXXXX--XXXX---%%%%%%%%%%---XXXXXXXXXXX-XXXX-%%%%%%------%%%---|--XXXX-|-%--
XXXXXXXXXXXXXXXX--XXXXXXXXXXXXXXXXXX-----------XXXXXXXXXXXXXXXXXXXXXXXXXXXXXXXXXXXXXXXXXXXXXXXX-||---|-X-X-||||-XXXXXXXXXX--XXXX----||||||||----XXXXXXXXXXX-XXXX--||||--------|----|-XXXXX-|-|--
