----------------------------------------------------------------------------------------------------------------------S-------------------------------------------------------------------------
--------------------------------------------------------------------------S---------------------------------------------------------------------------------------------------------------------
------------------------------------------------------------------------------------------------------------------------------------------------------------------------------------------------
----------------------------------------------------------------SSSSSSSSSSSSSSSS----------------SSSSSSS--------S-SS---o-------------------------------------------------------------------------
------------------------------------------------------------------------------------------------------------------S--SSS------------------------------------------------------------------------
---------------------------------------------------------------------------------------------------------------------------------oo-------------------------------------------------------o-----
--------%%%%%%%%-@----SSQS-----------------------------QQ------------SS-----SS-------SSS---#-------------------S----------------%%%%------------%%%%-------------------SS-----------------------
---------||||||----------------------------------------------------------------------------#-------------------------------------||--------------||-------------SS----oo---ooo---o--------K-oo--
---------||||||------------------------TT-------------------------------------------------##---S---------------------------------||--------------||---------------------------------------#-----
---------||||||--------g---------------TT-----------------SSSSSS----gg-------------------###------------------------o------------||------ooooo---||--------------------k----SS-----------##-----
------%%%%%%%%%%-So-SS@QQ---SQS--------##-------------------------SSSS#-----------------####----------------------SSSSS----------||-----%%%%%%---||-------------------SSo---------TT----TT------
-------||||||||-----------------------------------SS-------------------K---------------####--#-----------------------------------||------||||-oo-||-----TT----TT------------------TT----TT------
-------||||||||-------------------#---------------------------------------------------########-----------------#-----------------||------||||%%%-||-----TT----TT------------------TT--####------
-------||||||||----k--------------##-------k------SkS---k-------k----kk-----k--------#######-#---------------g-#------------koko-||r----r|r||-|--|k-----TT----TT------------------TT--####---k--
XXXXXXXXXXXXXXXXXXXXXXX-XXXXXXXXXXXXXXXXXXXXXXXXXXXXXXXXXX--XXXXXXXXXXXXXXXXXXXXXXXXXXXXXXX-XXXXXXXXXXXXXXXXXXXXXXXXXXXX-XXXXXXX-%%%%%%%%%%%%-|-XXXXXXXXXXXXXXXXXXXXX-XXXXXXXXXXXXXXXXXXXX---X--
XXXXXXXXXXXXXXXXXXXXXXX-XXXXXXXXXXXXXXXXXXXXXXXXXXXXXXXXXX--XXXXXXXXXXXXXXXXXXXXXXXXXXXXXXX-XXXXXXXXXXXXXXXXXXXXXXXXXXXX-XXXXXXX--||||||||||--|-XX-XXXXXXXXXXXXXXXXXX-XXXXXXXXXXXXXXXXXXXXX--X-X
