--------------------------S---------------------------------------------------------------------------------------------------------------------------------------------------------------------
-------------------------SS---------------------------------------------------------------------------------------------------------------------------------------------------------------------
------------------------------------------------------------------------------------------------------------------------------------------------------------------------------------------------
----------------SSSS-SSSSSSSSSSSSSSSSSSSSSSSSS-----------------------------------------------------------------------------------SSSS-----------------------------------------------------------
------------------S---SS-----SSS----------------------------------------------------------------------------------------------------------------------------------------------------------------
---------------------SSS----SSSS------------------o---------------------------------------------------------------------------------------------------------------------------------------------
--------%%%%%%%%SSSSSSSSo---SSSS--------o------------------------oo---SSS-----o---------SS-----o---------------o------------------------S-----------SQooo------------SSS--------%---------------
---------||||||-S-----------------------------------------------------K------------------------#-----------------------o----------S%%%%--------------------------#--------------|------o--------
---------||||||-----------------------------------------------------------#---SS---------------#-------------oS-----------------S---||------------------------------------------|---------------
---------||||||----ggggo-----ooo-----------------------------------------#SS-SSS--------------##--------------------------------S---||------------------------------------------|---------------
------%%%%%%%%%-TT-SSSSSSS---SSS----------------------------------------##-----S--------------##-#-----------US---------------------||------------------------------------------|---------------
-------|||||||--TT-SSSSS--------------------------TT--------------------##-------------------###---------TT-------------------------||-----------#-----------------------TT-----|---------------
-------|||||||--TT-SS-S---------------------------TT-------------------###-------------------###---------TT-------------------------||##---------#-----------------------TT-----|-------------TT
-------|||||||--TT--------g-----###----------g-g--TT----------oo----#-####---------r---------###---kogg--TT---------g----------k----|###---------#----g-----k---------k-###-----|-------------TT
XXXXXXXXXXXXXXXXXXXXXXXXXXXXXXXXXXXXXXXXXXXXXXXXXXXXXXX---XX-XSX-XXXXXXXXX---XXX%%%%%%%%%-XX-XXXXXXXXXXXXXXXXXXXXXXXXXXXXXXXXXXXXXXXXXXXXX-X-XXXXXXXXXXXXXXXXXXXXXXXXXXXXXXXXXXXXXXXXXXXXXXXXXXX
XXXXXXXXXXXXXXXXXXXXXXXXXXXXXXXXXXXXXXXXXXXXXXXXXXXXXX-X--XX----XXXXXXXXXX---XXX-|||||||---X--XoXXXXXXXXXXXXXXXXXXXXXXXXXXXXXXXXXXXXXXXXXX-X-XXXXXXXXXXXXXXXXXXXXXXXXXXXXXXXXXXXXXXXXXXXXXXXXXXX
