--------------------------------------SS--------------------------------------------------------------------------------------------------------------------------------------------------------
------------------------------------------------------------------------------------------------------------------------------------------------------------------------------------------------
-------------------------------------SS---------------------------------------------------------------------------------------------------------------------------------------------------------
---------------------------------------------------------------------------------SS-----------------------SSSSSSSSSSSSSSSSSSSSSS--------------------------SS--------------------SSSSSSSSSSSSSSSS
----------------------------------------------------------------------------------------------------------------S---------------------------------------------------------------SS---SSSSSSSSSS-
--------------------------------------------------------oooo-------------------------------------------------------------------------------------------------------------------------SSSSSSSSSSS
--------%%%%%%%%-----------------------SS------------------------------------------oo--------o---------------------------------------------------------------------------------------SSSSSSSSSSS
---------||||||---------------------------------------------ooo------------------------rr-rr-----U------------------------------------%%----o-S%------------------------------------------------
---------||||||--------------------------------------------------------------------%%%%%%%%%%SSS---------##----------------S%S--------||-------|------------------------------------------------
---------||||||---------------------------------------------------------------------||||||||------TT-----##-----------------|---------||-----SS|------------------------------------------------
------%%%%%%%%%%----------######------------------------------------------------%---||||||||------TT----TT------------------|---------||-------|-----------------------TT----------SS-----------
-------||||||||-----------------------------------TT---TT--------------------oro|---||||||||------TT-TT-TT------------------|---------||-------|--TT-------------------TT-----------------------
-------||||||||-----------------------------------TT---TT----#-------------S%%%%|---||||||||------TT-TT-TT--TTTT%----------K|---------||-----#-|--TT-------------------TT--------------#--------
-------||||||||-----------------------------------TT---TT----#------------rr-||-|---||||||||------TT-TT-TT--TTTT|--------#-g|g--#-----|k-----#-|--TT-------------------TT-------k------#----gg--
XXXXXXXXXXXXXXXXXXXXXXXXXXXXXXXX---XXXXX----%%%%XXXXXXXXX-XXXX--------%%%%%%%||-|---|||||X%%%%---XXXXXXXXXX-XXXX|-XXXXXXXXXXXXXXXXX---XXXXXXXXXXXXXXXXXXXXXXXXXXXXXXXXXXXXXXXXXXXXXXXXXXXXXXXXXX
XXXXXXXXXXXXXXXXXXXXXXXXXXXXXXXX---XX-XX-----||-XXXXXXXXX-XXXX---------|||||-||-|---|||X|--||--XXXXXXXXXXXX-XXXX|-XXXXXXXXXXXXXXXXX---XXXXXXXXXXXXXXXXXXXXXXXXXXXXXXXXXXXXXXXXXXXXXXXXXXXXXXXXXX
