-----------------------------------------------------------------------------------------------------------------------K------------------------------------------------------------------------
-----------------------------------------------------------------------------------------------------------------------o------------------------------------------------------------------------
----------------------------------------------------------------------------------------------------------------------%%%-----------------------------------------------------------------------
-----------------------------------------------------------------------------------------------------------------------|--------------------------------------------------------SSSSSSS---------
------------------------------------------------------------------o----------------------------------------------------|------------------------------------------------------------------------
-----------------------------------------------------------------------------------------------------------------------|---oo-------------------------------------------------------------------
--------%%%%%%%%-------------------------------o------------------%---------------------------------------------%%-----|--%%%%---------------------------------o-------------------------------S
---------||||||----------------------------#----------------------|---------------------------------------------||-----|---||------------------#-----------y------------------------------------
---------||||||----------------------------#----------------------|---------------------------------------------||-----|---||--------------###-#---------###--------TT--------------------------
---------||||||---------------------------##----------------------|---------------------------------------------||-----|---||---ooo--------###-#---------###--------TT--------------------------
------%%%%%%%%%%----------######---------###-#------------##-----oSo---%%%%%%-----------------------------------||-----|-%%%%---SSS-----######-#-------#####--------##--------------------------
-------||||||||-------------------------####-#------------#-------------||||--oo-------------------------TT-----||-----|--||-----------#########------######-#--TT-----TT-----------------------
-------||||||||------------------------#####-#---------####-------------||||-----------------------------TT-----||-----|--||----------#########-#--#########-#--TT-----TT-----------------------
-------||||||||-----------------------######-#--------#####----o--------||||-------------------r---------TT----k||-----|--||---------#########--#--#########-#--TT-----TT----k------------##----
XXXXXXXXXXXXXXXXXXXXXXXXXXXXXXXXXXXXXXXXXXXXXXXXXoXXXXXXXXX-------%%%%%-||||----------%%%%%%%%%%XXXXXXXXXXXXXXXX|%%%--%%%%%%%%%%XXXXXXXXXXXXXXXXXXXXXXXXXXXXXXXXXXX--XXXXXXXXXXXXXXXXXXXXXXXXXXX
XXXXXXXXXXXXXXXXXXXXXXXXXXXXXXXXXXXXXXXXXXXXXXXXXXXXXXXXXXX--------|||--||||-----------||||||||-XXXXXXXXXXXXXXXX|-|----||||||||-XXXXXXXXXXXXXXXXXXXXXXXXX@-XXXXXXXX-XXXXXXXXXXXXXXXXXXXXXXXXXXXX
