--------------------------------------------------------------------------S---------------------------------------------------------------------------------------------------------------------
---------------------------------K-------------------------------K-S-----SS---------------------------------------------------------------------------------------------------------------------
--------------------------------------------------------------------------S---------------------------------------------------------------------------------------------------------------------
------------------S------------------------------SSS------SS------SSSSSSSSSSSSSS----------------------------------------------------------------------------------------------------------------
-------------------------------------------------------------------------SSS--------------------------------------------------------------------------------------------------------------------
------------------------------------------------------------------------SSSS------------------------------------------------------o-------ooo---------------------------------------------------
--------%%%%%%%%--------%%----------S--------2-------------------------------S------------------------oS-------------QQQQ-----------------------S-SS@SSS----------------------------------------
---------||||||-%%%%%%%%||---------------------------------------------------S---------------S--------------------------------------------------------------------------------------------------
---------||||||--||||||-||-%----------------------------------------------K-SS---------------S------------------------------------------------------------------------------------------------K-
---------||||||--||||||-||-|---------------------------------------------#SSSS---------------------------------------------------------------------------------o--------------------------o-----
------%%%%%%%%%%-||||||-||-|-----------------US------2------------SSS---SS-----------------------------#--------###-----Q------------------------------------SSS---------TT-#-------------t-----
-------||||||||-o|||tt|-||-|-------------TT---@----------TT---SSSSSSSSSSSS#----SSSS---------------------------------------------TT---------------------------------------TT-#-----TT-----TT-----
-------||||||||-%%||tt|-||-|-------------TT--------------TT---TT-----SSSS##-----------------------------------------------------TT-------------#------------------------#####-----TT-----TT-----
-------||||||||-||||tt|-||-|------ggggy--TT---k------k-k-TT---TT----SSSS##o-------------------------------------#------------k--TT-------------#---k--------k-----kk--g####----#--TT-----TT-----
XXXXXXXXXXXXXXXX||XXXXXXXXXX%%%XXXXXXXXXXXXXXXXXXXXXXXXXXXXXXXXX-XXXXXSSXXS----XXXXXXXXXX---XXXXXXXXXXXXXXXXXXXXXXXXXXXXXXXXXXXXXXXXXXXXXXXXX--XXXXXXXXXXXXXXXXXXXXXXXXXXXXXXXXX-XXXXXXX-XXoXXXX
XXXXXXXXXXXXXXXX||XXXXXXXXXX-X-XXXXXXXXXXXXXXXXXXXXXXXXXXXXXXXXX-XXXXXXXXX-----XXXXXXXXXX--XXXXXXXXXXXXXXXXXXXXXXXXXXXXXXXXXXXXXXXXXXXXXXXXXX--XXXXXXXXXXXXXXXXXXXXXXXXXXXXXXXXX-XXXXXXX-XX--X-X
