-----------------------------------------S--------------------------------------------------------------------------------S-------------------------------S-------------------------------------
-------------------------------------SSSSSS----------------------------------------------------------------------K--------S-------------------------------S-------------------------------------
------------------------------------------------------------------------------------------------------------------------------------------------------------------------------------------------
---------------------------------------------------------------------------------------------------------------S----------------------------------SSSSSSSSSSSSSS--------------------------------
----------------------------------------------------------------------------------------------------------------------------------------------------S--SSS--------------------------------------
---------------------------------ooo-----o----------------------o------------------------------------------------------------------------o-------------SS-----S---------------------------------
--------%%%%%%%%---------------------------------o-SSSSSSSS--SSS---------------------------------%%%--------------------------------------------SSSSSSSSo----SS-------SS--------%%%o------------
---------||||||-------------------------------------------------------------oo-------------oo-----|------------------------------------------------------------------------------|---rrrrrrr----
---------||||||-----------------------TT----------------------------------------------------------|--ooo-------------------------------------------------------------------------|-%%%%%%%%%%---
---------||||||-----------------------TT--------o-----------------o------#------------------------|-%%%%%------------------------------------------ggo---------o-----------------|--||||||||----
------%%%%%%%%%%----------######------##--------S-----------------SS----##--------TT------------%%|--|||------------------------TT----S---------SSSSSSS--SS----------------------|--||||||||-%%%
-------||||||||--------------------------------------------------------##---------TT------------|||--|||----------TT------------TT-SSSSSS-------S-SSS-K--SS----------------------|--||||||||--|-
-------||||||||--------------------------------------------------------##---------TT------------|||--|||----------TT------------TT-----------#-----------TT----------------------|--||||||||--|-
-------||||||||------------------------------o------g-#-##-------------##---------TT----k---oooo%%%--|||----------TT----###-o---TT----k------#--------k--TT--------ggg-----------|--||||||||--|-
XXXXXXXXXXXXXXXXXXXXXXXXXXXXXXXX--XX------------XXXXXXXXXXXXXXXXXXXXXXXXXXXXXXXX-XXXXXXXXXX--SSX-|---|%%%%%-%%%--XXXXXXXXXX----XXXXXXXXXXXXXXXXXXXXXXXXXXXXXXXXXXXXXXXXXXXXXXXXX-|--|X%X%XXXXXXX
XXXXXXXXXXXXXXXXXXXXXXXXXXXXXXXX--XX------------XXXXXXXXXXXXXXXXXXXXXXXXXXX-XXXXXXXXXXXXXXX----X-|---|-|||---|--XXXXXXXXXXX--X-XXXXXXXXXXXXXXXXXXXXXXXXXXXXXXXXXXXXXXXXXXXXXXXXX-|--|-|XXXXXXXXX
