-----------------------------------------------------------------------------------------------------------------------------------------------------------------%--------------
---------------------------------------------------------------------------------------------------oo------------------------------------------------------------|--------------
-----------------------------------------------------------------------------------------------------------------------------------------------------------------|--------------
--------------------------------------------------SSSSSSSSSSSSSS----------------------------------------------------------SSS------------------------------------|--------------
-----------------------------------------------------------------------------------------------------------------------------------------------------------------|--------------
-----------------------------------------------U------------------------------------------------#---------------------------------##-----------------------------|--------------
--------%%%%%%%%---K--------------------------------------SS-------------------------SSSo------%---#--------------------SS--SSSS---------------So-SS-------------|--------------
---------||||||-------------------------------------------SSS----------------------------------#-SS--------------------------------------------------------------|--------------
---------||||||-------------------------------------------------------------------SSSSSSSSS---##-------TT-TT------S----------------------------------------------|--------------
---------||||||-----------------------------------------------------------------o------------###-------TT-TT--TT-------------------------------------------------|--------------
------%%%%%%%%%%------------------S--------------------------SSSTT--------------------S-----####-------TT-----TT----------SSSSS----------------Q-----------------|--------------
-------||||||||----------TT-----------------------TT------------TT----tt-------------------#####-------TT-----TT---------------K----tt-----tt--------------------|--TT----------
-------||||||||----------TT---------tt------##----TT------------TT----tt-TT--------#---S--######-------TT----TTT----------SS--------tt-----tt------------##------|--TT----------
-------||||||||------y---TT----g----tt------##---kTT-------gg---TT----tt-TT----g---K-----#######-------TT----TTT------#-----kk--g---tt-----tt-g----------------U-|--TT----------
XXXXXXXXXXXXXXXXXXXXXXXXXXXXXXXXXXXXXXXXXXXXXXXXXXXXXXXXXXXXXXXXXXXXXXXXXXXXXXXXXXXXXXXXXXXXXXXXXXXXXXXXXXXXXXXXXXXXXXXXXXXXXXXXXXXXXXXXXXXXXXXXXXXXXXXX-XX-----XXX-XXXXXXXXXXXX
XXXXXXXXXXXXXXXXXXXXXXXXXXXXXXXXXXXXXXXXXXXXXXXXXXXXXXXXXXXXXXXXXXXXXXXXXXXXXXXXXXXXXXXXXXXXXXXXXXXXXXXXXXXXXXXXXXXXXXXXXXXXXXXXXXXXXXXXXXXXXXXXXXXXXXXX-XX-----XXX-XXXXXXXXXXXX
