------------------------------------------------------------------------------------------------------------------------------------------------------------------------------------------------
----------------------------------S-------------------------------------------------------------------------------------------------------------------------------------------------------------
------------------------------------------------------------------------------------------------------------------------------------------------------------------------------------------------
--------------------------------SSSSSS----------SSSSSSSSSSSSSSSS----------------S---------------------------------------------------------------------------------------------------------------
------------------------------------------------------------------------------------------------------------------------------------------------------------------------------------------------
-------------------------------------------o------------oo-----------------o-----------------------------------------------------oooo----------------------------oooo--ooo----------------------
--------%%%%%%%%----------------------o------S-----------------------------------rrr---SS-----------------%%%-----------------------------------SSSS--SS------oo--------------------------------
---------||||||------------------------------S---U-----------------------------o%%%%%%---------------------|--------------------------------ooo-------------------------------------------------
---------||||||------------------------------------------------------------------||||---------S------------|-------------------------------------------------SS---------------------------------
---------||||||------g------------------------oo---------------------------------||||--------------------ooo------------------------------------oo---------SoSo---------------------------------
------%%%%%%%%%--#######------------S-------------TT----TT-----------S-----------||||------------------%%%%%%%S---TT--------------TT------------SS----------SSS---TT-----------------2----------
-------|||||||------------------------------------TT----TT----TT--------------#--|||tt---#-#------------|||||-----TT----TT--------TT------------------------------TT-------------------TT-------
-------|||||||------------------TT----------------TT----TT----TT-------------##--|||tt--####------------|||||-----TT----TT--------TT------------------------------TT-----K-------------TT----#--
-------|||||||------------------TT----kk----k-----TT--####----TT-----k------#-##-|||tt######------------|||||-----TT----TT--------TT----k----------k-g-------ggg--TT-------------------TT---##--
XXXXXXXXXXXXXXXXXXX---XXXXXXXXXXXXXXXXXXXXXXXXXX-XXXXXXXXX----XXXXXXXXXXXXXXXXXXXXXXXXXXXXXX----%%-XXXXXXX|||%%%XXXXXXXXXXXXXXXX-XXXXXXXXXXXXXXXXXXXXXXXXXXXXXXXXXXXXXXXXXXXXXXXXXXXXXXXXXXXXXXX
XXXXXXXXXXXXXXXXXXXX--XXXXXXXXXXXXXXXXXXXXXXXXXXXXXXXXXXXXX-----XXXXXXXXXXXXXXXXXXXXXXXXXX-o---X||-XXXXXXX|||-|-XXXXXXXXXXXXXXXXXXXXXXXXXXXXXXXXXXXXXXXXXXXXXXXXXXXXXXXXXXXXXXXXXXXXXXXXXXXXXXXX
