-------------------------------------------------------------------------------------------------------K----------------------------------------------------------------------------------------
---------------------------------K---------------------------------------------------------------------S----------------------------------------------------------------------------------------
------------------------------------------------------------------------------------------------------SS----------------------------------------------------------------------------------------
----------------SSSSSSSS--------------------------------------------------------SSSSSSS-----------SSSSS---------SSSSSSSSSSSSSSSS----------------#-----------------------------------------------
-----------------------------------------------------------------------------------------------------------------------------------------------------------------------------------------------#
--------------------------------------------------------------------------o---o--------------------------------------------o--------------------------------------o-----------------------------
--------%%%%%%%%--------oo-------------------------------------------------------------------------------------------------SS------------------------------------------------------------------o
---------||||||----------------------------------------------------------------o----------------%%%%-%-o----rr----------------------------------------------------------------------------------
---------||||||----------------------------------------------------------------------------------||--|%%%-%%%%%---------------------------------------------------------------------------------
---------||||||----------------------------------------------------------------------------------||--|-|---|||-----------------------------------------------------------oo---------------------
------%%%%%%%%%%-------------------------TT--------------------------2---------------------------||--|-|---|||------------------------------%%So-------------------------%%%--------------------
-------||||||||--------------------------TT------------TT----------------------------------------||--|-|---|||--TT--------------------------||----------------------------|---------------------
-------||||||||--------------------------TT---TT-------TT--------------TT----TT-----------------%%|--|-|---|||--TT-----TT----K--------------||----------------------------|---------------------
-------||||||||-------------------ggggg--TT---TT--gg---TT----kggg------TT----TT--------k--#-----|||--|-|---|||r-TT-----TT--g-g----o---------||-g---------##-------g-------|------------------kgg
XXXXXXXXXXXXXXXX--X-XXXXXXXXXXXXXXXXXXXXXXXXXXXXXXXXXXXXXXXXXXXXXXXXXXXXXXXXXXXXXXXXXXXXXXXXXXXX|||--XXX-X%%%%%%XXXXXXXXXXXXXXXXXXXXXXXXXXXXXXXXXXXXXXXXXXXXXXXXXXXXXXXXX-X-----XXXXXXXXXXXXXXXX
XXXXXXXXXXXXXXXXX-X-XXXXXXXXXXXXXXXXXXXXXXXXXXXXXXXXXXXXXXXXXXXXXXXXXXXXXXXXXXXXXXXXXXXXXXXXXXXX|||--XXXXX-||||-XXXXXXXXXXXXXXXXXXXXXXXXXXXXXXXXXXXXXXXXXXXXXXXXXXXXXXXXX-X-----XXXXXXXXXXXXXXXX
