------------------------------------------------------------------------------------------------------------------------------------------------------------------------------------------------
------------------------------------------------------------------------------------------S-----------------------------------------------------------------------------------------------------
------------------------------------------------------------------------------------------------------------------------------------------------------------------------------------------------
--------------------------------------------------------------------------------------SSSSSSSSSS----------------SSSSSSSSSSSSSSSS--------------------------------SSSSSSSSSSSSSSSS----------------
-----------------------------------------------------------------------------------------------------------------------------------------------------------------SS----SS-----------------------
---------------------------------ooo------oooooo-----------------------------------------------------------------------------------------------------------------SS--SSS-----------------------o
--------%%%%%%%%----------------%%%%------%%%%%--------S------------------------------------------------------------------##--o---------------------------------SSSSSSSS-----SSS----------------
---------||||||------------------||--------|||-----------------------------------#---------------#-----------o------------##-------------------------------ooo----------------------------------
---------||||||------------------||--------|||---------------------------------------------------------------------------###--------------------------------------------------------------------
---------||||||------------------||--------|||-o------------------------------------------------------------------o------###------------------------------------oooo----------------------------
------%%%%%%%%%%-----------------||--2---%%%%%%%----------------SSS-SSSS-----U--------------------TT----TT----TT--------####------------####--------------------SSSSS--TT--------2-------%%%%%oo
-------||||||||------------------||-------|||||-----------------SS--------------S-TT-----S--------TT----TT----TT------y####------------#####---------------------------TT----#------------|||---
-------||||||||---------------TT-||----TT-|||||-----------------------------------TT--------------TT-TT-TT----TT-----#######-#--------#####-------TT-----------------####----#------------|||---
-------||||||||---gg----------TT-||----TT-|||||--------------------k-k----k-k-----TT-Sk----oo-----TT-TT-TT----TT-----######--#-------######-------TT----------------#####--#-#------------|||---
XXXXXXXXXXXXXXXXXXXXXXXXXXXXXXXXXX|--X-XXXXXXX|-XXXXXXXXXXXXXXXXXXXXXXXXXXXXXXXXXXXXXXXXXXXXXXXXXXXXXXXXXXXXXXXXXXXXXXXXXX---XXXXXXXXXXXXXX------XXXXXXXX-------XXXXXXXXXXXXXXXXXXXX-XXXXXXXX--X
XXXXXXXXXXXXXXXXXXXXXXXXXXXXXXXXXX|--X-XXXXXX-|-XXXXXXXXXXXXXXXXXXXXXXXXXXXXXXXXXXXXXXXXXXXXXXXXXXXXXXXXXXXXXXXXXXXXXXXXXX---XXXXXXXXXXXXXX----XXXXXXXXXXX------XXXXXXXXXXXXXXXXXXXX-X-XXXXXX--X
