---------------------------------------------------------------------------------------------------------------------------------------K--------------------------------------------------------
----------------------------------------------------------------------------------S-------S--------------------------------------------o--------------------------------------------------------
--------------------------------------------------------------------------------------------------------------------------------------%%%-------------------------------------------------------
----------------SSSSSSSSSSSSSSS---------------------------------SSSSSSSSSSSSSSSSSSSSSSSSSSSSS--S---------------------------------------|--------------------------------------------------------
---------------------S------------------------------------------S----S-----------------------------------------------------------------|--------------------------------------------------------
---------------------------------------------------------------------SS--------S-----------------------------------------ooo-----------|--------------------------oo-------oo-------------------
--------%%%%%%%%-oo-----------oo-------------------------------------SS-----SSSS----------------------------------------%%%%%----------|--------------------------------------------------------
---------||||||-----------------S----------------------------------------------------------------------------------------|||-----------|--------------------------------------------------------
---------||||||----------------S-----------------------TT---------------------------TT-----------------------------------|||-----------|--------------------------------------------------------
---------||||||-o-------------------#------------------TT----------oo---------------TT-----------------------------------ooo-----------|---o----------------------------------------------------
------%%%%%%%%%%S--------------------------------------##----------SSSS--TT-----######----------#--S##-------U----------%%%%%---%%-----|--%%-------------------------2----------------#---------
-------||||||||-----------------------------------------#------TT--------TT-----##---------------------------------------|||----||-----|--||--o---------##------TT------------------------------
-------||||||||-----tt-----------------TT---------------K------TT--------TT-----TT---------------------------------------|||----||-----|--||%%%%-------###------TT------------------------------
-------||||||||-----tt-----kk---g------TT----k-----------------TT----kkk-TT-----TT--------------k------k--k-k------------|||----||-----|--||-||o------###-------TT------------------------------
XXXXXXXXXXXXXXXXXXXXXXXXXXXXXXXXXXXXXXXXXXXXXXXXXXXXXXXXX------XXXXXXXXXXXXXXXXXXXXXXXXXXXXXXXXXXXXXXXXXXXXXXXXX%%%%%-%XXXX|%%%%||--%%%%--||%%%%-XXXXXXXXX--XXXXXXXXXXXXXXXXXXXXXXXXX-X------XXX
XXXXXXXXXXXXXXXXXXXXXXXXXXXXXXXXXXXXXXXXXXXXXXXXXXXXXXXXX-------XXXXXXXXXXXXXXXXXXXXXXXXXXXXXXXXXXXXXXXXXXXXXXXX-|||--|XXXX|-||-||---||---||-||-XXXXXXXXXX--XXXXXXXXXXXXXXXXXXXXXXXX--X------XXX
