------------------------------------------------------------------------------------------------------------------------------------------------------------------------------------------------
------------------------------------------------------------------------------------------------------------------------------------------------------------------------------------------------
------------------------------------------------------------------------------------------------------------------------------------------------------------------------------------------------
--------------------------------SSSSSSS---------------------------------------------------------------------------------------------------------------------------------------------------------
---------------------------------S-----------------------------------------------------------------------------------------------------------------------------o--------------------------------
---------------------------------------------------------------------------------------------------------------------------------------------------------------------------------------------g--
--------%%%%%%%%----QQQQQ------------------------------SS--------------------------------------S----------------------SS-----------------------o----QQQQ---------------SSS-------------------S--
---------||||||----------------------------o-------------------#----------------------------------------------------------------------------------------------------------------------------SS--
---------||||||--------------------------S%%-----------------###----------------------------------------------------------------------------------------------------------------------------S---
---------||||||---------------------------||---------------#-###---------------------------------------------------------------------------#--------------------So------------------ggg--------o
------%%%%%%%%%%###-SSSS----SUS-----------||---------------#-###---------------------SSSSSSSSSSS-SS-------------S-------------------------###-------------------SSS----------S---S-SSS##--------
-------||||||||---------------------------||---------------#####---------------------------------------------o-o-------------------------####-----------------------------------SS-SSSS---------
-------||||||||------------------------TT-||---------------#####---------------------------------------TT-------------------------------####-------------------------------------#--SSS---------
-------||||||||-----------k-k----------TT-||---#---------#-#####-----k---------o-------------------g---TT----------k-k------k-----k----#####----#--k-kkg--#-------------------------------U-k---
XXXXXXXXXXXXXXXXXXXXXXXXXXXXXXXXXXXXXXXXXXXXXXXX--XXXXXXXXXXXXXX--XXXXXX-XXX-%%%--%%%%----XXXXXXXXXXXXXXX-------XXXXXXXXXXXXXXXXXXXXXXXXXXXXXXXXXXXXXXXXXXXXXXXXXXXXXXXXXXXXXXXXXXXXXXXXX-X-XXXX
XXXXXXXXXXXXXXXXXXXXXXXXXXXXXXXXXXXXXXXXXXXXXXXX--XXXXXXXXXXXXXX--XXXXXX-XXX--|----||-----XXXXXXXXXXXXXXX-X-----XXXXXXXXXXXXXXXXXXXXXXXXXXXXXXXXXXXXXXXXXXXXXXXXXXXXXXXXXXXXXXXXXXXXXXXXX-X-XXXX
