------------------------------------------------------------------------------------------------------------------------------------------------------------------------------------------------
------------------------------------------------------------------------------------------------------------------------------------------------------------------------------------------------
------------------------------------------------------------------------------------------------------------------------------------------------------------------------------------------------
----------------------------------------------------------------------------------SSSSSSSSSS----------------------------------------------------------------------------------------------------
------------------------------------------------------------------------------------------------------------------------------------------------------------------------oo----------------------
------------------------------------------------------------------------------------------------------------------------------------------------------------------------------------------------
--------%%%%%%%%--------------------QQQ-------------------------------------------------------------------------SSSSSSSSS----S---------S--------------S-----------------SSS----------SSSSSS--SSS
---------||||||------------------------------------------------------------------------------------------------o--------------------------------------------------------------------------------
---------||||||---------------------------------------K------S----------------------------------------------------------------------------------------------------------------------------------
---------||||||--------------------------------------------ooS-S-------------------------------------------------------------ooo--------------------------------------------SS---------k--------
------%%%%%%%%%%----------######QQQ---SSSSSSSSS------------------------------S----------------------------------SSQQSSSSS----SSS-------S--------Qooo------------------------SS--QQQQ---USS------
-------||||||||--------------------------------------------------------------------------TT---TTTT----------------------------------------------------------------------------------------------
-------||||||||-------------------------------------------------------------------TT-----TT---TTTT-----TT------------------------------------#--------------------------------------------------
-------||||||||--------------------k-----------k-------------------r------------k-TT--k--TT---TTTT-----TT---k------k--k------------------------------g-----------------------------------------g
XXXXXXXXXXXXXXXXXXXXXXXXXXXXXXXXXXXXXXXXXXXXXXXXXXXXXXXXXXX-XXXX-%%%--XXXXX--XXXXXXXXXXXXXXXXXXXXXXXXXXXXXXXXXXXXXXXXXXXX----XXX-XXXX-XXXXX--X--XXXXXXXXXXXXXXXX-----S----S%%%--XXXXXXXXXXX-XXXX
XXXXXXXXXXXXXXXXXXXXXXXXXXXXXXXXXXXXXXXXXXX-XXXXXXXXXXXXXXX-XXXXX-|----XXXX--XXXXXXXXXXXXXXXXXXXXXXXXXXXXXXXXXXXXXXXXXXXX---XXXX--XXX-XXXXX-XXX-XXXXXXXXXXXXXXXX------------|---XXXXXXXXXXX-XXXX
