------------------------------------------------------------------------------------------------------------------------------------------------------------------------------------------------
------------------------------------------------------------------------------------------------------------------------------------------------------------------------------------------------
--------------------------------------------------------------------------------------------------------------------------------------------------------------------------S---S-----------------
--------------------------------SSSSSSSSSSSSSSSS---------------------------------------------------------------------------------S------------------------------SSSSSSSSSSSSSSSS----------------
--------------------------------SSS--SS--SS------------------------------------o-------------------------------------------------------------------------o--------S-S--S---S-S------------------
---------------------------------SS-----------SS--o----------------------------------------------ooo--------------o--------ooooo-------------------------------------SSS---SSSSS----------------
--------%%%%%%%%------------------So------SSo-----------------------QQQQ---------------ooo---o-o----------------%%%-------%%%%%----------------o--------oSS-SS-----SSSSS--SSSSS---------%%------
---------||||||--------------------------------------------------------------------------------------------------|---------|||-----------------#---------------------------------%%%%%%%||------
---------||||||--------------------------------------------------------------------------------------------------|---------|||---------------###----------------------------------|||||-||------
---------||||||-----------------ooo------------------------------------------------------------------------------|---------|||--------------####----------------------------------|||||-||------
------%%%%%%%%%%----------------SSS------------------------------#--------------Q-#---QQQ---SS---S-----@---------|------%%%%%%-------------#####-----SS----SSS--S--------------S--|||||-||------
-------||||||||----------TT--------------------------------------#-----------------------------------------------|-------||||--------------#####-----------------------K----------|||||-||------
-------||||||||-TT-------TT--------------------------------------#-----------------------------------------------|-------||||----------tt--#####------------------------#---------|||||-||------
-------||||||||-TT-------TT----o-----gg-------##-----------------#-k--g------------k--------k--------------------|-------||||----------tt#######------------------------k---------|||||-||------
XXXXXXXXXXXXXXXXXXXXXXXXXXXXXXXXXXXXXXXXXXXXXXXXXXXXXXXXXXXXXXXXXXXXXXXXXXXXXXXXXXXXXXXXXXXXXXXXXXXXXXXXX-XX-X-X%%%%%%%%%%%%|---XXXXXXXXXXXXXXX----%%%%%SSS----XXXXXXXXXXXXXXXXX--|||XXXXXXXX%--
XXXXXXXXXXXXXXXXXXXXXXXXXXXXXXXXXXXXXXXXXXXXXXXXXXXXXXXXXXXXXXXXXXXXXXXXXXXXXXXXXXXXXXXXXXXXXXXXXXXXXXXXX-XX-X-X-||||||||||-|---XXXXXXXXXXXXXXX-----|||--------XXXXXXXXXXXXXXXXX--|||-XXXXXXXX--
