-------------------------------------------------------------------------------------------------------------------------------------------------------K----------------------------------------
-------------------------------------------------------------------------------------------------------------------------------------------------------o----------------------------------------
-------------------------------------------------------------------------------------------------------------------------------------------------------%----------------------------------------
--------------------------------SSSSSSSSSSSSSSSS--------------------------------SSSSSSSSSSSSSSSS-------------------------------------------------------|----------------------------------------
--------------------------------S----------------------------------------------------------------------------------------------------------------------|----------------------------------------
-------------------------------------------------------------------------------------------------------------------------------o-----------------------|-o--------------------------------------
--------%%%%%%%%-----------#---o--------SSS-----------------------------------oo----------------------------------------------------QQQSSSSSS-@--------%%%--------------------------------------
---------||||||-----------###----------------------------------------------#-------------------------------------#------------oo------------------------|---------------------------------------
---------||||||----------######--------------------------------------------#----------------------------------------------------------------------------|-----------------------S---------------
---------||||||---------######----------------------------------------------------------------------------------------------------------------------%%%%%%-SS-------------------S---------------
------%%%%%%%%%%--------#######-------------------TT-----TT--------------#---------------------------------------TT-------------------SSSSSSS@S------||||----------------TT---------------------
-------||||||||--------#######--o----tt-----------TT-----TT-------------##---#-----------------------------------TT-------#-#------------------------||||---------TT-----TT---TT----------------
-------||||||||--#---##########-%----tt--------#--TT-----TT-----------####---#----------#------------------------TT----##-###----------------------o-||||---------TT-----TT---TT----------------
-------||||||||--#---#########--|----tt----y-###--TT-----TT-----------####---#----------#----------------------g-TT----######------r--------------%%%||||---------TT-----TT---TT-------------g-g
XXXXXXXXXXXXXXXXXXXXXXXXXXXXXXX-XXXXXXXXXXXXXXXXXXXXXXXXXXXXXXXXXXXXXXXXXXXXXXXXXXXXXXXXXXXXXXXXXXXXXXXXXXXXXXXXXXXXXXXXXXXXXXXX-%%%%%--XXX-XXXX---|-|||%%%%%%%%XXXXXXXXXXXXX-XXXXXXXXXXXXXXXXXX
XXXXXXXXXXXXXXXXXXXXXXXXXXXXXXX-XXXXXXXXXXXXXXXXXXXXXXXXXXXXXXXXXXXXXXXXXXXXXXXXXXXXXXXXXXXXXXXXXXXXXXXXXXXXXXXXXXXXXXXXXXXXXXXX--|||---XXX-XXXX---|-|||-||||||-XXXXXXXXXXXXX--XXXXXXXXXXXXXXXXX
