------------------------------------------------------------------------------------------------------------------------------------------------------------------------------------------------
------------------------------------------------------------------------------------------------------------------------------------------------------------------------------------------------
------------------------------------------------------------------------------------------------------------------------------------------------------------------------------------------------
-------------------------------------------------------------------------------------------------------------------------------S----------------SSSSSSSS----------------------------------------
------------------------------------------------------------------------------------------------------------------------------------------------------------------------------------------------
-----------------------------------------------------------------------------------------------o------------------------------------------------------------------------------------------------
--------%%%%%%%%--------------------QQQQQS--------------------------------------------------------------------------------------------QQQSSS-------------------------------oo-------------------
---------||||||----------------------------------------------------------------------------------------------------------------------------------o-----------------------------------------##---
---------||||||-------------------------------------------------------------------------------------------------------------------------------------------------------------SS-------------##---
---------||||||---------------------------------------------------------------------------------------------------------------------------------------------------------SSSSSS-------------##---
------%%%%%%%%%%----------######-------SQ--------------TT----------------------------2-------o--------------SSS-----------------####--##-----S-------------##---------------SS-------------##---
-------||||||||----------------------------------------TT----#-----------TT-----------------------------------------------------####--------------------TT###---------------------TT-------#----
-------||||||||---------------------------------------###---##-----------TT-----------------#---------------------------##------####------------TT------TT###---------------------TT-----###----
-------||||||||-----------------------------k--g-----####--###---k---kkk-TT-----g-g-------#-#---------------------k-----##------####-------k-g##TT------TT###-----#--------k-ggg--TT----##-#----
XXXXXXXXXXXXXXXXXXXXXXXXXXXXXXXXXXXXXXXXXXXXXXXXXXXXXXXXX--XXXX-XXXXXXXXXXXXXXXXXXXXXXXXXXXXXXXX--%%%%---XXXXXXXXXXXXXXXXX------XXXX--XXXXXXXXXXXXXXXXXXXXXXX-XXXXXXXXXXXXXXXXXXXXXXXXXXXXXXXXXX
XXXXXXXXXXXXXXXXXXXXXXXXXXXXXXXXXXXXXXXXXXXXXXXXXXXXXXXXX-XXXXX-XXXXXXXXXXXXXXXXXXXXXXXXXXXXXXXX---||----XXXXXXXXXXXXXXXX-------XXXX--XXXXXXXXXXXXXXXXXXXXXXXXXXXXXXXXXXXXXXXXXXXXXXXXXXXXXXXXXX
