------------------------------------------------------------------------------------------------------------------------------------------------------------------------------------------------
------------------------------------------------------------------------------------------------------------------------------------------------------------------------------------------------
--------------------------------------------------------------------------S---------------------------------------------------------------------------------------------------------------------
----------------------------------------------------------------SSSSSSSSSSSSSSSS----------------------------------------------------------------------------------------------------------------
----------------------------------------------------------------SSS-SSSSSSSS-SSS----------------------------------------------------------------------------------------------------------------
----------------------------------------------------------------SSSSSSSSSSSooSSS-------------------------------------------------------------------------------------------o--------------------
--------%%%%%%%%----------------SSSS@SSS-----SSS---------------S-SSSSSSS-SSSSSSS--------------------------------------SSSSSS%S--------------------------oo----------------%%%----SS2-----------U
---------||||||---------------------------------------------------------------------------------------------------oo--------|------------------------------------------o---|--------------------
---------||||||-------------------------------------------------------------------------------------------------------------|-----------------------------------------%%%--|--------------------
---------||||||---------------------------------------------------TToo--------oo--------------------------------------------|------------------------------------------|---|--------------------
------%%%%%%%%%%%S-------%%S----SSQQQ--QQS---US----------%%%%S--TTTTSSS----------SS-----------------------------------------|---###--#---------------------------------|--%%----Q-Q-------------
-------|||||||||---------||-------------------------------||----TTTT--K-TT-------------------------------#------------------|---###------------------------------------|--||--------------------
-------|||||||||---------||-------------------------------||----TTTT----TT-------------------------------#------------------|---###----------K-------------------------|--||%%%%----------------
-------|||||||||---------||----------g----k-k------k------||----TTTT--k-TT---------------------------k---#-----o-----k------|---###----k---k-g-g--------##-------------|r-||-||---gy------------
XXXXXXXXXXXXXXXX%%%%%%%%-||--X--XXXXXXXXXXXXXXXXXXXXXXXXXXXXXXXXXXXXXXXXXXXXXXXXXXXXXXXXXXXXXXXX-XXXXXXXXXXXX--XXoXXXXXXXXXXXXXXXXXXXXXXXXXXXXXXXXXXXXXXXXXXXXXX%%%%-XX%%%%%-||-XXXXXXXXXXXXXXXX
XXXXXXXXXXXXXXXX-||||||--||--X--XXXXXXXXXXXXXXXXX-XXXXXXXXXXXXXXXXXXXXXXXXXXXXXXXXXXXXXXXXXXXXXXXXXXXXXXXXXX---X-XXXXXXXXXXXXXXXXXXXXXXXXXXXXXXXXXXXXXXXXXXXXXXXX||---XX|||--||-XXXXXXXXXXXXXXXX
