-------------------S----------------------------------------------------------------------------------------------------------------------------------------------------------------------------
------------------------------------------------------------------------------------------------------------------------------------------------------------------------------------------------
------------------------------------------------------------------------------------------------------------------------------------------------------------------------------------------------
---------------------------------------SSSSSSSSS----------------------------------------------------------------SSS----------SSS----------------------------------------------------------------
------------------------------------------------------------------------------------------------------------------------------------------------------------------------------------------------
-----------------------------------------------------------------------------------------o-------------------------------------------------------oo---------oooo--------------------------------
--------%%%%%%%%--rr---%%------------SS------S-----------------------SQoo-----------------------------------------------------------------------------------------------------------------------
---------||||||-%%%%%%-o|--o------------------------------------------------------------------------------------------------------------------K--------------------------------------------#----
---------||||||--||||--||-%%-----------------S------------------------------------------------------------------------%%%-%%-------------------------------------------------------------##-----
---------||||||--||||--||-||------------------SS-----------------------g-----#oo--------TT----------------SS-----------|--||-----------------------------------------------------o------##------
------%%%%%%%%%%-||||--||-||--------SSS--S----SS----------------###---S##----##---------TT-----------------------------|--||-----------------------------%%----------2-----------------###------
-------||||||||-o||||--||-||------S------S------------------------------#--####---------TT---------------#------o------|--||---#--TT---TT----------------||----------------------------###------
-------||||||||-%%|||--||-||--------------------------------------------#--####---------##--------------##------%%-----|--||------TT---TT-----TT---------||-------------TT------------####------
-------||||||||-|||||--||-|o------------------------------------------###g#####---yg-#--##---#----------#-------%|-----|rrrrr-----TT---TT-----TT-g-------||-------------TT----g-----######---k--
XXXXXXXXXXXXXXXX|||||-%%%-%X%%%-XXXXXXXXXX--XXXX-----------%%%%%XXXXXXXXXXXXXXXXXXXXXXXXXX--XX--XXXXXXXXXX---XXX||----%%%%%%%%%-XXXXXXXXXXXXXXXXXXXX-SX--||---%-XXXXXXXXXXXXXXXXXXXXXXXXXXXXXXXX
XXXXXXXXXXXXXXXX|||||--|--|X-|--XXXXXXXXXX---XXX---X--------|||-XXXXXXXXXXXXXXXXXXXXXXXXXX---X--XXXXXXXXXX---XXX||-----|||||||-XXXXXXXXXXXXXXXXXXXX------||---|-XXXXXXXXXXXXXXXXXXXXXXXXXXXXXXXX
