------------------------------------------------------------------------------------------------------------------------------------------------------------------------------------------------
------------------------------------------------------------------------------------------------------------------------------------------------------------------------------------------------
------------------------------------------------------------------------------------------------------------------------------------------------------------------------------------------------
------------------------------------------------------------------------------------------------------------------------------------------------SS----------------------------------------------
-------------------------------------------------------------------------------------------------------------------------------K----------------------------------------------------------------
------------------------------------------------------------------o-------------------------------------oo----------------------------------------------------------------------o-o-------------
--------%%%%%%%%------------------------------------------------%%%-------------------------------------------------------------------------------------S--------------SS-----------------------
---------||||||--------o---o---------------#----------oo---------|----------------------------------------------------------------------------------------------SSS%%---------------------------
---------||||||-------%%%--%%-------------##---------------------|-------------------------------------------------------------------------------------------------||---------------------------
---------||||||--------|---||-------------##---------------------|--------------------------------------------------------------------------------------------#----||---------------------o-----
------%%%%%%%%%%-------|---||------------###---------------------|-------------o---------------------------------------------------------------------------#-------||---------------------------
-------||||||||--------|---||-----------####---------------------|--------------------------------TT---------------------TT------------------#-#-----------#---#---||---------------------------
-------||||||||--------##--||----------#####---------------------|--------------------------------TT-----#---------------TT--------------TT--#-------------#---#---||---------------------------
-------||||||||--------##--||---------######---------------------|gg------------------------------TT-----#-----o--gk--g--TT---k-----gg---TT--###-----g-----#--##---||--------g-g--g-------------
XXXXXXXXXXXXXXXX-XXXXXXXX--||----XXXXXXXXXX----X-----%%%%%%%----XXXXXXXXXXXXXXXX--XXXX-------%%%XXXXXXXX-X------XXXXXXXXXXXXXXXXXXXXXXXXXXXXXXXXXXXXXXXXXXXXXXXXXXXXXXXXXXXXXXXXXXXXXXXX-----%%%
XXXXXXXXXXXXXXXX--XXXXXXX--||---XXXXXXXXXXX----X------|||||-----XXXXXXXXXXXXXXXX--XXXX--------|-XXXXXXXX-X------XXXXXXXXXXXXXXXXXXXXXXXXXXXXXXXXXXXXXXXXXXXXXXXXXXXXXXXXXXXXXXXXXXXXXXXX------|-
