------------------------------------------------------------------------------------------------------------------------------------------------------------------------------------------------
------------------------------------------------------------------------------------------------------------------------------------------------------------------------------------------------
------------------------------------------------------------------------------------------------------------------------------------------------------------------------------------------------
----------------------------------------------------------------------------------------------------------------SSS-------------SSSSSSSSSSS-----------------------------------------------------
--------------------------------------------------------------------------------------------------------------------------------S---------------------------------------------------------------
-------------------------------------------oo-o----------------------------------------------------o--------------------------------------------------------------------------------------------
--------%%%%%%%%---------------------------SS----------------------------------------SSS-----------------------------------------SoSo-S-------SS--------------------------------Sooo----oSS----o
---------||||||-------------------------------------------------------oo---oo-------------------------------------------------------------------------------------------------------------------
---------||||||-------------------------------------------------------------------------------------------------------------------------------o----------------------------------------------oo-
---------||||||----------------------#--------oo-------------#------------------------------------------------------g-----------------------------------------------------------o---------------
------%%%%%%%%%%----------#####-----S2-------SSS-----------#-#--------------------------------------------------######-#----------------------SS-----2---------------------------------------@S-
-------||||||||----------------------------------------TT--###-------------------------TT-----------------------TT--------------------------------------TT--------------------TT----------------
-------||||||||------------------------TT--------------TT--###-------------------------TT---------TT------------TT------------------------#-------------TT---TT---------------TT----------------
-------||||||||-----------------g------TT-------g------TT--###----------------------gg-TT---------TT---------oo-TT----------k-k------k-g-##-----g-------TT---TT---g----g----k-TT--ggg-----------
XXXXXXXXXXXXXXXXXXXXXXXXXXXXXXXXXXX-XXXXXXXXXXXXXXXXXXXXXXXXXXX-XXXXXXXXXXXXXXXXXXXXXXXXXXXXXXXX-XXXX-----------XXXXXXXXXXXXXXXXXXXXXXXXXXXXXXXXXXXXXXXXXXXXXXXXXXXXXXXXXXXXXXXXXXXXXXXXXXXXXXXX
XXXXXXXXXXXXXXXXXXXXXXXXXXXXXXXXXXX-XXXXXXXXXXXXXXXXXXXXXXXXXXXXXXXXXXXXXXXXXXXXXXXXXXXXXXXXXXXXXXXXX-X--------XXXXXXXXXXXXXXXXXXXXXXXXXXXXXXXXXXXXXXXXXXXXXXXXXXXXXXXXXXXXXXXXXXXXXXXXXXXXXXXXX
