-----------------------------------------------------------------------K------------------------------------------------------------------------------------------------------------------------
--------------------------------------ooo------------------------------o------------------------------------------------------------------------------------------------------------------------
-------------------------------------%%%%%-----------------------------S------------------------------------------------------------------------------------------------------------------------
--------------------------------------|||------------S------------------------------------------------------------------------------------------SSS---SS----------------------------------------
--------------------------------------|||-------------------------------------------------------------------------------------------------------------------------------------------------------
--------------------------------------|||-----%%-------------------------------%----------------------------------------------------------------------------------------------------------------
--------%%%%%%%%----------------%-----|||-----||--o----SS-------%--------------|--------------------------------------SQQ-------------------------------------------------------------------S---
---------||||||-----------------|-----|||-----||--%%%------#----|--------------|-----------------o---------------------------------------------#------------------------------------------------
---------||||||-----------------|-----|||-----||---|-------#----|--------------|----oo----------%%%---------------------------------------------------------------------------------------------
---------||||||-----------------|-----|||ooo--||---|-------#----|--------------|-----------------|------------------------------------------#-#----------------------------------------------ooo
------%%%%%%%%%%----------######|-----||%%%%%-||---|-------#----|--------------|-----2-----------|-----------------#--##-----Q--------------#-#--------------------------------------SSS-----SSS
-------||||||||-----------------|-----||-|||-ooo---|-----###----|--------------|---------TT------|----------------##----------------------#-#-#--------------------------TT---------------------
-------||||||||-----------------|-----||-|||%%%%---|tt-#####----|--------------|---------TT------|--------------#####--------------------####-#--------------------------TT---------------------
-------||||||||-----------------|-rrrrrrr|||-||----|tt######----|----------r---|---------TT------|--------------####--k-----------gg-----##-#-###----------k-k---------k-TT----k----------o-----
XXXXXXXXXXXXXXXXXXXXXXXXXXXXXXXX%%%%%%%%%%%%-||--XXXXXXXXXXX----|-%%%%%%%%%%%%%|XX---X---XXXXXXX-%%%-XXX-XXX%%--XXXXXXXXXXXXXXXXXXXXXXXXXXXXXXXXXXXXXXXXXXXXXXXXXXXXXXXXXXXXXXXXXXXX------XXXXXX
XXXXXXXXXXXXXXXXXXXXXXXXXXXXXXXX-||||||||||--||-XXXXXXXXXXXX---o|--|||||||||||-|XX--XX---XXXXXXX--|--XXX-XXX||--XXXXXXXXXXXXXXXXXXXXXXXXXXXXXXXXXXX-XXXXXXXXXXXXXXXXXXXXXXXXXXXXXXXX------XXXXXX
