--------------------------------------------------------------------------------------------------------------------------------------------------------------------------------
---------------------------K-K-------------------------------------------------------------K-K-------------------------------K--------------------------------------------------
-------------------------------U-------o--------------------------------------------------------------------------------------Q-------------------------------------------------
----------------oooo--------------SSSSSS--------So-----------SSS----SSS---------------------------------------------------------------------------------------------------------
--------------------------------------------------------------------------------------------------------------------------------------------------------------------------------
----------------------%-%%%-----------------------------------------------------------%%%-%%------------------------------------------------------------------------------------
--------%%%%%%%%------|--|-------------------------------------------------------------|--||---------------------------------------------------------o--o-----------------------
---------||||||-------|--|-------------------------------------------------------------|--||-------ooo----------------------------------------------------------SSS-S-----------
---------||||||-%%%%%%%--|-----oSSS--##---S-----%%-------------------------------------|--||--------------------%%%%%%%%%------------------------------SSSSS---------#----------
---------||||||--|||||---|----SS----###---------||--------------------o----------------U--||---------------------|||||||------1------------------------------#------###---------
------%%%%%%%%%%-|||||---|-%%%%%S---###--#------||-----TT---------TT----%%%%%%%%---%-%%%%%%%%%%%TT---------------%%%%%%%%%---------------%%%%%%--------S----##------###--TT-----
-------||||||||--|||||---|--|||-----###---------||-----TT-----#---TT-----||||||----|--|||||||||-TT-------TT----T--|||||||-----------------||||-----#-------###----#-###--TT-----
-------||||||||--|||||---|--|||-#######---------||-----##-----#---TT-----||||%%%---|--||||||||%%TT-------TT----T--|||||||--%--------------||||-----#---#--####---##-##---TT-----
-------||||||||--|||||---|--|||-#######---------|k-----##-----#---TT-----||||-|----|--||||||||||TT----g-kTT----T--|||||||--|--------------||||-----#-#-#-#####--###-###--TT-----
XXXXXXXXXXXXXXXX-|||||---%%%|||-X---XXXX-------X|XXXX--XX--XXXXXXXXXX----|%%%%%----|--%%%%||||%%XXXXXXXXXXXXXXXX--|||||||--|-%%-XXXXXX----||||--XXXXXXXXXXXXXX-XXXXXXXXXXXXXXXXX
XXXXXXXXXXXXXXXX-|||||----|-|||-X---XXXX-------X|XXXX--XX--XXXXXXXXXX----|-|||-----|---||-||||||XXXXXXXXXXXXXXXX--|||||||--X-||-XXXXXX---XX|||--XXXXXXXXXXXXXX-XXXXXXXXXXXXXXXXX
