---------------------------------------------------------S-----------------------------------------------------------------------------------------------------------------------------K--------
-------------------------------------------------K--SS--SSS----------------------------------------------------------------------------------------------------------------------------o--------
--------------------------------------------------------------------------------------------------------------------------------------------------------------------------------------%%--------
--------------------------------SSSSSSSSSSSSSSS---------------------------------------------------------------------------------SSSSSSSSSSSSSSSS--------------------------------------||--------
---------------------------------------------------------------------------------------------------------o----------------------SS---S-------S----------------------------------------||-------o
------------------------------------------------SS-o----S-----------------------------------------------------------------------SSS--S----oooSSS--------------------------------------||-------%
--------%%%%%%%%-------------------------------------------------------Q--------------SSSSSS----------SSSSSS----#--------------oSSSSSSSSSSSSSSSS---------------------QQ--------o%-----||-------|
---------||||||----------------o-----------------------------------------------------%%o-----------o---------------------------#------------------------------------------------|-----||-------|
---------||||||--------------------------###--TT-------------------------------------||----------------------o-----%-----------#------------------------------------------------|-----||-------|
---------||||||-----------------o-------###---TT-------------------------------------||---------------------oS-----|----------##o-o---------------------------------------------|-----||-ooo---|
------%%%%%%%%%%------------------------##----TT---SSSS--SS--------------------------||------S---------QQ---SSS----|----------##-------------#------------------------------#---|-----||%%%%---|
-------||||||||-----------------------y###----TTSSSS-----SS--------------------------||----------------------------|----------##-------TT--###------------------------------#---|-----||-||----|
-------||||||||-----------------------####---TT-S-SS-----SS---------K----------------tt----------------------------|--------####-------TT--#TT--oo-------------#---------###----|-----||-||--%%|
-------||||||||----------------g-----#####---TT-SSSS--------oooS---------------------tt----k---g---k---------------|--------#-##-------TT--#TT--%%-------------#y-gk-k--###-----|--r--||-||--|||
XXXXXXXXXXXXXXXXXXXXXXXXXXXXXXXXXXXXXXXXXXXXXXXXXXXXXXX--SSX-XXXXXXXXXXXXXXXXXXXXXXXXXXXXXXXXXXXXXXX--------XXXX-%%XXXXXXXXXXXXXXXXXXXXXXXXXXX--||------%%%%%%%XXXXXXXXXXXXXXXXX|%%%%%%%%%%%%%%%
XXXXXXXXXXXXXXXXXXXXXXXXXXXXXXXXXXXXXXXXXXXXXXXXXXXXXX-------XXXXXXXXXXXXXXXXXXXXXXXXXXXXXXXXXXXXXXX----X---XXXX-|XXXXXXXXXXXXXXXXXXXXXXXXXXXXXX||-------XXX||-XXXXXXXXXXXXXXXXX|-|||||||||||||-
