------------------------------------------------------------------------------------------------------------------------------------------------------------------------------------------------
---------------------------------------------------------------------------------------------------------------------------------K--------------------------------------------------------------
------------------------------------------------------------------------------------------------------------------------------------------------------------------------------------------------
---------------------------------------------------------------SSSSS----------------------------SSSSSSS-----------------------------------------------------------------------------------------
---------------------------------------------------------------S--------------------------------------------------------------------------------------------------------------------------------
---------------------------------------------------------------S-------------------------ooo-----------------------------------%--------------------------------ooo------o----------------------
--------%%%%%%%%----------------------SSSS-----#------------------------------------------------------oSS----------------------|----QSQQQ-------------------------------------------------------
---------||||||-------------------------------##------------------------------------------------%%%%%%%--------%---------------|---------------------------------------------------S------------
---------||||||-----------------------------####--------------------TT---------------------------|||||---------|---------------|--------------------------------------------------SS------------
---------||||||----------------------------##-##--------------------TT---------------------------|||||-----#---|----------ooo--|-------g--------------------------------------------------------
------%%%%%%%%%%----------######---------####-------------S---------##-----------------TT----#---|||||---###---|--------%%%%%--|####SSSS-----U-----------TT-------------------------------------
-------||||||||--------------------------#####-o-------------------------TT---TTTT-----TT---##---|||||---###---|---------|||---|-------------------------TT-------TT----TT----------------------
-------||||||||------------------------#######-#o------------------------TT---TTTT-----TT---###-#|||#|-#####-#-#---------|||---|-------------------------TT-------TT----TT----TT----------------
-------||||||||-----------------------##########------------ooo-g--------TT---TTTT---k-TT--####--|||#|######-#-#---r-----|||---|---k-kgg--k----------k---TT-------TT----TT--k-TT-----------k----
XXXXXXXXXXXXXXXXXXXXXXXXXXXXXXXXXXXXXXXXXXXXXXXXXX---------XXXXXXXXXXXXXXXXXXXXXXXXXXXXXXXXXXXX-XXXXXXXXXXXX---X-%%%%%%%%%%%%%%%XXXXXXXXXXXXXXXXXXXXXXXXXXXXXXXXXXXXXXXXXXXXX-XXXXXXXXXXXXXXXXXX
XXXXXXXXXXXXXXXXXXXXXXXXXXXXXXXXXXXXXXXXXXXXXXXXX----------XXXXXXXXXXXXXXXXXXXXXXXXXXXXXXXXXXXX-XXXXXXXXXXXXo-oX--|||||||||||||-XXXXXXXXXXXXXXXXXXXXXXXXXXXXXXXXXXXXXXXXXXXXX-XXXXXXXXXXXXXXXXXX
