-------------------------------------------------------------------------------------------------------K-----------------------------------------------K----------------------------------------
-------------------------------------------------------------------------------------------------------o-----------------------------------------------o----------------------------------------
-------------------------------------------------------------------------------------------------------%----------------------------------------------%%----------------------------------------
--------------------------------SSSSSSSSSSSSSSSS-------------------------------------------------------|----------------------------------------------||----------------------------------------
-------------------------------------------------------------------------o-----------------------------|----------------------------------------------||----------------------------------------
-------------------------------------------------------------------------------------------------------|----------oo---------ooo----------------------||---ooo-----Q---SS-K---------------------
--------%%%%%%%%----SSSSSSS--------------------o-------SSS------------SSSS-----------------------------%%%-------------------------------------o%-----||-%%%%%----------------------------------
---------||||||--------------------------------#-------------------------------------------o----%%%%----|---------------------------------##----|-----||--|||--------------------U--------ooooo-
---------||||||----------------------------###--------------------------------------------%%%----||-----|--------------------------------###----|-----||--|||-----------------------------------
---------||||||----------------------------###----------------------------oo---------------|-----||-----|----------------ooo-------------##-----|-----||--|||-------------oo--------------------
------%%%%%%%%%%----SSSSSS----------------####-------------------ooo--SSSS%%----%----------|-----||-----|--------------2%%%%%------------##--#--|-----||%%%%%------o--------------TT------------
-------||||||||------------------##-------####----------------------------||----|----------|----o||-----|------#---------|||--oo-------####--#--|-----||-|||----------------------TT---TT-------
-------||||||||------------------##------#####-------tt-------------------||----|----------|-K%-%%|-----|------#---------|||----------########--|-----||-|||----------------------TT-##TT-------
-------||||||||----------------####---o#######-------tt-------------------||----|----------|--|-|||-----|------#--gg-----|||----------########--|-rr--|r-|||-----------------o----TT-##TT----k--
XXXXXXXXXXXXXXXXXXXXXXXXXXXXXXXXXXXXXXXXXXXXXXXXXXXXXXXXXXXXXXXX--XX%%X---||----|-----%%%-%%%%%%|||---%%%%%%%%%-XXXXXXXXXXXXXXX-XXXXXXXXXXXXXXXX%%%%%%%%%%||-----XXXXXXX---------XXXXXXXXXXXXXXX
XXXXXXXXXXXXXXXXXXXXXXXXXXXXXXXXXXXXXXXXXXXXXXXXXXXXXXXXXXXXXXXX--XX||----||----|------|---||||-|||----||||X||--XXXXXXXXXXXXXXX-XXXXXXXXXXXXXXXX-||||||||-||----XXXXXXXX--------XXXXXXXXXXXXXXXX
