------------------------------------------------------------------------------------------------------------------------------------------------------------------------------------------------
------------------------------------------------------------------------------------------------------------------------------------------------------------------------------------------------
------------------------------------------------------------------------------------------------------%%%---------------------------------------------------------------------------------------
------------------------------------------------SSSSSSSSSSSSSSSS---------------------------------------|----------------------------------------------------------------------------------------
-------------------------------------------------------------------------------------------------------|----------------------------------------------------------------------------------------
-------------------------------------------------------------------------------------------------------|--------Q---------------------------------o---------------------------------------------
--------%%%%%%%%--------------------------------------------SS------SQo---SS--------------------%%%----|--------------Q-----------o---------------------------------------------S------Sooo--SSS
---------||||||----------------------------------------------------------------------------------|o----oo-ooo---------------oo-------------#-----------------------------------%----------------
---------||||||----------------------------------------------------------------------------------%%%-%%%%%%%%-----------------------------##-----------------------------------|----------------
---------||||||------------------------------------------------o----------------------------------|---||||||------------------------------##-----------------------------------|----------------
------%%%%%%%%%%----------######--------------K-----SSS----------------------Q--------------------|---||||||-----SQS-SS@-U---------------####------------%%%%%%----------------|S----S@QQSSSSS--
-------||||||||-----------------------------------------------------------------------------------|---||||||--rr-------------------------##---------------||||-----------##----|----------------
-------||||||||---------------------------------TT------------------------------------------------|---||||||%%%%------------------------###---------------||||-----------##----|----------------
-------||||||||-------------------kggy--------g-TT---------------------g--k-k------k------k-k-----o---|o||||-||-----------------------#####---------------||||-k--------####---#----------------
XXXXXXXXXXXXXXXXXXXXXXXXXXXXXXXXXXXXXXXXXXXXXXXXXXXXXXXXXXXXXXXXXXXXXXXXXXXXXXXXXXXXXXXXXXXXXXXX-%%%-X%X%%%%-||-QXXXXXXXXXX--XXXXXXXXXXXXXX-XXXX-%%%%-%---XXXXXX---XXXXXXXXXXXXX--%%%%--XXXXXXXX
XXXXXXXXXXXXXXXXXXXXXXXXXXXXXXXXXXXXXXXXXXXXXXXXXXXXXXXXXXXXXXXXXXXXXXXXXXXXXXXXXXXXXXXXXXXXXXXX--|---|X-X|--||XXXXXXXXXXXX--XXXXXXXXXXXXXXXXXXX--||--|---XXXXXX---XXXXXXXXXXXXX---||---XXX-XXXX
