------------------------------------------------------------------------------------------------------------------------------------------------------------------------------------------------
-------------------------------------------------------o----------------------------------------------------------------------------------------------------------------------------------------
------------------------------------------------------------------------------------------------------------------------------------------------------------------------------------------------
------------------------------------------------------------------------------------------------------------------------------------------------------------------------------------------SS----
------------------------------------------------------------------------------------------------------------------------------------------------------------------------------------------------
----------------------------------o----------------------------------------------------------------------------------------------------oo----------------oooo-----------------------------------
--------%%%%%%%%----------------SSSS-----------------------------------------------------------o-----------------o-------------o------------------------------------------------ooo---SS-----oo-
---------||||||-----------------------------------o----------------------------------------------oo----o-------------------oo---------------------------------oo-U------------------------------
---------||||||----------------------------------%%%-------SS-----------------------------------%%%%%%%%%-------------------------------------------------------------------------------------SS
---------||||||-----------------------------------|----------------------------------------------|||||||--------------------------------------------------------------------------------------So
------%%%%%%%%%%----------######-------------SS---|-----%%%%%--------S@-----S@S---#--------------|||||||-%%%-------------#---------------------------2-TT--------------------------------#------
-------||||||||-----------------------------------|------|||---------------------##--------------|||||||--|---oo---------#-----------------------------TT--------------------------------#------
-------||||||||-----------------------------------|------|||--------------------###--------------|||||||--|-%%%%--------##----------------------TT-----TT----#--------------------------##------
-------||||||||-----------------------------------|------|||---o---k------k----####----k---g-----|||||||--|--||-----k---##---#----g-----------g-TT-----TT---##----------------------k---##------
XXXXXXXXXXXXXXXXXXXXXXXXXXXXXXXXXXXXXXXXXXXXXXXX-%%%%%%%%%%%%%%%XXXX-X--XXXXXXXXXXXXXXXXXXXXXXXX%%|XXXX%%%%--%%%XXXXXXXXXXXXXXXXXXXXXXXXXXXXXXXXXXXXXXXXXXXXXXXXXXXXXXXXXXX-----XXXXXXXXXX--XXXX
XXXXXXXXXXXXXXXXXXXXXXXXXXXXXXXXXXXXXXXXXXXXXXXX--|||||||||||||-XXXX-X--XXXXXXXXXXXXXXXXXXXXXXXX|||XXXXX||----|-XXXXXXXXXXXXXXXXXXXXXXXXXXXXXXXXXXXXXXXXXXXXXXXXXXXXXXXXXXX----XXXXXXXXXXX--XXXX
