------------------------------------------------------------------------------------------------------------------------------------------------------------------------------------------------
------------------------------------------------------------------------------------------------------------------------------------------------------------------------------------------------
------------------------------------------------------------------------------------------------------------------------------------------------------------------------------------------------
--------------------------------------------------------------------------------SSS---SS------------------------SSSSSSSSSSSSSSSSSS---S----------------------------------------------------------
----------------------------------------------------------------------------------------------------------------SSS-SSSS------------------------------------------------------------------------
---------------------------------------------------------------------------ooooo--------------------------------SSSSSSS--------S----------o-----------------------------------------------------
--------%%%%%%%%------SSSS----oo-------------------------------------------%%%%-S-------------------------------SSSSSSSSo---SSSS-----------------------Q---S------------------------------------
---------||||||-------o-----------------------------------------------------||--S-------------------------------------------------------------------------------oo-----o--oo--------------------
---------||||||-------------------------------------------------------------||--S---TT--------------------------------------------------------------------------%%%---%%%%%%%----#--------------
---------||||||-----------------------------------------------------------oo||------TT--------------------------S--oo------------TT-----------K------------------|-----|||||-----#--------------
------%%%%%%%%%%------------------------TT----TT-----------------------%%%%%%|----SS##SS------------------------SSSSSSS-------SS-TT-----TT---TT------SSS-----#---|-----|||||-----##-------------
-------||||||||----#--------------------TT----TT---------------#--------||||-|---------------------------------------------------TT--U--TT---TT--------------#---|-----|||||----###--------#----
-------||||||||-#--#-----#--------------TT----TT--------------##--------||||-%%---------------k--------oo------------------------TT-----TT--TT--------------##---|-----|||||----###-------------
-------||||||||-#-##-----#------g-gggg--TT----TT--------------##--------||||-||--------------###-------------k------gg---------g-TT---k-TT--TT-------k------##---|-----|||||----###-------##k---
XXXXXXXXXXXXXXXXXXXXXXXXXXX-XXXXXXXXXXXXXXXXXXXX---XXXXXXXXXXXXX%%%%%%%%%%%%-||-XXXXXXXXXXXXXXXXXXXXXXXXXXXXXXXXXXXXXXXXXXXXXXXXXXXXXXXXXXXXXXXXXXXXXXXXXXXXXXXX-|XXXXXXXXXX%%--XXXXXXXXXXXXXXXX
XXXXXXXXXXXXXXXXXXXXXXXXXXX-XXXXXXXXXXXXXXXXXXXX---XXXXXXXXXXXXX-||||||X|||--||-XXXXXXXXXXXXXXXXXXXXXXXXXXXXXXXXXXXXXXXXXXXXXXXXXXXXXXXXXXXXXXXXXXXXXXXXXXXXXXXX-|XXXXXXXXXX||--XXXXXXXXXXXXXXXX
