------------------------------------------------------S-SS--------------------------------------------------------------------------------------------------------------------------------------
-----------------------------------------------------SSSSSS-------------------------------------------------------------------------------------------------------------------------------------
------------------------------------------------------------------------------------------------------------------------------------------------------------------------------------------------
-----------------------------------------------------------------------------------------------------------------S------------------------------#-----------------------------------------------
------------------------------------------------------------------------------------------------------------------------------------------------------------------------------------------------
------------------------------------------------#Q-Q---SSSS-------------------------------------------------------------------------------------------------------------------oo----------------
--------%%%%%%%%------------------------------or------------------------------------------------%------%%%%--------------------------So---SSS-----r-rr-----------------------------------------S
---------||||||-------------------------------#%------------------------------------------------|--o%%%o||---%%%--------------------------------%%%%%%%%-----%%%----------------------oo--------
---------||||||------------------------------###------------------------------------------------|----|--||----|----------------#-----------------||||||-------|----------------------------U----
---------||||||----------------------------#####---------ooo------------------------------------|----|--||----|----------------#-----------------||||||----#--|---------------------------------
------%%%%%%%%%%---------TT----------------####--U-o-----------------So-----So----------%%%%%%--|----|--||%%--|-S--------------#-----S-------@SS-||||||----#--|--S-----TT--------------------SSS
-------||||||||----------TT----------------#####---------------S-------------------------||||---|----|--||||--|----------------#TT-----@---------||||||---##--|--------TT-----------------------
-------||||||||----------TT---------------######---K-------------------------------------||||---|----|--||||-%%%%-------------##TT---------------||||||--###--|--------TT-----------------------
-------||||||||----g-----TT-----#------g--######-----------------------------------------||||---|----|--||||--||-------------###TT-----g---------||||||-####--|---g----TT---------go------------
XXXXXXXXXXXXXXXXXXXXXX---XXX-XXXXXXXXXXXXXXXXXXX-XXXXXXX--------XXX--XXXXXXXXXXX-%%%%%%%-XXX|%%X%%%%%|%%%|||--||-------XXXXXXXXXXXXXXXXXXXXXXXXX-|||||XXXXXX--|XXXXXXXXXX-------XXXXXXXXXXXXXXXX
XXXXXXXXXXXXXXXXXXXXXX--XXXX--XXXXXXXXXXXXXXXXXXXXXXXXXX--------XXX--XXXXXXXXXXX--|||||--XX-|||--|||-|-|-|||--||-------XXXXXXXXXXXXXXXXXXXXXXXXX-|||||XXXXXX--|XXXXXXXXXX-------XXXXXXXXXXXXXXXX
