-----------------------K------------------------------------------------------------------------------------------------------------------------------------------------------------------------
-----------------------o---------------------------------------------------------------------------------------------------------------------------------------------ooo------------------------
-----------------------%--------------------------------------------------------------------------------------------------------------------------------------------%%%%%-----------------------
-----------------------|-----------------------------------------------------------------S------SSSSSSSS----SSSS-----------------------------------------------------|||------------------------
-----------------------|---------------------------------------------------------------------------------------------------------------------------------------------|||------------------------
-----------------------|------------------------------------------------------------------------------------------o----------------Q---S-----------------------------|||------------------------
--------%%%%%%%%-------|----------------oS-----o----------------------SSSS-S----Sooo---------Soo----------------------------------------------------------------%%%%-|||--------ooor-oooS-----oo
---------||||||-oo-----|----%%%%-------------------------------------------------------------------------------------------------------U-----o---#---------------||--||o-----%%%--%%%%%------S--
---------||||||-%%%----|-----||---------------------o------------------------------------------------------------------------------------------------------------||--|%%%-%%%-|----|||-----#-#--
---------||||||--|-----|-----||-------------------------------------------------o----------------------------------------ooo-------------------------------------||--|-|---|--|----|||-----#----
------%%%%%%%%%%-|-----|-----||-------------SSS----------TT-----------SS----SSS-S------------SS-%----------------------@-%%----------------------TT--------------||--|-|---|--|----|||-----#----
-------||||||||--|-----|-----||--------------------------TT-------------------------------------|------------------------||----------------------TT--K--TT-------||--|-|---|--r----|||---###----
-------||||||||--|-----|-----||--------------------------TT-------------------------------------|------------------------||----------------------TT-----TT-------||--|-|---|%%%%---|||--####---#
-------||||||||--|-----|-----||----k---------------------TT---###----kk----k-------kggg-----k---|----------k-------------||----------------------TT-----TT--k----||r-|-|rr-|-||----||#######---#
XXXXXXXXXXXXXXXX-|----%%%%%%%%%%XXXXXXXXXXXXXXXXXXXXXX---XXXXXXXXXXXXXXXXXXXXXXXXXXXXXXXXXXXXXXXXXX--XXXXXXXXXXXXXXXXXXXX||-----XXXXXXXXX-XXXXXXXXXXXXXXXXXXXXXX-%%%%|%%%%%|-||---XXXXXXXXXXXXXX
XXXXXXXXXXXXXXXX-|-----||||||||-XXXXXXXXXXXXXXXX--XXXX--XXXXXXXXXXXXXXXXXXXXXXXXXXXXXXXXXXXXXXXXXXX--XXXXXXXXXXXXXXXXXXXX||-----XXXXXXXXX-XXXXXXXXXXXXXXXXXXXXXX--||-|-|||-|-||-X-XXXXXXXXXXXXXX
