-------------------------------------------------------------------------------------------------------------------------------------------------------K---------------SSS-------------K--------
-------------------------------------------------------------------------------------------------------------------------------------------------------o------------SSSSSSS------------o--------
------------------------------------------------------------------------------------------------------------------------------------------------------%%%--------------S--------------%%%-------
------------------------------------------------------------------------------------------------SS----------------------------------------------SS-----|-------S-----------------------|--------
-------------------------------------------------------------------------------------------------------------------------------------------------------|---------------SSK-------------|-------o
---------------------------------------------------------------------------------------------------------oo--------------------------------------------|--------#--@Q-SSS--------------|------%%
--------%%%%%%%%----------------------------------SSSSSS----S---SSSSSSSS-----S---oo---SSSSS----S-2--------------SSSSSSSSo----SSS-----------------ro----|-------------QQQQS-------------|------||
---------||||||----------------------------------------------------------------------------------#------------oo--------------------------------%%%%---|---o--------------------%%-----|------||
---------||||||-------------------------------------------------------------------------------------o--------------------------------------------||----|--%%%-------------------||-----|------||
---------||||||------------------------------------------------o-o-------------oooo-----------------##-----------------------------------ooo-----||----|---|-----------------K--||-----|-ooo--||
------%%%%%%%%%%----------######-------TT-----------SSSSS----SSSSSSSS--------------------------------2----------SSSSS--------US----------%%%%%--S%|----|---|-----SS--SSSSS---U--||-----|%%%%--||
-------||||||||------------------------TT------------------------------K--------------------------------TT-------------K------------------|||---o||----|---|--------------------||-----|-||--oo|
-------||||||||------------------------TT----##-------------------------------------------------TT------TT----TT--------------------------|||---%%|----|---K--------------------||-----|-||-%%%%
-------||||||||---------------------gg-TT----##----k-g----k---------ggkk----k-------ggk---------TT------TT----TT---k-k-k----k------------#|||---|||----|---o-------k-------k----||or---rrrr--||-
XXXXXXXXXXXXXXXXXXXXXXXXXXXXXXXXXXXXXXXXXXXXXXXXXXXXXXXXXXXXXXXXXXXXXXXXXXXXXXXXXXXXXXXXXXXXXXXXXXXXXXXXXXXXXXXXXXXXXXXXXXXXXXXX-%%--XXXXXXXX---|||---%%%-%%%%---XXXX-X------XXX|%%%%%%%%%%%-||-
XXXXXXXXXXXXXXXXXXXXXXXXXXXXXXXXXXXXXXXXXXXXXXXXXXXXXXXXXXXXXXXXXXXXXXXXXXXXXXXXXXXXXXXXXXXXXXXXXXXXXXXXXXXXXXXXXXXXXXXXXXXXXXXX-||--X-XXXXXX---|||----|---||----XXXX-X-X----XXX|-|||||||||--||-
