------------------------------------------------------------------------------------------------------------------------------------------------------------------------------------------------
------------------------------------------------------------------------------------------------------------------------------------------------------------------------------------------------
------------------------------------------------------------------------------------------------------------------------------------------------------------------------------------------------
------------------------------------------------SSSSSSSSSSS-------------------------------------------------------------------------------------------------------------------------------------
------------------------------------------------------------------------------------------------------------------------------------------------------------------------------------------------
---------------------------------ooo-------oooo-----------------------------------------oo----------------------------------------------------oo------------------o------o---------------------o
--------%%%%%%%%----------------%%%%-------%%------------------S-%%---------------------------------------------------SSSS---SSS----------------------------------------------------------------
---------||||||------------------||--------||----#---------------||----------------------------------------ooo-o------o-------------------------------------------------------------------------
---------||||||------------------||--------||--------------------||-----------------------------------------------------------------------------------------------------------------------------
---------||||||------------------||-------o||--------------------||----------------------------------------------------k--------------------------o---------------------------------------------
------%%%%%%%%%%----------######-||---%%%%%%%---------------#----||-------------------------------TT------------------SQSS-------------@%%%%%-----------TT-------TT--2--TT-------------------#--
-------||||||||------------------||----|||||---------------##----||---------------TT-----TT---TT--TT-------------------------------------|||------------TT-------TT-----TT----TT-------TT---#---
-------||||||||------------------||----|||||---------tt---###----||------------#--TT-----TT---TT--TT----TT-------------------------------|||------------TT-------TT-----TT----TT-------TT--##---
-------||||||||------------------||----|||||------y--tt---###----||-----------g#--TT-----TT---TT--TT----TT--------or------------k--------|||------k-----TT-------TT---k-TT----TT--ggg--TT---k---
XXXXXXXXXXXXXXXXXXXXXXXXXXXXXXXX%%%%%%%%%%X|----XXXXXXXXXXXXXXXXX|XXXXXXXXXXXXXXXXXXXXXXXXXX--XXXXXXXXXXXXXXXXXX--%%%-XXXXXXXXXXXXXXXXXXXXXXX---XXXXXXXXXXXXXXXXXXXXXXXXXXXXXXXXXXXXXXXXXXXXXXXX
XXXXXXXXXXXXXXXXXXXXXXXXXXXXXXXX-||||||||-X|----XXXXXXXXXXXXXXXXX|XXXXXXXXXXXXXXXXXXXXXXXXXX---XXXXXXXXXXXXXXXXX--XX--XXXXXXXXXXXXXXXXXXXXXXX-X-XXXXXXXXXXXXXXXXXXXXXXXXXXXXXXXXXXXXXXXXXXXXXXXX
