------------------------------------------------------------------------------------------------------------------------------------------------------------------------------------------------
------------------------------------------------------------------------------------------------------------------------------------------------------------------------------------------------
------------------------------------------------------------------------------------------------------------------------------------------------------------------------------------------------
------------------------------------------------SSSSSSSSSSSSSSSS------------------------------------------------SSSSSSSSSSSSSSSSSS------------------------------SS-----K------------------------
-----------------------------------------------------SS---------------------------------------------------------SSS-----------------------------------------------------------------------------
-----------------------------------------------------------------------------------------oo-oooo---------o------SSSSSSSSSSSoSSSS---------------------------------------%%-------Q---------------
--------%%%%%%%%----QSQS-------S-------------------o------------------------------------------------------------SSSSSSSSSSSSSSSS---------------------------#----%%-----||------------QQQQ-------
---------||||||-----------------------------oo-------------------------------------------------o-#-------------#-----------------------o---oo--------------#----||-----||-----------------------
---------||||||-------------------------------------------Sy-SSS----------------------------------------------##------------------------------------TT---#-#----||-----||-----------------------
---------||||||--o-----------------------oo----------------------------------SS----------ooo-----------------###Soooo---------oo--------------------TT----------||-----||------------------S----
------%%%%%%%%%%------------------------------------------##----S------------------------%%%------------TT--####SSSSS--------##S--------------------##----------%|-----||--------##----#--------
-------||||||||--------TT--------------------------------###------------------------------|-------------TT--####-------TT----#---------TT-----------------------||-----||--#---#----------------
-------||||||||--------TT---------------------------tt--####-----------------%%-----------|------TT-----TT-#####-------TT--####--------TT----TT---------TT---#--||-----||--#---#----------------
-------||||||||--------TT---k-----------------------tt--####-----------------||-----------|------TT-----TT-#####-------TT--####-k------TT----TT---------TT---#--%%%----||-##--##------k---------
XXXXXXXXXXXXXXXXXXXXXXXXXXXXXXXX-XXXXXXXX---%%%%--XXXXXXXXXXXXXX----------%%%%%--%%%%%----|%%%%-XXXXXXXXXXXXXXXXXXXXXXXXXXXXXXXXXXXXXXXXXXXXXXXXXXXXXXXXXXXXXXXX-|---XXXXXXXX-X-XXXXXXXXXXXXXXXX
XXXXXXXXXXXXXXXXXXXXXXXXXXXXXXXX-XXXXXXXX----||---XXXXXXXXXXXXXX-----------|||----|||-----|-||--XXXXXXXXXXXXXXXXXXXXXXXXXXXXXXXXXXXXXXXXXXXXXXXXXXXXXXXXXXXXXXXX-|---XXXXXXXX-X-XXXXXXXXXXXXXXXX
