------------------------------------------------------------------------------------------------------------------------------------------------------------------------------------------------
------------------------------------------------------------------------------------------------------------------------------------------------------------------------------------------------
------------------------------------------------------------------------------------------------------------------------------------------------------------------------------------------------
-------------------------------------S--------------------------------------------------------------------------SSSSSSSSSSSSSSSS----------------------------------------------------------------
----------------------------------------------------------------------------------------------------------------SS---SSS------------------------------------------------------------------------
--------------------------------------------------------------------------------------------------o--------------S---S---------S----------------------------------------------------------------
--------%%%%%%%%-----------------------------o---------------------------------S-------------------------------#-S---SSSoSSSSSSS--r-rro%%%---------------------------SS-oS-----o----------------
---------||||||--ooo-------ooo--------------------------------------------------------------------------------##----------------%%%%%%%%|----%%%-o-----------------------------------------#----
---------||||||---------------------------------------------------------------------------------------------####-----------------||||||-|-----|------------------------------------------###----
---------||||||------------------------------------------------------------###-----------------------------#####o----------------||||||-|-----|-----------------------------------------###-----
------%%%%%%%%%%---------#------------------------------------------------###-##---------------------2--TT-#####S-SSSo-----------||||||-|--#--|------------------###-----#--------------##------
-------||||||||---------##-------------------------------------#----------###-##------------------------TT-#####----------------o||||||-|--#--|---TT-----------#--##----####-----------###------
-------||||||||--------###-------------------------o---------------------####-##----------------TT------TT-#####----------------%%|||||-|#-#-#|---TT-----------#---#---####--#--------####--TT--
-------||||||||-------####----------gy-----kk-----%%-----#-----#----g-g-#####-##-------------g--TT------TT-#####-----g--------k-|||||||-|#-#-#|---TT-----------#--##--#####--#-------#####--TT--
XXXXXXXXXXXXXXXXXoXXXXXXXXX-----XXXXXXXXXXXXXXXX--||-----XX--X-XXXXXXXXXXXXXXXXX---XXXXXXXXXXXXXXXXXXXXXXXXXXXXXXXXXXXXXXXXXXXXX||||||XXXXXX-X|XXXXXXXXXXXXX---XXXXXXXXXXXXXXXXXXXXXXXXXXXXXXXXX
XXXXXXXXXXXXXXXXXXXXXXXXXX------XXXXXXXXXXXXXXXX--||-----X---X-XXXXXXXXXXXXXXXXX---XX-XXXXXXXXXXXXXXXXXXXXXXXXXXXXXXXXXXXXXXXXXX||||||XXXXXXXXXXXXXXXXXXXXXX---XXXXXXXXXXXXXXXXXXXXXXXXXXXXXXXXX
