-----------------------------------------------------------------------K------------------------------------------------------------------------------------------------------------------------
-----------------------------------------------------------------------o------------------------------------------------------------------------------------------------------------------------
----------------------------------------------------------------------%%%-----------------------------------------------------------------------------------------------------------------------
-------------------------------------------------#---------------------|--------SSSSSSSSSSSSSSSS------------------------------------------------SS----------------------------------------------
-----------------------------------------------------------------------|------------------------------------------------------------------------------------------------------------------------
-----------------------------------------------------------------------|---------------------------------------------------------------------------------%%-------------------------------------
--------%%%%%%%%-----------------SS@QQQS-------------------------------|---------------------------------------------------------------------------------||-------------------------------------
---------||||||---------------------------------------------------r----|----------%%---------------------------------------------------o-----------------||---%%------oo------------------------
---------||||||--------------------------------------------#----%%%%%%-|----------||---------------------------------------------------------------------||---||---------------------------y#---
---------||||||-------------------------------------------###----||||--|----------||---------------------------------------------------k------------%%%%-||---||--------------------------###---
------%%%%%%%%%%----------######--QQ---UQS---SS-----------###----||||--|--------%-||-----###----#---####-----SSS-SSS-------------------#-------------||--||---||--------------------------###---
-------||||||||------------------------------------------####----||||--|-----o--|-||-----###----#--------------------------------------#-------------||--||---||-------------------------####---
-------||||||||-----------------------------------------#####-TT-||||--|----%%%%|-||---#####----#--------------------------------------##----K-------||--||---||------------------------#####---
-------||||||||-----------------------------------g----#####k-TT-||||--|-----||-|-||---#####----#---------kkk------------------o-----####-------%%%--||--||---|#-----------------------######---
XXXXXXXXXXXXXXXXXXXXXXXXXXXXXXXXXXXXXXXXXXXXXXXXXXXXXXXXXXXXX-XX-||||-%%%%%%-||-|-XXXXXXXXXX----XXXXXXXXXXXXXXXXXXXXXXXXXXXXXXXXXXXXXXXXX----X---|---|XXXXXXXXXX--XX--X--S%%----XXXXXXXXXXXXX---
XXXXXXXXXXXXXXXXXXXXXXXXXXXXXXXXXXXXXXXXXXXXXXXXXXXXXXXXXXXXX-XX-||||--||||--||-|-X-XXXXXXXX----XXXXXXXXXXXXXXXXXXXXXXXXXXXXXXXXXXXXXXXXX--------|---|XXXXXXXXXX--XX--X---||----XXXXXXXXXXXXX-o-
