-------------------------------------------------------------------------------------------------------------------------------------------------------K---------------S------------------------
-------------------------------------------------------------------------------------------------------------------------------------------------------o---------------S-S----------------------
------------------------------------------------------------------------------------------------------------------------------------------------------%%%--------------S------------------------
--------------------------------SSSSSSSSSSSSS---SSSSSSSSSSSSSSSSSSSSSSSS-----SSS-----------------------------------------------------------------------|------------------------SSSSSSSo-----SSS
------------------------------------------------SSSSSSSSSS--SS-----------------------------------------------------------------------------------------|---------------S------------------------
------------------------------------------------SSSSSSSSSS--SSoS---------------------------------------------------------------------------oo----------|--------------oSS-@---------------------
--------%%%%%%%%----------------------Soo-----oSSSSSSSSSoSSSSSSS----------------------------------------------------------------%%%--------%%----------|--------------QQQ-----------------------
---------||||||------------------------------------------------------------------------------------------------------------------|---------||---%%-----|-------------------ooo------------------
---------||||||-------------------------------------------------S%---------------------------------------------------------------|---------||---||-----|-------------------------------%%--%%---
---------||||||---------------------------------ooooooo-------oo-|--#------------------------------------------------------------|---------||---||-----|-------------------SSSS--------||--||---
------%%%%%%%%%%---------#----------------------TTkSSSS------SSS-|-------------------S#--------------------------#------------SS-|---2-----||---||-----|-------#----SSSQS--------------||--|o---
-------||||||||---TT----##--------#-------------TT-----K---------|--------------TT-----------------------------------------------|---------||---||-----|-------#----------------o------||--||---
-------||||||||---TT---###-----#######----------TT---------------|--------------TT-------TT--------------------------------------|---------||---||-----|-------#----------------%------||--||---
-------||||||||---TT--####-----#######k----kg---TT----kk----k---g|-------g---rr-TT---kk--TT---##-g-----k-g-----g----------k-k----|---------||--g||-----|rr-----#---k------------|------||--ooo--
XXXXXXXXXXXXXXXX-XXXXXXXXX-----XXXXXXXXXXXXXXXXXXXXXXXXXXXXXXXXXXXXXXXXXXXXX%%%XXXXXXXXXXXXXXXXXXXXXXXXXXXXXXXXXXXXXXXXXXXXXXXXXX%%-XXXXXXXXXXXX||----%%%%%%----XXXXXXXXX---XXXX|-XXXXXXXX%%%%%X
XXXXXXXXXXXXXXXXXXXXXXXXXX-----XXXXXXXXXXXXXXXXXXXXXXXXXXXXXXXXX--XXXXXXXXXXX|-XXXXXXXXXXXXXXXXXXXXXXXXXXXXXXXXXXXXXXXXXXXXXXXXXXXX-XXXXXXXXXXXX||-----||||-----XXXXXXXXX---XXXX|-XXXXXXXXXX|X-X
