-------------------------------------------------------------------------------------------------------------------------------------------------------K----------------------------------------
------------------------------------------------------------------------------------------------------------------------------------------------------------------------------------------------
------------------------------------------------------------------------------------------------------------------------------------------------------------------------------------------------
----------------S--S-SSS-------------SSSSSSSSSSSSSSSSSSSSSSSSSSS--------------------------------------------------------------------------------------------------------------------------------
------------------------------------------------S-----------------------------------------------------------------------------------------------------------------------------------------------
-------------------------------------------------------------------------------o-----------------oo------------------------------------------------------oo-------ooo---------------------------
--------%%%%%%%%-----------------------------------------------o---------------------QQQQ-------------------------------------------SSSS-------S----------------%%%%%%--------------------------
---------||||||------------------------------------------------#-------------------------------------------------------------------------------------------ooooo-||||---------------------------
---------||||||------------##-------------##-------------------#---------------------------------------------------------------------------#---------------------||||---------------------------
---------||||||-----------###------------###---------------#-##------------------------------------------ooo---------------------o-------------------------------||||----oooo-------------------
------%%%%%%%%%%--------#####------------###--------------#####------------#-#-2##-----------S----------%%%%-----------------------------------------------------||||---%%%%%%------------------
-------||||||||---------#####-----TT----###--------------######--------TT--###---------------------------||--o-o-------------------------------------------------||||----||||-------------------
-------||||||||-------#######-----TT--######---TT-------#######--------TT--###---------------------------||--%%--------------------------------------------------||||----|||%%%%----------------
-------||||||||-----#########--#-###########---TT------########---ggg#-TT--###-----k-------k-------r-----||--||--------g-------#----ggg--##-#------------------o-||o|----|||-||----------k---oo-
XXXXXXXXXXXXXXXXXXXXXXXXXXXXXXXXXXXXXXXXXXXXXXXXXXXXXXXXXXXXXXXXXXXXXXXXXXXXXXXXXXXX-XXXXXXXXXXX-%%%%%%%%%|--|%%%%%%--XXXXXXXXXXXXXXXXXXXXXXXXXX------XX---%%%%%-%%%%-%%%%%|-||-XXXXXXXXXXXXXXXX
XXXXXXXXXXXXXXXXXXXXXXXXXXXXXXXXXXXXXXXXXXX-XXXXXXXXXXXXXXXXXXX-XXXXXXXXXXXXXXXXXXXX-XXXXXXXXXXX--|||||||-|--|-|X||---XXXXXXXXXXXXXXXXXXXXXXXXXX------XX----|||---||---|||-|-||-XXXXXXXXXXXXXXXX
