-----------------------------------------------------------------------------------------------------------------------------------------------------------------------K------------------------
-----------------------------------------------------------------------------------------------------------------------------------------------------------------------o------------------------
------------------------------------------------------------------------------------------------------------------------------------------------------------------------------------------------
--------------------------------SSSSSSSSSSSSSSSS--------------------------------SSSSSSSSSSSSSSSSSSSSSSSSSSSSSSSS----------------------------------------------------------------SSSSSSSSSSSSSSSS
-------------------------------------SSS--------------------------------------------------------SS---S--------------------------------------------o---------------------------------------------
------------------o--------ooooo------------------o---------------------------------------------SS---SSS------SS------------------------------oo------------------------------------------------
--------%%%%%%%%-----------------------------S-------------------------------------------------S-----SS---SSoSSS------SS--------------------------S@-SSSSS--------------------------------------
---------||||||----------------o---------------------------------------------------------------------------------------------------------------------------------------o---o--------------------
---------||||||-------------------------------------------------------------------------------------------------------------------------------------------------------%%%-%%%-------------------
---------||||||----------oooo-------ooo-------oS-------------------------------------------------------------------------------o--------------------------------r------|---|--------------------
------%%%%%%%%%%---------%%%%---S-----S----------------TT-----------------------------------------------------------SSSSSSS--------------%%%-----QQQQSUS-----S--%%%----|---|--------------------
-------||||||||-----------||--o------------------------TT---TTTT--TT---TT----TT-----------------------------------------------------------|--ooo-----------------|-----|---|-------------#------
-------||||||||-----------||---------------------------TT---TTTT--TT---TT----TT--------------------------#------------------------------#-|----------------------|-----|---|%%%%--------##------
-------||||||||-----------||-----------------o--g-gg-g-TT---TTTT--TT---TT----TT------g-k-g-----g------g--#-----g------------------gg----#-|--------k-------------|-----|---|-||--------####-----
XXXXXXXXXXXXXXXX--%%%%----||----XXXXXXXXXXXSXXXXXXXXXXXXXXXXXXXXXXXXXXXXXXXXXXXXXXXXXXXXXXXXXXXXXXXXXXXXXXXXXXXXXXXXXXXXXXXXXXXXXXXXXXXXXXXXXXX-XXXXXXXXXX--XXXX-%%%--%%---|-%%%XXXXXXXXXXXXXXXX
XXXXXXXXXXXXXXXX---||-----||----XXXXXXXXXX---XXXXXXXXXXXXXXXXXXXXXXXXXXXXXXXXXXXXXXXXXXXXXXXXXXXXXXXXXXXXXXXXXXXXXXXXXXXXXXXXXXXXXXXXXXXXXX---X-XXXXXXXXXX--XXXX--|---||---|--|-XXXXXXXXXXXXXXXX
