-----------------------------------------------------------------------------------------Q--------------------------------------------------------------------------------------
--------------------------------------------------------------------------------------------------------------------------------------------------------------------------------
--------------------------------------------------------------------------------------------------------------------------------------------------------------------------------
----------------SSSSSSSSSSSSSSSS----------------SSSSSSSSSSSSSSS-----------------------------------------------------------------------------------------------------------------
-------------------SSSSSSSSSS-o-------------------------------------------------------Q---g-------------------------------------------------------------------------------------
--------------------SSSSSS----SS----------------------------------------------------%%%%%%%%%%----------------------------------------------------------------------------------
--------%%%%%%%%-SSSSSSSoooo--SSSS-----------SSo-------------------------------------||||||||--------USK---------------S--------------oo-----------------------o----------------
---------||||||---------SSS----------------------------------------------------------r||r||||------SSS--------------------------------------------------------------------------
---------||||||----S--SSSSSS--------------------%%%%-------------------SSS--------%%%%%%%%%%|-----SSSS---------------------------------SSSS-------------------------------------
---------||||||-K--------------------------------||---------------------SSS----#---||||||||-|----------------------g---------R--------------------------------------------------
------%%%%%%%%%%S--SSSSSSS--SS------------S------||%-%%%%%%%%%%%--------------#----||||||||-|------------------#-------SS%------------------##----QQ----Q---------------------#-
-------||||||||----------------------------------|||--|||||||||--------------##-TT-||||||||-|-----------------##---------|---#-------------###--------------------------------#-
-------||||||||-S-----S-SSSS----------#----------|||--|||||||||-------------###-TT-||||||||-|-----------------##---------|--##-------#----####------------------------------###-
-------||||||||-----------------------#----------|||--|||||||||---kg-------####-TT-||||||||-|-------------#--###--------g|-###-------#-#-#####--gg--g-k-----------Kg-k------###-
XXXXXXXXXXXXXXXX----------------XXXXXXXXXXXXXXXX-|XX--|||||||||-XXXXXXXXXXXXXXXXXX-||X||||%%%%%-XXXXXXXXXXXXXXXXX----XXXXXXXXXXXXXXXXXXXXXXXXX-XXXXXXXXXXXXXXXXXXXXXXXXXXXXXXXXX
XXXXXXXXXXXXXXXX----------------XXXXXXXXXXXXXXXX-|XX--|||||||||-XXXXXXXXXXXXXXXXg--||X||g|-|||--XXXXXXXXXXXXXXXXX----XXXXXXXXXXXXXXXXXXXXXXXXX-XXXXXXXXXXXXXXXXXXXXXXXXXXXXXXXXX
