------------------------------------------------------------------------------------------------------------------------------------------------------------------------------------------------
------------------------------------------------------------------------------------------------------------------------------------------------------------------------------------------------
------------------------------------------------------------------------------------------------------------------------------------------------------------------------------------------------
----------------------------------------------------------------SSSSSSSSSSSSSSSS--------------------------------------SSSSS---------------------------------------------------------------------
----------------------------------------------------------------------------------------------------------------------S-------------------------------------------------------------------------
------------------------------------------------------------------------------------------------------------------------------------------------------------------------------------------------
--------%%%%%%%%----------SSS-------------------------------------------o-----------------------SooS-----S---SoSS--S---------oSo-----------------------------------S----------------------------
---------||||||------------------------------------------------#-----------------------------------------------------------------------------------------------------------------------o--------
---------||||||---------------------------------------------------------------------------------------------------------------------------------------------------------------------------------
---------||||||------------------------------------------------------------------oo-o---------------------------Soo----------------------------------------------------------o-o----------------
------%%%%%%%%%%-------S-----SS-Q------------------------###------------------------------------QS--QSQ-----SSSSSSSS-----------------------#---------------------##----------SS-----------------
-------||||||||-----------------------------------------####-#-----------------------------------------------------------------------------#------TT-----TT-------------------------------------
-------||||||||----------------------------------------#####-#---------------------------TT----------------------------------------------#-#------TT-----TT-------------------------------------
-------||||||||----y-------------------------------##-#####--#--k------------------------TT--##g-------------------kgg-----g---g-------g####------TT-----TT----g------------------------------oo
XXXXXXXXXXXXXXXXXXXXXXXXXXXXXXXXXXXXXXXXXX--XXXXXXXXXXXXXXX--X--XXXXXXXXXXXXXXXXXXXXXXXXXXXXXXXXXXXXXXXXXXXXXXXXXXXXXXXXXXXXXXXXXXXXXXXXXXXXXXXXXXXXXXXXXXXXXXXXXXXXXXXXXXXXXXXX--XXXXXX---%%%%%
XXXXXXXXXXXXXXXXXXXXXXXXXXXXXXXXXXXXXXXXXX--XXXXXXXXXXXXXXX--X--XXXXXXXXXXXXXXXXXXXXXXXXXXXXXXXXXXXXXXXXXXXXXXXXXXXXXXXXXXXXXXXXXXXXXXXXXXXXXXXXXXXXXXXXXXXXXXXXXXXXXXXXXXXXXXXX--XXXXXX----|||-
