------------------------------------------------------------------------------------------------------------------------------------------------------------------------------------------------
------------------------------------------------------------------------------------------------------------------------------------------------------------------------------------------------
------------------------------------------------------------------------------------------------------------------------------------------------------------------------------------------------
----------------SSSS----------------------------SSSSSS-------------------------------------------------------------------------------SSS---------------SSSSSSSSS----------------------S---------
------------------------------------------------------------------------------------------------------------------------------------------------------------------------------------------------
----------------------------------------------------------------------------------o-----------------------------roo--------oooo%-----------------------------------------------o----------------
--------%%%%%%%%-------------------------------S----------------------------------------------------------------%%%%------%%%%%|-oo----------oo-------------------------------------------------
---------||||||---------------%%---------------------------------------------------------------------------------||--------|||-|------------------------------------------------------o---------
---------||||||---------------|#---------------------------------------------------------------------------------||--------|||-|----------#--SSS------------------------------------------#--S--
---------||||||---------------|#-o------------------------------------------------------------------------SS-----||----o-oooo|-|---------#SS-SSS-----------------------------------------#S-----
------%%%%%%%%%%--------------|#--------------------------------------------------------TT----TT-----------------||----%%%%%%|-|S--------##----S----SSS---------------------#------------#------
-------||||||||---------------##--------------------------------------------------TT----TT----TT-----------------||-----||||-oo|--------###--------------@------------------#------------#------
-------||||||||--------------###-------TT-----------------------------------------TT----TT----TT-----------------||-----||||%%%%------#####-----TT---------------------TT--##----------####-----
-------||||||||--------------###--g----TT---g------------------g----gg------k-----TT----TT----TT-----------------||r---rr|||-||-----#######-----TT----kk---------gg----TT---#--------g-####-----
XXXXXXXXXXXXXXXXXXX-XXXXXXXXXXXXXXXXXXXXXXXXXXXXXXXXXXXXXXXXXXXXXXXXXXXXXXXXXXXXXXXXXXXXXXXX--XXXXXXXXXXXXXX-U-X-%%%%%%%%%%%-||-XXXXXXXXXXX-XXXXXXXXXXXXXXXXXXXXXXXXXXXXXXXXXXXX--XXXXXXXXXX---X
XXXXXXXXXXXXXXXXXXX--XXXXXXXXXXXXXXXXXXXXXXXXXXXXXXXXXXXXXXXXXXXXXXXXXXXXXXXXXXXXXXXXXXXXXXX---XXXXXXXXXX-X--X-X--|||||||||--||-XXXXXXXXXX--XXXXXXXXXXXXXXXXXXXXXXXXXXXXXXXXXXXX--XXXXXXXXXX---X
