-------------------------------------------------------------------------------------------------------k---------------k-----------------------------------------------K------------------------
-------------------------------------------------------------------------------------------------------S---------------------------------------------------------------o------------------------
----------------------------------------------------------------------------------------------------------------------------------------------------------------------%%%-----------------------
--------------------------------SSSSSSSSSSSSSSSSSSSSSSSSSSSSSSSS------------------------------------------------------------------------------------------------S------|------------------------
------------------------------------------------SS---------------------------------------------------------------------------------------------------------------------|------------------------
-----------------------------------------------------------------------------------------------------------------------------------------------o-----------------------|----------o-------------
--------%%%%%%%%-----QQQSSS--SSS--------------------------SS--SS----------------S-SSS-------------------------------------------S---S----------S---------------S-rrrrrr|------r-----------------
---------||||||------------------------------------------------------------------------------------------------o------------------------------------------------%%%%%%%%----%%%%----------------
---------||||||--------------------------##---S------------------------------------------------------------------------------------------------------------------||||||------||-----------------
---------||||||-----------------o--------#-----------------------------------------------------------------------------------------------------------------------||||||------||-----------------
------%%%%%%%%%%#---QQQQQQ---o---------TT#-------------------------------------------------------------%%%%%%-----------%%%%%%--SSQ----SSSSSS%SS-----------------||||||------||--------#--------
-------||||||||------------------------TT#--TT------------------------------------------------K---------||||-------------||||----------------|-----------TT------||||||------||-----------------
-------||||||||-----------------------####--TT-TT-----tt------------------------------------------------||||-------------||||----------------|-----------TT------||||||----K-%%%----------------
-------||||||||---oy--------k--------#####--TT-TT-----tt-------k--kgg----##---k----kgg------kkk---------||||-------o-----||||-----gggg-------|----gggg---TT------||||||-------|---g---------k--#
XXXXXXXXXXXXXXXXXXXXXXXXXXXXXXXXXXXXXXXXXXXXXXXXXXXXXXXXXXXXXXXXXXXXXXXXXXXXXXXXXXXXXXXXXXXXXXXX%%%%%%%%%|||-%%%-%%%%%%%%XX|%%--XXXXXXXXXXXXXXXXXXXXXXXXXXXXXXXX-|||||%%%-%%%-|-XXXXXXXXXXXXXXXX
XXXXXXXXXXXXXXXXXXXXXXXXXXXXXXXXXXXXXXXXXXXXXXXXXXXXXXXXXXXXXXXXXXXXXXXXXXXXXXXXXXXXXXXXXXXXXXXX-|||||||-|||--|---||||||-XX|||--XXXXXXXXXXXXXXXXXXXXXXXXXXXXXXXX-|||||-|---|--|-XXXXXXXXXXXXXXXX
