---------------------------------------K--------------------------------------------------------------------------------------------------------------------------------------------------------
---------------------------------------o--------------------------------------------------------------------------------------------------------------------------------------------------------
------------------------------------------------------------------------------------------------------------------------------------------------------------------------------------------------
--------------------------------------------------------------------------------------------------------------------------------SSSSSSSS--SS----------------------------------------------------
-------------------------------------------------------------------------------------------------------------------------------------------------------------------------------o----------------
------------------------------------------------------------------------------------------------------------------------------------------------------------------------------------------------
--------%%%%%%%%--S-----------oo%%%%----------------------------------SS----------------------------SSSSSSSSSSSS-------S----------------------------------------------QQQ---------oo--SSoSS-----
---------||||||------------------||----------------------------o------oo---oo------------------------------------------------------------------#------------------------------------------------
---------||||||------------------||----------------------------#--------------------------------------------------------------------------------------------------------------------------------
---------||||||------------S-SS--||----------------------------#----------------------g---------------------------------------------------------------------------------------------------------
------%%%%%%%%%%SSQS-------------||---------------------------##--So-------------#---##--------------SSS----SSSS----------%--------------------------------------###------------SS------Q----SS-
-------||||||||------------------||---------------------------##-----------------#----------------------------------------|---------------##--#------------------###----------------------------
-------||||||||--------------K---||----------------------TT---##--------#--------#----------------------------------------|---------------###-##-----------------#-------TT---------------------
-------||||||||------------------||----------goo---------TT--###------##---------#--------------------------k--------k---#|-------k-------###-##---------------###----kk-TT----#---------------g
XXXXXXXXXXXXXXXXXXXXXXXXXX--XXXX%%%%-%-XXXXXXX%XX-%XXXXXXXXXXXXXXoXXXXXXXX---XXXXXXXXXXXXXXXXXXXXXXXXXXXXXXXXXXX-XXXXXXXXXXX----XXXXXXXXXXXXXXXX----XXXXXXXXXXXXXXXXXXXXXXXXXXXX--XXXXXXXXXXXXXX
XXXXXXXXXXXXXXXXXXXXXXXXXX--XXXX-||--|-XXXXXXXXXX-|-XX---XXX-XXXXXXXXXXXXX---XXXXXXXXXXXXXXXXXXXXXXXXXXXXXXXXXXX--XXXXXXXXXX----XXXXXXXXXXXXXXXX----XXXXXXXXXXXXXXXXXXXXXXXXXXXX--XXX-XXXXXXXXXX
