------------------------------------------------------------------------------------------------------------------------------------------------------------------------------------------------
---------------------------------------------------------------------------------K--------------------------------------------------------------------------------------------------------------
------------------------------------------------------------------------------------------------------------------------------------------------------------------------------------------------
----------------------------------------------------------------SSSSSSSSSSSSSSSS--------------------------------SSSS-----------S-----------------------------------------SSSSSSS----------------
------------------------------------------------------------------------------------------------------------------------------------------------------------------------------------------------
------------------------------------------------------------------------o------------------------------------------------------------------oo---------------------------------------------------
--------%%%%%%%%-------------------------------------------------%%%---%%%------SSSo--SSo------S-------------S-----------------------QQQQ------------SS----------oo----%%-----------------------
---------||||||------------------------o--------------------------|-----|------------------------------------S---#----------------------------oo---------------#%%%%---||-----------------------
---------||||||-----------------%%%%--%%%-%%%---------------------|-----|------------------------------------S-------------##--------------------------------##--||----||-----------------##----
---------||||||------------------||----|---|----------------------|-----|-------o--gg--------------------------------------##-------------------------------###--||----||--S-S------------##----
------%%%%%%%%%%----------######-||----|---|------S------S-------%|-----|-------S--##SSSS----------oS-U--------------2-----##----#-----#--------------------###--||----||--#-------------##-----
-------||||||||------------------||----|---|------------#--------||-----|-------------------------------------K-TT-----TT--##----#------------------------#-###--||----||--S------------###-----
-------||||||||------------------||----|-TT|----------###--------||-----|--------------------------------K------TT-----TT--##----#------------------------#####--||----||#-K-----------####-----
-------||||||||------------------||----|-TT|---#------###--------||-----|--------------------#-g---k-----S--k---TT-----TT--##--###----------------gggg---######--||#---||#--------g---#######---
XXXXXXXXXXXXXXXXXXXXXXXXXXXXXXXX-||-XXXX-XXX---XXXXXXXXXXX----XX-||-XXXXXXXXXX-XXXXXXXXXXXXXXXXXXXXXXXXXXXXXXXXXXXXXXXXXXXXXX--XXXXXXXXXXXXXXXXXXXXXXXXXXXXXXXXX-|XX---X|X%%%%--XXXXXXXXXXXXXXXX
XXXXXXXXXXXXXXXXXXXXXXXXXXXXXXXX-||-XXXX-XXX---XXXXXXXXXXX----XX-||XXXXXXXXXXX-XXXXXXXXXXXXXXXXXXXXXXXXXXXXXXXXXXXXXXXXXXXXXX-XXXXXXXXXXXXXXXXXXXXXXXXXXXXXXXXXX-|XX--XX|X-||---XXXXXXXXXXXXXXXX
