-------------------------------------------------------------------S--S---S---------------------------------------------------------------------------------------------------------------------
------------------------------------------------------------------SS-SS--SS---------------------------------------------------------------------------------------------------------------------
------------------------------------------------------------------------------------------------------------------------------------------------------------------------------------------------
----------------SSSS-----SSSSS-----------------------------------SSSSSSSSSSSSSSS------------------------------------------------------SSSSSSSSSSSSSSSSSS--------SSS---SS------------------------
---------------------------------------------------------------#-------S------------------------------------------------------------------------------------------------------------------------
----------------------------------------------------------------------SS-----g---------------------------------o------------------------------SS------------------------------------------------
--------%%%%%%%%----------------%--------------------------------So--SSS-----S-----------------S-----QQQoS-----S------SSS-------SSSSSSSS-----SSS-oo----SS---------------------------------------
---------||||||-----------------|-------------------------------------------------------------------------------So------------------------------SS%%%%%------------------------#S------------%%%
---------||||||-----------------|----------------------------------------------S-----------------------------o----------------------------------S--|||-----%%-------------------%%--%%--------|#
---------||||||-----------------|------------#---------------------------------S-----------------g--------------S-----------------ggg----------oS--|||-----||-----------------#o||--||--------|#
------%%%%%%%%%%----------------|------------#-------------------SSSSSSSS------S------------S@SS##Q-QSSS----S@SS----------------SSSSSS----------S--|||-----#|----------------##-||--||--------|#
-------||||||||----------TT-----|------tt----#------------------SSSSSSSSSS-----------------------------------------------#------SSSSSSSS-----------|tt---#-#|---#----------####-||--||--------|#
-------||||||||----------TT-----|------tt----#--------------------SSSSSSSS---------------------------------------------###---------SS--------------|tt---#-#|---#----------####-||--||--------|#
-------||||||||------k-#-TT-----|------tt----#----#------------#--SSSSSSSS------------------------gk------k----------#####-------SSSSS-------------|tt---#-#|---#--------#-####-||--||--rrr---|#
XXXXXXXXXXXXXXXXXXXXXXXXXXXXXXXXX%XXXXXXXXXXXX--XXXXXXXXXXXXXXXX-XXXXXSSSS---XXXXXXXXXXXXXXXXXXXXXXXXXXXXXXXXXXXXXXXXXXXXXXXXXXXXXXXXXXXXXXXXXXXXXXXXXXXoXXX|---XXXXXXXXXXXXXXX-|%%%||%%%%%%%-|-
XXXXXXXXXXXXXXXXXXXXXXXXXXXXXXXXXXXXXXXXXXXXXXX-XXXXXXXXXXXXXXXXXXXXXXXXXX---XXXXXXXXXXXXXXXXXXXXXXXXXXXXXXXXXXXXXXXXXXXXX-XXXXXXXXXXXXXXXXXXXXXXXXXXXXXXXXX|---XXXXXXXXXXXXXXXX|-|-||-|||||--|-
