------------------------------------------------------------------------------------------S------------------------------------------------------------S----------------------------------------
------------------------------------------------------------------------------------------S-----------------------------------------------------------------------------------------------------
------------------------------------------------------------------------------------------------------------------------------------------------------------------------------------------------
----------------------------------------------------------------SSSSSSSSSSSSSSSS-------SSSSSSS------------------------------------------------------------------SSSSSSSSSSSSSSSS----------------
-----------------------------------------------------------------------------------------------------------------------------------------------o----------------SS--SS--------------------------
-----------------------------------------------------------------------------------------------------------------------------------------------%-----------------S-------------S----------------
--------%%%%%%%%--------------------------------SooS--SSo-----o------------------------------S---------SSS----------------------%--------%%%%%%|-----------------SSSS--------SSS----------------
---------||||||--------o---------------------------------------------------------------------S----------------------------------|---------||||-|-----------------------------------------------#
---------||||||-----------------------------------------------SS----------------------------------------------------TT----------|---------||||-|---------------------------y-SSS---------------#
---------||||||----------------------------------------o---S--oo--------------------g---------------------SSSSS-----TT----------|--------oooo|-|-----------o----o---------##---o--------------##
------%%%%%%%%%%------------------TT------------SSSSS-SSS----SSS-----2-------------SSSS-----------------------------###---------|-------%%%%%|-|--------%%%%----S--------###------------------##
-------||||||||-------------------TT----TT---TT------------------------------#--TT-SSSS-----------------------------------------|--------|||-ooo---------||-------------####------------------##
-------||||||||----------------#--TT----TT---TT------------------------tt----##-TT-SSS------------------------------------------|--------|||%%%%---------||------------#####----------tt-----###
-------||||||||---------------##--TT----TT---TT------------------------tt--#-##-TT---Sk---U-k--------------r----g-g-------------|--rrr---|||-||----------||----------########---------tt---#####
XXXXXXXXXXXXXXXXXXXXXXXXXXXXXXXXXXXXXXXXXXXXXXXXXXXXXXXXXXXXXXXXXXXXXXXXXXXXXXXXXXXXXXXXXXXXXXXX--------X%%%%S-XXXXXXXXXXXXXXXXX|%%%%%%%%%%%-||---%%%%%X-||-----XXXXXXXXXXXXXXXXXXXXXXXXXXXXXXXX
XXXXXXXXXXXXXXXXXXXXXXXXXXXXXXXXXXXXXXXXXXXXXXXXXXXXXXXXXX-XXXXXXXXXXXXXXXXXXXXXXXXXXXXXXXXXXXXX--X-----X-||---XXXXXXXXXXXXXXXXX|-|||||||||--||----|||-X-||-----XXXXXXXXXXXXXXXXXXXXXXXXXXXXXXXX
