------------------------------------------------------------------------------------------------------------------------------------------------------------------------------------------------
------------------------------------------------------------------------------------------------------------------------------------------------------------------------------------------------
------------------------------------------------------------------------------------------------------------------------------------------------------------------------------------------------
------------------------------------------------SSSSSSSS----------------------------------------------------------------------------------------------------------------------------------------
------------------------------------------------------------------------------------------------------------------------------------------------------------------------------------------------
--------------------------------------------------------------------------oo--------------------------------------------------------------------------------------------------------------------
--------%%%%%%%%-----------------------------------SSSSSo--------------------------------------------------------------------------------------------------%---------------------%%-------------
---------||||||------------------------------------------------------------oooo----------------------------------------------------------------------------|---------------------||-------------
---------||||||----------------------------------------------------------------------------------------TT--------------------------------------------------|---------------------||-------------
---------||||||-----------ooo---oo-----------------------------------------------------------SSS-------TT--------------------------------------------------|---------------------|#-------------
------%%%%%%%%%%%%%-----%%%%%S--S----------------#SSS---------------------------------------------S----##--------------------------------#-------SS---%%%%%%------------%%%%%%%%-##-------------
-------|||||||||||-------|||---------------------#-----------------------------------------------------------------------TT--------------#-------------||||----o---------||||||--##----tt-------
-------|||||||||||-------|||-%%---------------%%-#-----------------------------------------------------------U-----------TT-------TT----###------------||||--------------||||||--##----tt-------
-------|||||||||||-------|||-||---------------||-#----kk----k-k----------------------------------------------#-----------TT-------TT----###--#-k--o----||||--------------||||||--##----tt----k-g
XXXXXXXXXXXXXXXX%%%%---XXX||-||---XXXXXXXXXXXX||XXXXXXXXXXXXXXXXXXX---XXXXXX---XXXXXXX-------XXXXXXXXXXXXXXXXXXXXXXXXX--XXXX-%%%XXXXXXXXXXXXXXXXX%%%-XXXXXX-----%%%%%%---XX||XXXXXXXXXXXXXXXXXXX
XXXXXXXXXXXXXXXX-||----XX-||-||---XXXXXXXXXX-X||XXXXXXXXXXXXXXXXXXX---XXXXXX---XXXXXX-X------XXXXXXXXXXXXXXXXXXXXXXXXX--X--X--|-XXXXXXXXXXXXXXXXXXXX-XXXX-XX-----||||----XX||-XXXXX-XXXXXXXXXXXX
