--------------------------------------------------------------------------------------------------------------------------------------------------------------------------S---------------------
--------------------------------------------------------------------------------------------------------------------------------------------------------------------------S---------------------
-------------------------------------------------------------------------------------------------------------------------------------------------------------------------SSS--S-----------------
-----------------SSSSSSSSSSSSSSSSS-----S---SS--S----------------------------------------------------------------SSSSSSS-------SS--------------------------------SSSSSSSSSSSSSSSS----------------
----------------------------------------------------------------------------------------------------------------------------------------------------------------SS---S----S--SSS----------------
--------------------------------------------------------------------------------------------o------------------------------oo-----------------------------------SS---SS--ooooSSS----------------
--------%%%%%%%%oooo--SSSSo--Soo--oo---SS------------------------------%S%-%%%--------------%--------------------------------------------------------------------SS--SSS-SSSSSSS%%%%%%----------
---------||||||--------------------------------------------------------|-|--|---------------|---------------------------------------------------------------o--------------------||||-----------
---------||||||----------------------------S-SS------------------------|-|--|---------------|------------------------------------------------------------------------------------||||-----------
---------||||||----------------o-----------SSSS------------------------|-|--|------------ooo|-----o---------------------------oo----gg-----------------------------------------o-||||-----------
------%%%%%%%%%%S--------#-----SS----------S-SS-%%---------------------|-|--|----SS---%%%%%%%-----SS------------TT---2-----------###SSS---------------------------SS---TT------S-||||----TT-----
-------||||||||---------##-----------------K----||--------------o------|-|--|----------|||||---o--------TT------TT-----TT----#--TT------------------------------TT-----TT--------||||----TT-----
-------||||||||--------#####--------------------||--------------#------|-|--|----------|||||------------TT------TT-----TT----#--TT------------------------------TT-----TT--------||||----TT-----
-------||||||||------#######--------------------||--------------#------|-|--g#---------|||||---------k--TT------TT-----TT--###--TT--------------#---------------TT-----TT--------||||----TT-----
XXXXXXXXXXXXXXXXXXXXXXXXXXX-XXXX--XX--XXXX--XXXX|%%%%%%%oXXXX%--X---XXXXXXXXXXXX-%%%%%%%%%%|----XXXXXXXXXXXXXXXXXXXXXXXXXXXXXXXXXXXXXXXXXXXXXXXXX------X%%%%----XXXXXXXXXXXXXXXXXXXXXXXXXXXXXXXX
XXXXXXXXXXXXXXXXXXXXXXXXXXX-XXXX--XX--XXXX--XXXX|-|||||--XXX-|--X---XXXXXXXXXXXX--||||||||-|----XXXXXXXXXXXXXXXXXXXXXXXXXXXXXXXXXXXXXXXXXXXXXXXX---------|XX---XXXXXXXXXXXXXXXXXXXXXXXXXXXXXXXXX
