--------------------------------------------------------------------------------------------------------------------------------------------------------------------------------
--------------------------------------------------------------------------------------------------------------------------------------------------------------------------------
--------------------------------t-----------------------------------------------------------------------------------------------------------------------------------------------
----------------SSSSSSSSSSSSSSSSt-------------------SSSSSSSSSSSS------------------------------------------------SSSSSSSSSSSSSSSS------------------------------------------------
---------------------S-S-S------t-------------------SSSSSSSSS-------------------------------------------------------------------------------------------------------------------
--------------------SS---SSS----t-------------------SSSSSSSSSSS------------------------------o---------o----------------------------------o-------------------------------------
--------%%%%%%%%-----S----------SS-----------------SSSSSSSSSSS------------------#####----------------------------SSS--------------------------------------------o--------r----2%
---------||||||-------------------------r------------S-----------------------SS-----------------SS--------o----------------------------oooo---------------------%-----%%-%---U-|
---------||||||-----------------------%%%%%%%----------------------------------S----------TT--------------------------------------------------------------------|-----||-|-----|
---------||||||---oooSSS---------------|||||-------oooooooooo----K------S--S-SSS----------TT--------------------------------------------------------------------|-----||-|-----|
------%%%%%%%%%%---SSS------------TT---|||||------SSSSSS----S-------------------------###-##--------TT-------------------------------------------------TT-------o-----||-|-----|
-------||||||||-------------------TT---|||||------------------------TT----------------##------TT#---TT---T----TT-------------------K-------------------TT-------|-----||-TT----|
-------||||||||---------------#---TT---|||||------------------------TT---------------###------TT----TT---TT---TT---------------------------------------T#-------|-----||-TT----|
-------||||||||----k-----k----#---TT--t|||||---g---kk---kkkk--------TT--------------#####-----TT----TT---TT---TT---------------------------------------T#-------|----#|k-TT----k
XXXXXXXXXXXXXXXX-XXX----XXXXXXXXXXXXXXXXXXXX--XXXXXXXXXXXXXXXXXX---------------XXXXXXXXXXXXXXXXXXXXXXXXXXXXXXXXX------X--------X-XXXX--XXXXXXXXXXXXXX--XX---XXXXXX--XXXXXXXXXXXX
XXXXXXXXXXXXXXXXXXXX----XXXXXXXXXXXXXXXXXXXX--XXXXXXXXXXXXXXXXXX---------------XXXXXXXXXXXXXXXXXXXXXXXXXXXXXXXXX-----XX---X----X-XXXX--XXXXXXXXXXXXXX-XXXX-XXXXXXXX-XXXXXXXXXXXX
