------------------------------------------------------------------------------------------------------------------------------------------------------------------------------------------------
------------------------------------------------------------------------------------------------------------------------------------------------------------------------------------------------
------------------------------------------------------------------------------------------------------------------------------------------------------------------------------------------------
----------------SSSSSSS------SSS------------------SSSSSSSSSSSSSS---------------------------------------SSSSSSSSS--------------------------------------------------------------------------------
------------------------------------------------------------------------------------------------------------------------------------------------------------------------------------------------
---------------------------------------------------------o-------------------------------------------------------oo--------ooooo----------------------------------------------------------------
--------%%%%%%%%----------------------SSo--------------------------------------o---QQQQQQ-----Q---------------o--%%--------%%-------------------SSoQQSQSSS---S----------------------QQQQQ-------
---------||||||------------o----S--------------------------------------------------------------------------------||--------||----------------------------------------------o--------------------
---------||||||-----SSSSSS%%---S------------------------------------------------------------------------------SS-||--------||-------------------------------------------------------------------
---------||||||-----------||---oS-----------------TT---------------------------------ggg------------------SS--SS-||--------||--------------------------g----------------------------------------
------%%%%%%%%%%----------||----------------------TT----TT----------------------########Q----U-----------#-----S-||--2%%%%SS|-----------------SoQ--SSSSSS----US------------------####-----------
-------||||||||-----------||-----------U----------TT----TT---TT--------------------##-------------------##-------||----||---|-------------------------------------TT-------------###------------
-------||||||||-----------||----------------------TT----TT---TT--------------------#-------------------###-------||----||---|------------------@------------------TT----TT-------##-------------
-------||||||||-----------ok----------kk----------TT----TT---TT----k---------------k--------k---------####-------||----||---|-------gg---------g------------------TT----TT-----o-##k--gg#-#-----
XXXXXXXXXXXXXXXXX-XXXXXXXXXXXXXXXXXXXXXXXXXXXXXXXXXX--XXXXXXXXXX---XXXXXXXXXXXXXXXXXXXXXXXXXXXXX-XXXXXXSXX------%%%%--%%%%XX|---XXXXXXXXXXXXXXXXXXXXXXXXXXXXXXXX--XXXXXXXXX--%%%XXXXXXXXXXXXXXXX
XXXXXXXXXXXXXXXXX-XXXXXXXXXXXXXXXXXXXXXXXXXXXXXXXXXXXXXXXXXXXXXX---XXXXXXXXXXXXXXXXXXXXXXXXXXXXXXXXXXXXXXX-------||----||-XX|---XXXXXXXXXXXXXXXXXXXXXXXXXXXXXXXX---XXX-X-XX---|-XXXXXXXXXXXXXXXX
