-------------------------------------------------------------------------------------------------------K----------------------------------------------------------------------------------------
-----------------K------------------------------------------------------------------------------------------------------------------------------------------------------------------------------
-------------------------------------------------------------------------------------------------------%----------------------------------------------------------------------------------------
-------------------------------------------------------------------------------------------------------|--------SSSSSSSS--------------------------------------------------------SSSSSSSSSSS-----
-------------------------------------------------------------------------------------------------------|----------------------------------------------------------------------------------------
-------------------------------------------oooo---------------------------ooooo-----------------------%%%%%%---%--------------------------------------------------------------------------------
--------%%%%%%%%-------------S---------------------------------------------------------------2--%%%%---||||----|---------------S-----QQQQ------o-----SSSS---------------------------------------
---------||||||-------------------------------oo-------------------------------o-------------K---||----||||----|--------------------------------------------------------------------------#-----
---------||||||----------------------------------------------------------------------------------||---o||||----|-------------------------------------------------#-----------------------##-----
---------||||||-----g------------------------------------------o---------------o-----------------||-%%%%|||----|o------------------------------o---------------o-#----------------------##------
------%%%%%%%%%%-SSSSSS-TT-----------------------------------------------%%-----------2---------%||--||-|||----|S----------------###---###------QSQS-------------#---------------------TT-------
-------||||||||--SSSS---TT-------------TT--------------------------------||-----S-TT--K---------o||--||-|||----|----------------####----#--------------------#---TT--------------------TT-------
-------||||||||--SSSSS--TT-------------TT--------------------------------||-------TT-----TT-----%o|--||-|||----|----------------#####---#--------------------#---TT--------------#---####-------
-------||||||||------kk-TT-------gg----TT-----------------------k--------|##----k-TT-----TT-----%%%--||-|||----|----------------#####-k-k-k----------g-------#---TT-------g----------####----k--
XXXXXXXXXXXXXXXXXXXXXXXXXXXXXXXXXXXXXXXXXXXXXXXXXXXXXXXXXX----XXXXXXXXXXXXXXXXXXXXXXXXXXXXXXXXXX-|---|%%%XXX---|XXXXXXXXXXXXXXXXXXXXXXXXXXXXXXXXXXXXXXXXXXXXXXX-XXXXXXXXXXXXXXXXXXXXXXXXXXXXXXXX
XXXXXXXXXXXXXXXXXXXXXXXXXXXXXXXXXXXXXXXXXXXXXXXXXXXXXXXXXX---XXXXXXXXXXXXXXXX-XXXXXXXXXXXXXXXXXX-|---|-|-XXX---|XXXXXXXXXXXXXXXXXXXXXXXXXXXXXXXXXXXXXXXXXXXXXXXXXXXXXXXXXXXXXXXXXXXXXXXXXXXXXXXX
