--------------------------------------------------------------------------------------------------------------------------------------------------------------------------------
--------------------------------------------------------------------------------------------------------------------------------------------------------------------------------
------------------------------------------------SS------------------------------------------------------------------------------------------------------------------------------
------------------------------------------------SS---------------------------------------------------------------------------------SSS----S-SSSS--------------------------------
--------------------------g---------------------SS------------------------------------------------------------------------------------------------------------------------------
----------------------@---%%----%--%-------ooo--SS---------%--------------------------------------------------------------------------------------------------------------------
--------%%%%%%%%----------||----|--|-----------------------|-g----------------------------------------r---------------------------------------------------------Q---QQ----------
---------||||||---------r-||--U-|--|---S----------------r--|--------U---------------------------%%%%%%%%%-----------------------------------------------------------------------
---------||||||-------%%%%%%%---#--|----------------%%%%%%%%%------------------------------------|||||||------------------------------------------------------------------------
---------||||||--------|||||--1----|-----------o-----|||||||------------------o------------------|||||||------------------------------------------------------------------------
------%%%%%%%%%%%%%%%%%%%%%%%%%%#--|-S---------%-----|||||||----------------%%%%-----------------|||||SS----TT------------------SS--------------------------------2S------------
-------||||||||--||||||||||||||----|-----------|-----tt|||||-----------------||---------------TT-|||||------TT------TT----------------------------TT----------------------------
-------||||||||--||||||||||||||----|-----------|-----tt|||||-----------------||---------------TT-|TT||------TT------TT----------------------------TT---##-------------------##--
-------||||||||--|||||||||g||||----|---k-y-----|-----tt|||||------------ggg--||---------------TT-|TT||-k-y--TT------TT------------k-------k-------TT---##-------K-------g---##--
XXXXXXXXXXXXXXXX-|||||||%%%%%%%----|--XXXX-----|--XXXXX||XXX--X-XX-----XXXXX-||-XX-------XXX-XXXXXXXXXXXXXXXXXXXXXXXXXXXXXXXXXXXXXXXXXXXXXXXXXXXXXXXXXXXXXXXXXXXXXXXXXXXXXXXXXXX
XXXXXXXXXXXXXXXX-|||||||g|||gg-----|--XXXX-----|gXXXXXX||XXX--X-XX-----XXXXX-|X-XX-------XXXXXXXXXXXXXXXXXXXXXXXXXXXXXXXXXXXXXXXXXXXXXXXXXXXXXXXXXXXXXXXXXXXXXXXXXXXXXXXXXXXXXXX
