-----------------------------------------------------------------------------------------------------------------------K------------------------------------------------------------------------
-----------------------------------------------------------------------------------------------------------------------o------------------------------------------------------------------------
----------------------------------------------------------------------------------------------------------------------%S%-----------------------------------------------------------------------
----------------SSSSSSSSSSSSSSSS--------------------------------SSSSSSSSSSSSSSSS--------------------------------------|-|----------------------------------------------------------------------#
------------------S---------------------------------------------------------------------------------------------------|-|-----------------------------------------------------------------------
-----------------------------------------------------------------------------------------oo---------------------------|-|-------------------------------------------------@---------------------
--------%%%%%%%%------S----o-------SSSSSSSSSS----------------------------------------------------o----SSS-------------|-|-------------------------o--SSSS--#---------S--------------------------
---------||||||------------------------------------------------------------------------------o------------------------|-|------------------oo--------------#--------------------%%%----------%%%
---------||||||------------k-----------------------------------------------##-----------------------------------------|-|---------------------------------##-SSS-----------------|------------|-
---------||||||-ooo-----------------------------------------------o-------###----TT----------o------------------------|-|--------------------------------###---o---------ooo-----|------------|-
------%%%%%%%%%%-SS----TT--#-----------SSSS%SSSS--------TT---------------####----TT-----TT----------------------------|-|--------------------------------###---SQQQo--S@S-------%|------------|-
-------||||||||--------TT------------------|------------TT---------------####----TT-----TT----TT----------------------|-|----o--------------------------####--------------------||------------|-
-------||||||||-------####-----#-----------|------TT----TT--------------#####----TT-----TT----TT----------------------|-|---%%%%-----------------------#####--------------------||------###---|-
-------||||||||------#####-----#-----------|------TT----TT-------------######----TT---k-TT----TT----g----##--##----rr-|-|----||-----------------------######--------------------||------###---|-
XXXXXXXXXXXXXXXXXXXXXXXXXXXXXXXX-XXXXXXXXXXXXXXX--XXXXXXXX---%%%XXXXXXXXXXXXX-XXXXXXXXXXXXXXXXXXXXXXXXXXXXXXXXXX-%%%%%%%%%%%%||-XXXXXXXXXXXXXXXXXXXXXXXXXXX--XXXXXXXXXXXXX--XXXX||-----XXXX--%%%
XXXXXXXXXXXXXXXXXXXXXXXXXXXXXXXX-XXXXXXXXXXXXXXX---XXXXXXX----|-XXXXXXXXXXXXX-XXXXXXXXXXXXXXXXXXXXXXXXXXXXXXXXXX--||||||||||-||-XXXXXXXXXXXXXXXXXXXXXXXXXXX-XXXXXXXXXXXXXX--XXXX||-----XXXX---|-
