-------------------------------------------------------------------------------------------------------------------------------------------------------K------------------------------S---S-----
-------------------------------------------------------------------------------------------------------------------------------------------------------o---------------------------K-SS---SS----
------------------------------------------------------------------------------------------------------------------------------------------------------%%----------------------------------S-----
---------------------------------SSS-----SS-----------------------------------------------------SSSSSSSSSSSSSSSS------oo------------------------#-----||-------------------------------SSSS-----
------------------------------------------------------------------------------------------------------------------------------------------------#-----||----------------------------------------
-------------------------------------------------------------------------------------------o----------------------------------------------------------||------------------------------S------g--
--------%%%%%%%%--------------------------------%------------------------------------S----------------S-----------------------------------------------||----------------------------SSS------S--
---------||||||---------------------------------|------o---o------------------------------------------------------------------------------------------||-------------------------------------S--
---------||||||---------------------------------|-----%%%---------------------------------------------------------------------------------------------||-------##---------------------------SS--
---------||||||---------------------------------|------|--oo-----------------------------------oo-o---------------------------------------------------||-------#--------------------g-------SS-S
------%%%%%%%%%%----------######----------------|------|-%%%--------------------TT--------------------------------------------------------------------||-%%%---#----------------SSSSSSSS-------S
-------||||||||---------------------------K---TT|------|--|--------------TT-----TT----------------------TT----K--------------------------------o------||--|---##----------------SSSSSSSSS------S
-------||||||||---------------------------#---TT|------|--|--------------TT-----TT-----TT---------------TT--------------------------------------------||--|--%%%----------------S-SSSSSS--------
-------||||||||----------------------gg-------TT|--r---|--|-------g--g---TT-----TT-----TT--g------g-----TT----g----------------------------------ooo--||r-|---##%%%%-----------#SSSSSSSSS---oooo
XXXXXXXXXXXXXXXXXXXXXXXXXXXXXXXXXXXXXXXXXXXXXXXX|%%%%%%%%%%%%%%%XXXXXXXXXXXXXXXXXXXXXXXXXXXXXXXXXXXXXXXXXXXXXXXXXXXXXXXXXXXXXXXXXXXXXXXX-XXXXXXX%%%%%-%%%%XX--XX-||-XXXXXXXXXXXXXXXXXXXXXX--XXXX
XXXXXXXXXXXXXXXXXXXXXXXXXXXXXXXXXXXXXXXXXXXXXXXX|-|||||||||||||-XXXXXXXXXXXXXXXXXXXXXXXXXXXXXXXXXXXXXXXXXXXXXXXXXXXXXXXXXXXXXXXXXXXXXXXX---XXXXX-|||---XXXXX--XX-||-XXXXXXXXXXXXXXXXXXXXXX---XXX
