---------------------------------------------------------------------------------------------------------------------------------------S--------------------------------------------------------
-------------------------------------------------------------------------------------------------------------------------------------SSSSS------------------------------------------------------
--------------------------------------------------------------S------------------------------------------------------------------------S--------------------------------------------------------
------------------------------------------------SSSSSSS---S--SS-SSSSSSSS-----SSS------------------------------------------------------------------------------------------------------SSSSSSSS--
-----------------------------------------------------------------S------------------------------------------------------------------------------------------------------------------------------
----------------------------------o-----------------------------------------SSSS-----------------------------o-o--------------oooooo---SS-@ooo-------------#-----oo--------ooooo----------------
--------%%%%%%%%-----------------%%-------------SSSo---S---SSSSS-----------SSSSS---------------------------------------------------------------------------#--o-%%%--------%%%---SSoSSSoo------S
---------||||||------------------||--------------------------------------------------------------------------------------------o--------------------------#y--#--|----------|-------------------
---------||||||------------------||----TT-----------------------S---##-----------------------------------------------------------------------------------####----|----------|-------------------
---------||||||------------------||----TT--------oo------------o----##-------------------------------------------------------------------ooo-------------###-----|-------oo-|-------------------
------%%%%%%%%%%----------######-||----##-------SSSSS----------#-----------------------------##------S@--%%%%@SS------------####-U-------%%%%S----------####-----|----%%%%%%%----------------SSS
-------||||||||------------------||----------------------------#-------------------------##--##-----------||---------------####-----------||-------#---#####-----|-----|||||--------------------
-------||||||||------------------||----------------------------#-------TT----TT----------##-####----------||-----------TT--####-----------||-----###########-#---|-----|||||--%%----------------
-------||||||||------------------||-----------------------o----#-------TT----TT-----k----#######--or------||---kg-g----TT--####-----------||---k-###########-#---|rr---|||||--||-#-k------------
XXXXXXXXXXXXXXXXXXXXXXXXXXXXXXXXXXXXXXXXXXXX-X--XXXXXXXXXXXXXXXXXXXXXXXXXXXXXXXXXXXXXXXXXXXXXXXXXXXXXXXXXXXXXXXXXXXXXXXXXXXXXXXX--%%%%%%--||----XXXXXXXXXXX-XXXX%%%%%%%%%|||--|%XXXXXXXXXXXXXXXX
XXXXXXXXXXXXXXXXXXXXXXXXXXXXXXXXXXXXXXXXXXXXX---XXXXXXXXXXXXXXXXXXXXXXXXXXXXXXXXXXXXXXXXXXXXXXXXXXXXXXXXXXXXXXXXXXXXXXXXXXXXXXX----||||---||----XXXXXXXXXXX-XXXXXXXXXX||-|||--||XXXXXXXXXXX-XXXX
