-----------------------------------------------------------------------------------------------------------------------------------------------------------------------S------------------------
---------------------------------------------------------------------------------------------------------------------------------------------------------------------SSS------------------------
------------------------------------------------------------------------------------------------------------------------------------------------------------------------------------------------
--------------------------------SSSSSSSSSSSSSSSS--------------------------------SSSSSSSSSSSSSSSSSSSSSSSSSSSSSSSS----------------SSSSSS----------------------------------------------------------
--------------------------------SS----------------------------------------------SSS-SSSSSSSS----SS--SSSSSS-SSS-S------------------------------------------------g-------------------------------
--------------------------------------------------------------------------------SSS--SS-S-S--SSSSS---SSSSSSSSSSS---------------------------------------------------@-@SSS-@-@-----o-------------
--------%%%%%%%%-----------------------------oo-----SSSQQ---------SQSSSSQ----S--SSSSSSS------SSS-SS--SSSSSSSSSSS----------SSS-----------------------QSQ-------------------------%%%-------%%%---
---------||||||----------------------------#---------------------------------------------------------------------------------------------------------------------------------o---|---------|----
---------||||||---------------------------#---SS---------------------------------------------------------------------------------------------------------------------------------|---------|----
---------||||||-------o---oo----S---------#S-------------------------------------oooo----------------------------------------------------------o-g-----------------------ooo-----|---------|----
------%%%%%%%%%%-SS---U--SSSS---S-SS-----#-----###-SSSS---------Q---SSSS-----SSSSSSSS--------------S------------------------S@%%-------TT-------Q#Q----SSS---US----------%%------|-----%%%%%%---
-------||||||||-----------------------y###-----T---------------------------------------TT---------------------K---------------||-------TT--------------------------------||------|------||||----
-------||||||||----------------------#####----TT----------------------------------TT---TT-------------------------------------||-------TT--------------------------------||------|------||||----
-------||||||||----------------------#####----TT------g------------k--y-----------TT---TT-------g------k------k---ok----------kg-----#-TT----------k---------------------||------|------||||----
XXXXXXXXXXXXXXXX--XX-S---------XXXXXXXXXXXXXXXXXXXXXXXXXXXXXXXXXXXXXXXXXXXXXXXXXXXXXXXXXXXXXXXXXXXXXXXXXXXXXXXXXXXXXXXXXXXXXXXXXXXXXXXXXXXXXXXXXXXXXXXXXXXXXXXXX---%%S---S|-----%%%%%X%%%|||-%%%
XXXXXXXXXXXXXXXX--XX----------XXXXXXXXXXXXXX-XXXXXXXXXXXXXXXXXXXXXXXXXXXXXXXXXXXXXXXXXXXXXXXXXXXXXXXXXXXXXXXXXXXXXXXXXXXXXXXXXXXXXXXXXXXXXXXXXXXXXXXXXXXXXXXXXXX---||-----|------||X-X-XX|||--|-
