-------------------------------------------------------------------------------------------------------------------------------------------------------K----------------------------------------
-------------------------------------------------------------------------------------------------------------------------------------------------------o----------------------------------------
------------------------------------------------------------------------------------------------------------------------------------------------------%%%---------------------------------------
--------------------------------------------------------------------------------SSSSSSSSSSSSSSSS-------------------------------------------------------|--------SSSSSSSS--SSSSSSSSSSSSSSSSSSSSSS
--------------------------------------------------------------------------------SS---S-----------------------------------------------------------------|------------------------------S---------
----------------------------------oo--------------------------------------------SS---SSS-------------------------------------------------------o-------|------%%-----------o---S----------------
--------%%%%%%%%--------------------------------%-------%%S----o---------------------SSS--SSSSS------oSSSS---------------------------------------------|------||--------------------------------
---------||||||---------------------------------|-%%%%%%||---------------------------------------------------------------------------------------------|------||--------------------------------
---------||||||------------------------------o--|--||||-||---------------------------------------------------------------------------------------------|------||--------------------------------
---------||||||---------------------------------|--||||-||---------------------------------------------------------------------------------------------|--oroo||----------------ooo-------------
------%%%%%%%%%%----------######-------------US-|--||||-||----------------------------------------------S--#-------------------------------------------|-%%%%%%TT----2--------------------------
-------||||||||--------------------------TT-----|--||||-||-------------------------------------------------#-#--------------------TT-----#-------------|--||||-TT-------TT-------------TT-------
-------||||||||--------------------------TT-----|--||||-||---%%%--------------------------------####------####--------------------TT----##-------------|--|||%%%T-------TT-------------TT-------
-------||||||||------------------g-k-ggg-TT---k-|--||||-||----|-------------------------------o#####-----#####----##--------------TT----##---------rrr-rrr|||-|-T-------TT-------------TT----gg-
XXXXXXXXXXXXXXXXXXXXXXXXXXXXXXXXXXXXXXXXXXXXXXXX|-XXXXXXXXX---|---X%%%%------%%%---XXXXXXXXXXXXXXXXXXXXXXXXXXXXXXXXXXXXXXXXXXXXXXXXXXXXXXXXXXXXX-%%%%%%%%%%%|-|-XXXXXXXXXXXXXXXXXXXXXXXXXXXXXXXX
XXXXXXXXXXXXXXXXXXXXXXXXXXXXXXXXXXXXXXXXXXXXXXXX|-XXXXXXXXX---|---XX||--------|----XXXXXXXXXXXXXXXXXXXXXXXXXXXXXXXXXXXXXXXXXXXXXXXXXXXXXXXXXXXXX--|||||||||-|-|-XXXXXXXXXXXXXXXXXXXXXXXXXXXXXXXX
