--------------------------------------------------------------------------------------------------------------------------------------------------------------------------------
--------------------------------------------------------------------------------------------------------------------------------------------------------------------------------
------------------------------------------------tt------------------------------------------------------------------------------------------------------------------------------
------------------------------------------------tt---------------------------------------------------------------------------------SSS----S-SSSS--------------------------------
--------------------------g---------------------tt------------------------------------------------------------------------------------------------------------------------------
----------------------@---%%----%--%-------ooo--tt---------%--------------------------------------------------------------------------------------------------------------------
--------%%%%%%%%----------||----|--|-----------------------|-g----------------------------------------r---------------------------------------------------------Q---QQ----------
---------||||||---------r-||--U-|--|---S----------------r--|--------U---------------------------%%%%%%%%%-----------------------------------------------------------------------
---------||||||-------%%%%%%%---#--|----------------%%%%%%%%%------------------------------------|||||||------------------------------------------------------------------------
---------||||||--------|||||--1----|-----------o-----|||||||------------------o------------------|||||||------------------------------------------------------------------------
------%%%%%%%%%%%%%%%%%%%%%%%%%%#--|-S---------%-----|||||||----------------%%%%-----------------|||||SS----TT------------------SS--------------------------------2S------------
-------||||||||--||||||||||||||----|-----------|-----tt|||||----T------------||---------------TT-|||||------TT------TT----------------------------TT----------------------------
-------||||||||--||||||||||||||----|-----------|B----tt|||||----T------------||---------------TT-|TT||------TT------TT----------------------------TT---##-------------------##--
-------||||||||--|||||||||g||||----|---k-y-----|T----tt|||||----T-------ggg--||---------------TT-|TT||-k-y--TT------TT------------k-------k------kTT---##-------K-------g---##--
XXXXXXXXXXXXXXXX-|||||||%%%%%%%----|--XXXX-----|XXXXXXX||XXX--X-XX-----XXXXX-||-XX-------XXX--XXXXXXXXXXXXXXXXXXXXXXXXXXXXXXXXXXXXXXXXXXXXXXXXXXXXXXXXXXXXXXXXXXXXXXXXXXXXXXXXXX
XXXXXXXXXXXXXXXX-|||||||g|||gg-----|--XXXX-----|gXXXXXX||XXX--X-XX-----XXXXX-|X-XX-------XXXXXXXXXXXXXXXXXXXXXXXXXXXXXXXXXXXXXXXXXXXXXXXXXXXXXXXXXXXXXXXXXXXXXXXXXXXXXXXXXXXXXXX
