--------------------------S------------K--------------------------------------------------------------------------------------------------------------------------------------------------------
---------------------------------------o--------------------------------------------------------------------------------------------------------------------------------------------------------
---------------------------------------S--------------------------------------------------------------------------------------------------------------------------------------------------------
------------------------------------------------SSSSSSSS----------------------------------------SSSSSSSSSSSSSSSS#-------------------------------------------------------------------------------
------------------------------------------------------------------------------------------------SSS--SS-----------------------------------------------------------------------------------------
-----------------------------------------------%-----------------oo------oo---------------------SSS------------S--------------------------------o-----------------------------------------------
--------%%%%%%%%-------------------------------|-----------------------------------------------o--------------SS--%%----------------------------------------------------------------------------
---------||||||------------------------o---oo--|%%%%%%%%----r-----------------------------------S-----------------||------------SS----------------------------------------------------------oo--
---------||||||-----------------------%%%-%%%--|-||||||----%%SSS-----------------------------##-S-----------------||----------------TT----------------------------------------------------------
---------||||||------------------------|---|---|-||||||----||-------------------------------###-Soo---------------||------oo--------TT-------------------ooo--------------ooo----------o--------
------%%%%%%%%%%-------------S---------|---|---|S||||||----||----TT-------------####---TT--#####SSS---------------||-----%%%--------##-----------UQo-----%%%--------------S------SQo---U%%%-----
-------||||||||------------------------|---|-o-|o||||||----||----TT-----TT---#---------TT--####--------tt---------||------|--------------TT---------------|----o-------------------------|------
-------||||||||------------------------|---|%%o|%%|||||----||----TT-----TT-----------####--####--------tt---------||-----#|--------------TT---------------|------------------------------|------
-------||||||||------------------------|--rr||-||||||||----k|----TT-----TT---#-------####--####-k------tt----ggg--||-----#|--------------TT--------g------|------------------------------|------
XXXXXXXXXXXXXXXX---X------XXXXXX---%%%%%%%%%%%%%|||||XXXXXXXXXXXXXXXXXXXXXXXXXXXXXXXXXXXX--XXXXXXXXXXXXXXXXXXXXX--||XXXXXXX-----XXXXXXXXXXXXXXXXXXXXXXXXX-|--------X-S-------%%%-XXXX-X--|------
XXXXXXXXXXXXXXXX---X------XXXXXX----|||||||||||-|||||XXXXXXXXXXXXXXXXXXXXXXXXXXXXXXXXXXXX-XXXXXXXXXXXXXXXXXXXXXX--||XXXXXXX----XXXXXXXXXXXXXXXXXXXXXXXXXX-|--------X----------|--XXXX-X-X|------
