-----------------------------------------------------------------------K------------------------------------------------------------------------------------------------------------------------
-----------------------------------------------------------------------o------------------------------------------------------------------------------------------------------------------------
-----------------------------------------------------------------------%------------------------------------------------------------------------------------------------------------------------
-----------------------------------------------------------------------|------------------------------------------------------------------------------------------------------------------------
-----------------------------------------------------------------------|------------------------------------------------------------------------------------------------------------------------
-----------------------------------------------------------------------|------------------------------------------oo-------o--------------------------------------o-----------------------------
--------%%%%%%%%---------------------------S--------------------%------|--%%%%---------------S---2---------------------------------------------------------------------------------QQQQQQS---SSS
---------||||||--------------------------------------------#----|------|---||----------------S---o------------oo-----------oooo------------------------o----------------------------------------
---------||||||---SS--------------------------##----------##----%%-----|---||------------------------#-----------------------------------------------%%%%--%%-----------------------------------
---------||||||------------------------------###---------###----||-----|-ooo|-----------------------##-----------2------------------------------------||---||--------------------------g--------
------%%%%%%%%%%----------------------------####---------###----%o-----|%%%%%------------------------2-----------------TT-----------------------------||---||-------------------Q#Q#QSSQQS---U--
-------||||||||----------------------------#####-------#####----||-----|-|||--oo---------------TTTT-----TT--#----------TT-----------------------------||---||--------------------------------#--
-------||||||||----------------------------#####------######----||-----|-|||-%%%---------------TTTT-----TTT##--#-------##----------------TT-----------||-#-||--------------------------------##-
-------||||||||----------------#----------######-----#######----||-rr--|-|||--|-------------k--TTTT-----TTt##-##--g----##---------k------TT-----------||-#-||--------------------------g----k###
XXXXXXXXXXXXXXXXXXXXXXXXXXXXXXXX%%%XXXXXXXXXXXXXXXXXXXXXXXXXXXXX%%%%%%%%%%%%--|-XXXXXXXXXXXXXXXXXXXXXXXXXXXXX-XXXXXXXXXXX---XX--XXXXXXXXXXXXXXXX-----XXX-X-||--XXXXXXXX-----XXXXXXXXXXXXXXXXXXXX
XXXXXXXXXXXXXXXXXXXXXXXXXXXXXXXXX|XXXXXXXXXXXXXoXXXXXXXXXXX--XXX-||||||||||---|-XXXXXXXXXXXXXXXXXXXXXXXXXXXXX-XXXXXXXXXXX---XX--XXXXXXXXXXXXXXXX-----XXX-X-||--XXXXXXXX-----XXXXXXXXXXXXXXXXXXXX
