-----------------------------------------------------------------------S-----------------------------SSS----------------------------------------------------------------------------------------
-------------------------------------SS--SS----------------------------S------------------------------------------------------------------------------------------------------------------------
-----------------------------------------------------------------------------------------------------%%%%---------------------------------------------------------------------------------------
------------------------------------------------SSSS--------------------------------------------------||------------------------------------------------------------------------SSSSSSSSSSSSSSSS
------------------------------------------------------------------------------------------------------||-------o----------------------------------------------------------------S---------------
------------------------------------------------------------------o-----------------------------------||------%%--------------------------------------------------------------------------------
--------%%%%%%%%--------------------------------------------------------------------------------------||------||-----------------%%%------------------------------------------------------------
---------||||||---------------------------------------------------------------------------------------|o---o--||------------------|-------------------------------------------------------------
---------||||||---------------------------------------------------------------------------------------%%%-%%%-||------------------|--------------------------o-----------------------------y----
---------||||||-----------------------------S----------------------------ooo---------------------------|---|--||---------------o--|--------##----------------------------------------------#----
------%%%%%%%%%%----------######-oo---S@S------------------------%------%%%%----###--2------S@S--------|---|--||---SSSS--TT-------|--------##------------TT--@S---------------------------###---
-------||||||||---------------------------------------tt---------|-------||-----#-#--------------------|---|--r|TT-------TT-------|-------###------------TT------------------------------####---
-------||||||||---------------------------------------tt---------|o------||-----#----------------------|---|%%S|TT-------TT-------|----tt-###------------TT--------------TT-------------#####---
-------||||||||---------------------------------------tt-----gg--|-r-----||-----#------k----kkkk-------r---r||r|TT-------TT----o-oy----tt-###-----gggkk--TT--------------TT----g------#######---
XXXXXXXXXXXXXXXXXXXXXXXXXXXXXXXX-XXX--XXX-------XXXXXXXXXXXXXXXX-%%%%%%%-||--%%%XXXXXXXXXXXXXXXX-%%%%%%%%%%%%%%%XXXXXXXXXXXXXXXXXXXXXXXXXXXXXX-XXXXXXXXXXXXXXXXXXXXXXXXXXXXXXXXXXXXXXXXXXXXXXXXX
XXXXXXXXXXXXXXXXXXXXXXXXXXXXXXXX-XXXX-XXX------XXXXXXXXXXXXXXXXX--|||||--||---|-XXXXXXXXXXXXXXXX--|||||||||||||-XXXXXXX-XXXXXXXXXXXXXXXXXXXXXXXXXXXXXXXXXXXXXXXXXXXXXXXXXXXXXXXXXXXXXXXXXXXXXXXX
