------------------------------------------------------------------------------------------------------------------------------------------------------------------------------------------------
------------------------------------------------------------------------------------------------------------------------------------------------------------------------------------------------
------------------------------------------------------------------------------------------------------------------------------------------------------------------------------------------------
-------------------------------------------------#--------------SSSSSSSSSSSSSSSS------------------------------------------------SSSSSSSo------------------------SSS--SSS--SSSSSS----------------
-----------------------------------------------o----------------SS---SSS---S-S------------------------------------------------------------------------------------------------------------------
----------------------------------------------------------------SS---SSS---SSSSS----------------------------------o-----oo-----o----------------------------------------------------------oo----
--------%%%%%%%%----------------#--------------------QQQQ-S----#------SSoSSSSSSS------------------------------------------------------------------------o---------------------------------------
---------||||||-----------------------------------------------##------------------------------oo-----------#-----------------ooo-------or-rrr------------------o--------------------------------
---------||||||----------------------------------------------###-----------------------------------------####------------------------%%%%%%%%%--------------------------------------------------
---------||||||---------------------------------------------####-----------------------------------------###-------------o------------|||||||-----------------##--------------------ggg---------
------%%%%%%%%%%----------######-------------U--####-#-----#####----------------------------------------####--------------------------|||||||----------------###----------------TT-####---------
-------||||||||------------------------K--------###-------######---------------------------------------#####------TT------------o---oo|||||||----------------###-TT-------------TT---K----------
-------||||||||---------------------------------#---------######--------------------------------------######------TT------------%%-%%%|||||||---------------####-TT-------------TT-----TT-------
-------||||||||-------------------ggg--k----k---#---------######-------------------------------#-----#######------TT------------||--|-|||||||--------k----#-####-TT----k-----gg-TT-----TT---k---
XXXXXXXXXXXXXXXXXXXXXXXXXXXXXXXXXXXXXXXXXXXXXXXXXXXXXXXXXXXXXXXXXXXXXXXXXXXXXXXX-%%%------XX-X%XXXXXXXXXXXXX----XXXXXXXXX----%%%||XXXXXXXXXXXXXXXXXXXXXXXXXXXXXXXXX--XXXXXXXXXXXXXXX-XXXXXXXXXXX
XXXXXXXXXXXXXXXXXXXXXXXXXXXXXXXXXXXXXXXXXXXXXXXXXXXXXXXXXXXXXXXXXXXXXXXXXXXXXXXXX-|------XXX--|XXXXXXXXXXXX----XXXXXXXXXX-----|-||XXXXXXXXXXXXXXXXXXXXXXXXXXXXXXXXX--XXXXXXXXXXXXXXXXXXXXXXXXXXX
