---------------------------------------------------------------------------------------K--------------------------------------------------------------------------------------------------------
---------------------------------------------------------------------------------------o--------------------------------------------------------------------------------------------------------
--------------------------------------------------------------------------------------%%--------------------------------------------------------------------------------------------------------
------------------------------------------------SSSSSSSSSSS-SS------------------------||-------------------------------------------------------------------------SSS--oS--SS--------------------
--------------------------------------------------------------------------------------||--------------------------------------------------------------------------------------------------------
-----------------------------------------------------------------o-----o--------------||--------------------------------------------------------------------------------------------------------
--------%%%%%%%%----------------------------------------------------------------------||--------------------------------%S------------SSSS------------------------------------------------------
---------||||||------------------------------------------------#----------------rr---o|o---o---#------------------------|-------------#-------S-------------------------------------------------
---------||||||-----------------------------------------------------------------%%%%%%%%%-%%%--#------------------------|-----------------------------------------------------------------------
---------||||||--------------------------------------------#-----------g---SSSSS-||||#||---|---#------------------------|-----------------------------------------------------------------------
------%%%%%%%%%%----------######--------------------------##-#--------##---------||||-||---|---#S-----------------------|----------------------------------------------------TTTT-SSSSSS--------
-------||||||||-----------------------#-----------------######-------------------||||-||---|---#------------------------|-------------------------TT-----TT------------------TTTT-----S---------
-------||||||||-----------------------#----------------#######-------------------||||-||---|---#------------------------|-------------------------TT-----TT-------------TT---TTTT---------------
-------||||||||-----------------------#------k------##########-------------------||||-||rrrr---#------------------------|-------------------------TT-----TT----------#--TT---TTTT---------y-----
XXXXXXXXXXXXXXXXXXXXXXXXXXXXXXXXXXXXXXXXXXXXXXXXXXXXXXXXXXXXXXXX-------------XXX%%%%|-%%%%%%%--X--XXX-X--S%%%%%@---XXXXXXXXXXXXXX-XX-XXXXXXXXXXXXXXXX----XXX---XXXXXXXXXXXXXXXXXXXXXXXXXXXXXXXXX
XXXXXXXXXXXXXXXXXXXXXXXXXXXXXXXXXXXXXXXXXXXXXXXXXXXXXXXXXXXXXXX--------------XXX-||-|--|||XX---X--XXX------|||-X---XXXXXXXXXXXXX--XX--XXXXXXXXXXXXXXX--X--XX---XXXXXXXXXXXXXXXXXXXXXXXXXXXXXXXXX
