---------------------------------------S--------------------------------------------------------------------------------------------------------------------------------------------------------
---------------------------------------S--------------------------------------------------------------------------------------------------------------------------------------------------------
------------------------------------------------------------------------------------------------------------------------------------------------------------------------------------------------
------------------------------------------------------------------------------------------------SSSSSSSS------------------------SSSSSSSSSSSSSSSS-------S-SSSSSSS--------------------------------
------------------------------------------------------------------------------------------------S-------------------------------SS---S----------------------------------------------------------
--------------------------------------------------------------------------------------------------------------------------------SS--------------------------------------------------------------
--------%%%%%%%%-------------------2-SSSSS-----------------------------------------------------------------------------SSSSSSSSS-S-----------ooS--oo--------------------------------------------
---------||||||----------------------------------#--------------------------------------------------------------------------------------------------------------#-------------------------------
---------||||||---------------------------------------------------------------------------------#--------------------------------------------------------------SS-------------------------------
---------||||||-----------------------------------------------------------------------------------------------------------------o------------------------------o--------------------------------
------%%%%%%%%%%-----------------o--SS@QSSS--SS---------------------------------SS----S%%%%%%------------------------SQQQSSSS@SS-----------------------------SSS-------------------------TT-----
-------||||||||-------------------------------------------------------------------------||||---o--------------TT------------------------------K------------------------------TT----------TT-----
-------||||||||----------------------------------------TT-------------------------------||||------------------TT-------------------------------------------------------TT----TT----------##-----
-------||||||||---------g-#----------------------------TT------#----------rrooo---------||||-----------k------TT---------------------g-k--------------------------gg---TT--k-TT---------------oo
XXXXXXXXXXXXXXXXXXXXXXXXXXXXXXXX-XXX---------XXXXXXXXXXXXXXXXXXX--------%%%%%%%%--%%%--XXXX|-XX-XXXXXXXXXXXXXXXX--%X--XXXXXXXXXXXXXXXXXXXXXXXXXX-X-------XXXXXXXXXXXXXXXXXXXXXXX------------%%%%
XXXXXXXXXXXXXXXXXXXXXXXXXXXXXXXX-XXX---------XXXXXXXXXXXXXXXXXXX---------||||||----|---XXXX|-XX-XXXXXXXXXXXXXXXX--XX--XXXXXXXXXXXXXXXXXXXXXXXXXX---------XXXXXXXXXXXXXXXXXXXXXXX-------------||-
