-----------------------------------------------------------------------------------------------------------------------K----------------------------------S-------------------------------------
-----------------------------------------------------------------------------------------------------------------------o----------------------------------S-------------------------------------
----------------------------------------------------------------------------------------------------------------------%%%--------------------------------SSS------------------------------------
-----------------------------------------------SSSSSSSSSSSSSSSSS-------------------------------------------------------|--------S---------------SSSSSSSSSSSSSSSS--------------------------------
-----------------------------------------------------------------------------------------------------------------------|------------------------SS--------SS-S----------------------------------
-----------------------------------------------------------------------------------------------------------------------|---------------------------------ooooSS---------------------------------
--------%%%%%%%%------------------------------o-------------oo-o-----------------------------------SSSQ------2---------|-----------------------------SS-----SS------------SS-------------------#
---------||||||--------------------S%%%-------SS-------------------------------------------------------------U---------|------------------------------------S---------------------------------##
---------||||||----------------------|--------S--------------------------------------------------------------U---------|-------------------##---------------S-------------------------------####
---------||||||----------------------|----------oooo---------------------------------------------------------U---------|-ooo---------------##----------------o-----------------------------#####
------%%%%%%%%%%----------######-----|---#-#----SSSS--------------------------------------------S--SS--------U--%%-----|%%%%%-----------####-----------TT-------------%%%%%%%%S-####------######
-------||||||||-----------------#----|---#-#-#------------------------------------------------------------------||-----|-|||------------####----S--S-S-TT-----TT-------||||||-------------######
-------||||||||-----------------#----|-#####-#-------------------------#----------------------------------------||-----|-|||-%%%-------#####---#S------TT-----TT-------||||||-------------######
-------||||||||-----------------#----|######-#---------k----k-k-k-------------------gg----y-k------k--k---------||--rr-|-|||--|-------######---#--SS-k-TT-----TT-------||||||------------#######
XXXXXXXXXXXXXXXXXXXXXXXXXXXXXXXXXXXXXXXXXXXXXX--XXXXXXXXXXXXXXXXXXXXXXXXXXXXXXXXXXXXXXXXXXXXXXXXXXXXXXXXXXXXXXXX%%%%%%%%%X||--|-XXXXXXXXXXXX---XXXXXXXXXXXXXXXXXX%%%%X-XXXXXXXXXX%XX-XXXXXXXXXXX
XXXXXXXXXXXXXXXXXXXXXXXXXXXXXXXXXXXXXXXXXXXXXXXXXXXXXXXXXXXXXXXXXXXXXXXXXXXXXXXXXXXXXXXXXXXXXXXXXXXXXXXXXXXXXXXX-|||||||-X||--|-XXXXXXXXXXXX---XXXXXXXXXXXXXXXXXXXX|---XXXXXXXXXX|---XXXXXXXXXXX
