-------------------------------------------------------------------------------------------------------------------------------------------------------Q------------------------
---------------------------------------------------------------------------K---------------------------------------------------------------------------------K------------------
-------------------------------------------------------------------------------U-------------------------------------------------------------------------------U----------------
----------------SSSSSSSSSSSSSSSS--SSSSSSSSSSSSSS--------------------------------SSSSS---------SS--------------------------------------------------------------------------------
-----------------------------S-------S------------------------------------------------------------------------------------------------------------------------------------------
------------------------------------SSS--------------------------------------------------------------------------------------------------------------%--------------------------
--------%%%%%%%%--------------SS-----------S------SSQSS-------SS--------------------------SS--S--SS---------1----------#-----------------------------|--------------------------
---------||||||---------------------------SSSS--------------------------------K---------------------------------------##-----------------------------|--------------------------
---------||||||---------------------------SS--------------------------%%%-------%-------------------------------S----###----------------#-TT---------|--------------------------
---------||||||-----SSS------S---U--------SSSSS------------------------|------1-|-----------------------------------####---------K-----##-TT---------|-r------r---1-------S---SS
------%%%%%%%%%%-----SSS-----SSS-------------------SS-----------%%%%%%%%%%%%%%%-|----------------------------------#####-#---#-#-------##-##-----%%%%%%%%%%%%%%%----------------
-------||||||||--------------------------------------------------|||||||||||||--|------------------------TT-------######-------#------###---------|||||||||||||-----------------
-------||||||||--SS---SSSSSS---------------%---------------------||||||||||%%|--|-----#-----%------------TT------#######-------#------###---------|||||||||||||-----------------
-------||||||||----------------------------|---------------------|||||||||||||--|-----------|--------y---TT----#########-------#------###-----#---|||||||||||||-----------------
XXXXXXXXXXXXXXXX--SS--------XX-X-----------|---------XX-XXXXXXXX-|%%%%%||||X||X-|--XX-X-----|---XXXXXXXXXXXXXXXXXXXXXXXXXX--XX-XXXXXXXXXX---XXXX--||||||XXXX|||----%--------XXX-
XXXXXXXXXXXXXXXX------------XXXX-----------|---------XX-XXXXXXXX-|-|||-||||X||X-|--XX-X-----|---XXXXXXXXXXXXXXXXXXXXXXXXXX--XX-XXXXXXXXXX--XXXXX--||||||XXXX|||----|---------XX-
