---------------------------------------------------------------------------------------S-----------------------------------------------K--------------------------------------------------------
---------------------------------------------------------------------------------------S-----------------------------------------------o-------------------------K------------------------------
--------------------------------------------------------------------------------------------------------------------------------------%%%-------------------------------------------------------
--------------------------------SSSSSSS------SSS---------------------------------------------------------------------------------------|--------------------------------------------------------
---------------------------------------------------------------------------------------------------------------------------------------|--------------------------------------------------------
-----------------------------------------------S---------------------------------------------------------------------------------------|-------%------------------------------------------------
--------%%%%%%%%---------------------SSS-------S-----------------------------------------------------SS--------------------------------|-------|----QQQQQ------#------QQ------------------------
---------||||||--------------------------------#---------------------------------------------------------------------------------------o-------|--------------##--------------------------------
---------||||||-------------------------------##-----------------------------------------------------------------------------------%%%%%%------|------------####--------------------------------
---------||||||----------------------------#####------------------------------------------SSSSS-----g-------------------------------||||-------|------------####------gg------------------------
------%%%%%%%%%%----------#####------2---TT#####------------------------------------------------SSSSS-------------------------------||||-%%%---|QQQQQ--SS--#####----SSSS-------------2----------
-------||||||||--------------------------TT#####--TT---------------------------------------------------TT---------------------------||||--|--oo|-----------#####------------------------TT------
-------||||||||--------------------------TT#####--TT---------------------------------------------------TT-------------------------o-||||--|-%%%%----------######-------------#----------TT------
-------||||||||----------------------ggg########--TT---------------------------------------------------TT----------k--k------------r|||r-rr--||----kgggg--######-----k------#---k----k--TT------
XXXXXXXXXXXXXXXXXXXXXXXXXXXXXXXXXXXXXXXXXXXXXXXXXXXXXXXXXXXXXXXXXXXXXXXXXXXXXXXX--%%%%%------S%SXXXXXXXXXXXXXXXXXXXXXXXXXXX-XXXX-%%%%%%%%%%%-||-XXXXXXXXXXXXXXXXXXXXXXXXXXXXXXXXXXXXXXXXXXXXXXXX
XXXXXXXXXXXXXXXXXXXXXXXXXXXXXXXXXXXXXXXXXXXXXXXXXXXXXXXXXXXXXXXXXXXXXXXXXXXXXXXX---|||--------|-XXXXXXXXXXXXXXXXXXXXXXXXXXX-XXXX--|||||||||--||-XXXXXXXXXXXXXXX-XXXXXXXXXXXXXXXXXXXXXXXXXXXXXXXX
