-----------------------------------------------------------------------------------------------------------------------K------------------------------------------------------------------------
-----------------------------------------------------------------------------------------------------------------------o------------------------------------------------------------------------
------------------------------------------------------------------------------------------------------------------------------------------------------------------------------------------------
------------------------------------------------SSSSSSSS-------S--------------------------------------------------------------------------------------------------------------------------------
------------------------------------------------------------------------------------------------------------------------------------------------------------------------------------------------
---------------------------------oo-------ooooo------------------oo--------------oo------o-----o---o-------ooooo--------------ro---------------------------------------------------------ooo----
--------%%%%%%%%----------------%%%-------%%%--------------------%%--------------%%-------------%%%%%-----%%%%%%%%----------%%%%------QQS%%%%%%-------------------------------------------------
---------||||||------------------|---------|---o-----------------||--------------||--------------|||-------||||||------------||-----------||||--------------------------------------------------
---------||||||------------------|---------|--##-----------------||--------------||--------------|||-------||||||------------||-----------||||--------------------------------------------------
---------||||||------------------|---------|--##-----------------o|--------------||--------------|||-----oo||||||------------||-----------||||--------------------------------------------------
------%%%%%%%%%%----------######-|---------|--##-----------------||----------SSS-||--2--TT-------|||--%%%%%%%%%%|-------%%%%%%|--------%%%%%%%%%----------------------------------------#-------
-------||||||||------------------|---------|-###-----------------||--------------||-----TT-------|||---||||||||-|--------||||-|---------|||||||----------------------------------------##-------
-------||||||||------------------|---------|####------tt---------||--------------||-----TT-------|||---||||||||%|--------||||%|---------|||||||--------TT-----------------------------####------
-------||||||||-----------------g|-----g---|#-##--#---tt------g--||------------g-||-----TT-------|||---||||||||||--------||||||---oo----|||||||--------TT----#-----------------o------###-------
XXXXXXXXXXXXXXXXXXXXXXXXXXXXXXXXXX%--XXXXXXXX-XXXXXXXXXXXXXXXXXXXX%%-X%XXXXXXXXXXXXXXXXXXXXXX---%%%%%-%%%XXXXXXX%%%%%%%%%%%||||-%%%%%XXXXXXXXXXXXXXXXXXXXXXXXXXXXXXXXXXXXXXX-%%%-XXXXXXXXXX-XXXX
XXXXXXXXXXXXXXXXXXXXXXXXXXXXXXXXXX|--XXXXXXXX-X-XXXXXXXXXXXXXXXXXXX|--|XXXXXXX-XXXX-XXXXXXXXX--X-|||---|-XXXX-XX-|||||||||-||||-X|||--XXXXXXXXXXXXXXXXXXXXXXXXXXXXXXXXXXXXXX--|-XXXXXXXXXXX-XXXX
