-----------------------------------------------------------------------K------------------------------------------------------------------------------------------------------------------------
-----------------------------------------------------------------------o------------------------------------------------------------------------------------------------------------------------
-----------------------------------------------------------------------%------------------------------------------------------------------------------------------------------------------------
-----------------------------------------------------------------------|-------S------------------------------------------------SSSS----o-------------------------------------------------------
-----------------------------------------------------------------------|---------------------------------------------------------------------------------------o--------------------------------
-----------------------------------------------------------------------|---------------------------------------------------------------------------------------S--------------------------------
--------%%%%%%%%-------------------------------------------------------|---o--------------------------QQQ---------------%%SS---------------------------------------------------------SQSSSS--SSS
---------||||||--------------------------------------------------------|--------------------------------------##--%%%%%%||----------------rrrr--------------------------------------------------
---------||||||-----------------------------------------------------%--|-------------------------------------------||||-||-%------%%%%%%%%%%%%%------------------S------------------------------
---------||||||-----------------------------------------------------|--|--------------------------#----------------||||-||-|-------|||||||||||-------------SSS------------------S---------------
------%%%%%%%%%%----------######-----------------------------##o----|--|-------------------------####--#-----##----||||-||-|-------|||||||||||--%-------------------------------------QQQ---SU--
-------||||||||----------------------------------------TT---##------|--|---------------TT--------###---#----###----||||-||-|----o--|||||||||||--|-----------------------------------------------
-------||||||||----------------------------------------TT--###------|--|-K-------------TT-------####---#----###----||||-||-|----%%-|%|||||||||--|--o--------------------------------------------
-------||||||||-------------------------g--------------TT---##------|--|----rrro-------TT----k--####---#---####----||||-||-k----||-|||||||||||r-|-%%%----------o-------------------k------------
XXXXXXXXXXXXXXXXXXXXXXXXXXXXXXXXXXX-XXXXXXXXXXXXXXXXXXXXXXXXXXXX----|-%%%%%%%%%%XXXXXXXXXXXXXXXXXXXXXXXXXXXXXXXX%%%%|XXXXXXXXXXX||-||XXXX|%%%%%%|--|--------%%%%XXXXXXXXXXX-XXXXXXXXXXXXXXXXXXXX
XXXXXXXXXXXXXXXXXXXXXXXXXXXXXXXXXXX-XXXXXXXXXXXXXXXXXXXXXXXXXXXX----|--||||||||-XXXXXXXXXXXXXXXXXXXXXXXXXXXXXXXX-||-|-XXXXXXXXXX||-||-XXX|-||||-|--|---------||-XXXXXXXXXX--XXXXXXXXXXXXXXXXXXXX
