----------------------------------------------------------------------------------------------------------S----------------------------K------------------------------S-------------------------
--------------------------S------------------------------------------------------------------------------SS-------------------------------------------------------------------------------------
----------------------------------------------------------------------------------------------------------S-------------------------------------------------------------------------------------
----------------SSSSSSSS-SS---SSSSS---SoooSSSSSS--------------------------------------------------SSSSSSSSSSSSSS-SS-----------------------------------------------------------------------------
--------------------------------------%%----------------------------------------------------------S-SSSSSS--------------------------------------------------------------------------------------
--------------------------------------||---------------------------------------------------------SSSSSSS------SS--------------------------------------------------------------------------------
--------%%%%%%%%------------SS--------||-ooo-o------------------------SSS-----------------------SSSSSSSSoS--SSSS-----------------------%%-------------------------r-------------%%--------%%%---
---------||||||-------------SS--------||---r----S-----------------SS%%%o---o-----o--------------S--------------------------------------||-----------------------S%%---oo--oooo--||---------|---#
---------||||||-------------SS--------%S%-%%%---S-SSS----------------|-----------------------------------------------------------------||------------------------||-------------|%%%-------|---#
---------||||||-----------------------|-|--|----S--------------------|-k---SSSS---TT-------------oggoooo----------------------------%%%%%%-------o---------------||-------------|-|--------|---#
------%%%%%%%%%%----SSSS--S----S%-----|-|--|---------#---------------|-QQ---SS----TT-------------SSSSSSSS-----SS---------------------||||--------S-----------o---||-------------|-|--------|--##
-------||||||||-----------------|-----|-|--|-------------------------|------------TT----TT----TTSSSS------------o--------------------||||------------------------||-------------|-|--------|--##
-------||||||||-----------K-----|-----|-|--|-------------------------|------------TT----TT----TT------------------------TT---TT---o--||||------------------------||--------K----|-|--------|--##
-------||||||||----------------o|-----|-|--|-rr-----------k-----#----|-----k------TT----TT----TT##S---k-----k-k---------TT---TT--%%%-||||-----oo--g----k----k----||---------rrr-|-|-------#|--##
XXXXXXXXXXXXXXXXXXXXXXXXXXXX--XX|-----|-%%%%%%%%XXXXXXXXXXXXXXXXXXXXXXXXXXXXXXXXXXXXXXXXXXXXXXXXXXXXXXXXXXXXXXXXXXXXXXXXXXXXXXXX--|--||X|XXX%%%%XXXXXXXXXXXXXXXX-|XX--XXXXX%%%%%|-XXXXXXXXXX--XX
XXXXXXXXXXXXXXXXXXXXXXXXXXXX--XX|-----|--||||||-XXXXXXXXXXXXXXXXXXXX-XXXXXXXXXXXXXXXXXXXXXXXXXXXXXXXXXXXXXXXXXXXXXXXXXXXXXXXXXXX--|--||X|XXX-||-XXXXXXXXXXXXXXXX-|XX--XXXX--|||X|-XXXXXXXXXX--X-
