------------------------------------------------------------------------------------------------------------------------------------------------------S-----------------------------------------
------------------------------------------------------------------------------------------------------SS----------------------------------------------S-----------------------------------------
------------------------------------------------------------------------------------------------------------------------------------------------------------------------------------------------
------------------------------------------------SSSSSSSSSSSSSSSSSSSSSSSoo-oooSSS------------------------------------------------S---------------------------------------------------------------
------------------------------------------------SSS-SSS%--------------%%-------------------------------S--K-KS----------------------------------------------------------------------------------
------------------------------------------------SSS----|-------S--o---||-------------------------------S-----g------------oo--------------------------------------------oo----------------------
--------%%%%%%%%-oo---SSS-----oo-------------------o---|-----oSS%%%%--||--ooo--------------------------K----SS---------------------------------ooooo--SSS----ooo--------------------QQQQQS-----o
---------||||||----------------------------------------|---------||---|o------------------------------------SS----------------oo-----------------------------------------------o----------------
---------||||||---------------SS---------------------SSSSSSSS----||---%%%%%%%S------------------------------S--S---------------------------#%%%%------------------------------------------------
---------||||||-S---------SS--So-o--------------Soo--------------||----|||||--------------------------------Sooo%T-------------------------#-||-S---------SSSSSS--------------------------------
------%%%%%%%%%%---------#-----S-------------#--SSS-------------%%|----|||||-------------------------SSS--------|T-----TT------------------#-||-S-------##---S-S--TT----TT-------------------U--
-------||||||||---------##-------------TT---##------------------|||----|||||-------------#----------------------|T-----TT----------------###-||---------##-------TT-----TT---TT-----------------
-------||||||||--------###------------#TT--###------------------|||----|||||-------------#----------------------TT-----TT----------------###-||--------###-------TT-----TT--#TT-----------------
-------||||||||------#####------------#TT--###-----------------g|||----|||||------%%%k---#----------------U-----TT-----TT---#----------#####-||-------k#k#-------TT-----TT--#TT----k-kgg--------
XXXXXXXXXXXXXXXXXXXXXXXXXX--XXXXXXXXXXXXXXXXXXX-XXXXXXXXXXXXXXXX|||----||||X%%-X--XXXX---XX--%%%XXXXXXX--------XXXXXXXXXXXXXXXXX-XXXXXXXXXXXX|XXXXXXXXXXXX--XXXXXXXXXXXXXXXXXXXXXXXXXXXXXXXXXXXX
XXXXXXXXXXXXXXXXXXXXXXXXXX--XXXXXXXXXXXXXXXXXXXXXXXXXXXXXXXXXXXX|||----||||X|X-X--XXX----X----|XXXXXXXX-------XXXXXXXXXXXXXXXXXX-XX-XXXXXXXXX|-XXXXXXXXXXX--XXXXXXXXXXXXXXXXXXX-XXXXXXXXXXXXXXXX
