---------------------------------------------------------------------------------------------------------------------------------------K--------------------------------------------------------
---------------------------------------------------------------------------------------------------------------------------------------o--------------------------------------------------------
--------------------------------------------------------------------------------------------------------------------------------------%%--------------------------------------------------------
--------------------------------------oSSSSSSSSSSSS-----------------------------SSSSSSSSSSSSSSSSSSSSSSSS-------S----------------------||----------------------------------------SSSSSSSS--------
--------------------------------------------------------------------------------------------------------------------------------------||--------------------------------------------------------
-------------------------------------------------------------------------ooo-------------------S--------------------------------------||------%%--------------oo--------------------------------
--------%%%%%%%%--------------------------------------------------------------------oSSo------SS--------------------------------%%----||------||------------------------------------------------
---------||||||------------------------------------------------%-------------ooo------------------------------------------------||----|o------||-------------------%%%%%------------------------
---------||||||-----------------------------------------------##----------------------------------------------------------------||----%%%-----||--------------------|||-------S-----------------
---------||||||---------------------------------------------#-##--------------------g-------------------------------------------||-----|--oo--||---------------o----|||-------------------------
------%%%%%%%%%%----------######---------------------------##-##TT--------------TT@SS-----------------------------------TT------%%-----|-%%%--||---------------S----|||-----------------------TT
-------||||||||--------------------------------------------##-##TT-----TT-------TTT--K-TT-------------------TT----------TT------||-----|--|--ooo--------------------|||-----------------TT--TTTT
-------||||||||---------------------------------%%--------###-##TT-----TT---TT--TTt----TT--------------TT---TT----------TT---TT-||-----|--|-%%%%--------------------|||-----------------TT--TTTT
-------||||||||--------------------------g------||--------###-#-TT-----TT---TT--TTt--k-TT---k----------TT---TT----k-----TT---TT-||-rrrrrrrr--||---------------------|k|--#--------k-----TT--TTTT
XXXXXXXXXXXXXXXXXXXXXXXXXXXXXXXXXXXXXXXXXXXXXXXX||---XXXXXXXX-X-XXXXXXXXXXXXXXXXXXXXXXXXXXXXXXXXXXXXXXXXXXXXXXXXXXXXXXXXXXXXXXXX|%%%%%%%%%%%-||-XXXXXXXXXXXXXXXXXXXXXXXXXXXXXXXXXXXXXXXXXXXXXXXX
XXXXXXXXXXXXXXXXXXXXXXXXXXXXXXXXXXXXXXXXXXXXXXXX||---XXXXXXXX-X-XXXXXXXXXXXXXXXXXXXXXXXXXXXXXXXXXXXXXXXXXXXXXXXXXXXXXXXXXXXXXXXX|-|||||||||--||-XXXXXXXXXXXXXXXXXXXXXXXXXXXXXXXXXXXXXXXXXXXXXXXX
