-----------------------------------------------------------------------------------------------------------------------K---------------------------------------------------------------S--------
-----------------------------------------------------------------------------------------------------------------------o---------------------------------------------------------------S--------
----------------------------------------------------------------------------------------------------------------------%%%--------------------------------------------------------------S--------
---------------------------------------SSSSS---------------------------------------------------------------------------|------------------------------------------------------------------------
-----------------------------------------------------------------------------------------------------------------------|--------------------------------------------------------------oS--------
------------------------------------------------------------------------------------------------------------------o----|----------o---------------------------------------------------SS--@-----
--------%%%%%%%%-----------------oo-----------o-%-----S%%%SSSS-S-----QQQQ------o-------------------------------o%%%%---|------------------------------S%%%S-------------------------------------
---------||||||---------------------------------|------o|------------------------o------------o------------------||----|----------------------------%%%-|---------------------------------------
---------||||||---------------------------------|-------|--------------------------------------------------#-----||----|-----------------------------|--|---------------------------------------
---------||||||--------------------------#SS---o|-------|---------#g---------SS-------------------o--------------||-%%%%%o-o-------------------------|--|-----------------------------U----k----
------%%%%%%%%%%----------######--------##------|-------|----S--######Q#Q---------TT----------------------------%%|--|||%%%%%------------------------|--|--------------TT----#---Soo---@--------
-------||||||||-----------------------y###------|-------|-------#####-------------TT--k-TT---#----------TT--##--|||--|||-|||-------------------o-----|--|--------------TT---##------------------
-------||||||||---------------------######------|-------|-------#####--------K----TT----TT--##----------TT-##---|||--|||-|||-------------------------|--|------#-#-----TT---##------------------
-------||||||||---------------------######--k---|-------|-------#####------k-k----TT----TT--##----g--k--TT-##---%||--|||-|||-------------------------|k-|----###-#-----TT--###------------------
XXXXXXXXXXXXXXXXXXXXXXXXXXXXXXXXXXXXXXXXXX--XXXX|--XXX-XXXXXXXX-XXXXXXXXXXXXXXXXXXXX--XXXXXXXXXXXXXXXXXXXXXXXXX-|%%%-|%%%|XX-%--XXXXXXXX--------XXXXXXXXXXXXXXXXXXXXXXXXX--XXXXX--XXX-K--------X
XXXXXXXXXXXXXXXXXXXXXXXXXXXXXXXXXXXXXXXXXX--XXXX|--X----XX-XXXX-XXXXXXXXXXXXXXXXXXXXXXXXXXXXXXXXXXXXXXXXXXXXXXX-|-|--|-|-|-X-|--XXXX--X--------XXXXXXXXXXXXXXXXXXXXXXXXXX-XXXXXX--XXX-g--------X
