-------------------------------------------------------K------------------------------S---------------------------------------------------------------------------------------------------------
-------------------------------------------------------o----------------------------------------------------------------------------------------------------------------------------------------
----------------------------------------------S-------%%%---------------------------------------------------------------------------------------------------------------------------------------
--------------------------------SSSSSSSSSSSSSSSS-------|----------------------------------------------------------------------------------------SSSSSSSSSSSSSSSS--------------------------------
--------------------------------SSSSSSSSS--------------|-----------------------------------------------------------------------------------------S----------------------------------------------
--------------------------------SSSSSSSS-----ooo-------|----------------------------------------------------------------------------------------------------------------------------------------
--------%%%%%%%%----------------SSSSSSSS---SSSSS%%%----|------------------------------------------------------------------------%%%%-------S-----oo---SS---#--SS-----------------------------2--
---------||||||-------------S--------------------|-----o---r-------------------o-------------------------------------------------||------------------------#---------------------------------S--
---------||||||----------------------------------|--%%%%%%%%%%-------------------------------------------------------------------||-----------------------##------------------------------------
---------||||||-----------------ooooo---------oo-|---||||||||--------------------------------------------------------------------||-------------oo-------###------------------TT----------------
------%%%%%%%%%%----------------SSSSSS--------SS-|---||||||||------------------------------------------------------------%%%%----||----%%%%%%%SSS--------###------------------TT----------------
-------||||||||----------------------------------|---||||||||-------------------------------------TT-----TT---------------||-----||-----|||||---------y#####-------------##---TT---------TT----o
-------||||||||----------------------------------|---||||||||-------------------------------------TT-----TT---------------||-----||-----|||||---------######------TT----###---TT---------TT-----
-------||||||||----------------------g----k-k----oo--||||||||-ooo--------------#------------------TT-----TT--ooo----------||-----||-----|||||--------#######------TT---####---TT--k------TT----k
XXXXXXXXXXXXXXXX--XXXXXX---%%%%%XXXXXXXXXXXXXXXX%%%%-X|XXXXX%%%%XXXXXXXXXXXXXXXXXXXXXXXXXXXXXXXXXXXXXXXX-XXXXXXX-%%%%%%%%%||-%%%XXXXXXXXXXXXXXXXXXXXXXXXXXXXXXXX--XXXXXXXXX---XXXXXXXXXXXXXXXXXX
XXXXXXXXXXXXXXXX-XXXXXXX----|||-XXXXXXXXXXXXXXXX-||---|XXXXX-||-XXXXXXXXXXXXXXXXXXXXXXXXXXXXXXXXXXXXXXXX-XXXXXXX--|||||||-||--|-XXXXXXXXXXXXXXXXXXXXXXXXXXXX-XXX-XXXXXXXXXX---XXXXXXXXXXXXXXXXXX
