---------------------------------------------------------------------------------------------------------------------------------------K-K------------------------------------------------------
---------------------------------------------------------------------------------------------------------------------------------------o--------------------------------------------------------
--------------------------------------------------------------------------------------------------------------------------------------%%%%------------------------------------------------------
---------------------------------#-----------------------------------------------------------------------------------------------------||-------------------------------------------------------
---------------------------------------------------------------------------------------------------------------------------------------||-------------------------------------------------------
---------------------------------------------------------------------------------------------------------------------------------------|o-------------------------------------------------------
--------%%%%%%%%--------------------QQQQQ------oSSSS---------SS--U-@-----------------QQS---------------SSS-----o-or----SS------o--r----%%%------@SSSQSSSSS---SSS--------oS----------------------
---------||||||----------------------------------------------------------------@-------------------------------#%%%%----------##%%%%%%--|----%%%-------------------------------#----------U-----
---------||||||----------------------------####--------------------------------U------------------------------##-||---------####-||||---|-----|-------------------------------##---------##-----
---------||||||----------------------------###--------oo-----ooo----g----------U------------------------------##-||--------#####-||||-%%%-----|-------------------------------##--------##SS----
------%%%%%%%%%%----------------####-----#####--SSSSSSSSSSSSSSSS----S-U--------------------------------------###-||--------#####-||||--|------|-SSQQQ---S----USS--------------##-------###------
-------||||||||-----------------####-----####-------------------S------------------------------------------#-###-||------#######o||||--|------r------------------------------###------####------
-------||||||||-----------------####----######-----------------------------------------##----------------#######%||------#######%%|||--|----%%%%-----------------------------###-----#####------
-------||||||||------ggk----k---####--g#######-------g--------------------U-----------###------------k--########|||----#########|||||--|-----||---ggggy---k-----------------####----######---k--
XXXXXXXXXXXXXXXXXXXXXXXXXXXXXXXXXXXXXXXXXXXXXXXXXXXXXXXXXXXXXXXXXXXXXXXXX-X-XXXXXXXXXXXXXXXXXXXX--XXXXXXXXXXXXXXXXXXXXXXXXXXXXXX|||||-%%%----||-XXXXXXXXXXXXXXXX--------XXXXXXXXXXXXXXXXXX--XXXX
XXXXXXXXXXXXXXXXXXXXXXXXXXXXXXXXXXXXXXXXXXXXXXXXXXXXXXXXXXXXXXXXXXXXXXXXX---XXXXXXXXXXXXXXXXXXXXX-XXXXXXXXXXXXXXXXXXXXXXXXXXXXXo|||||--|-----||-XXXXXXXXXXXXXXXX--------XXXXXXX-XXXXXXXXXX--XXXX
