------------------------------------------------------------------------------------------------------------------------------------------------------------------------------------------------
------------------------------------------------------------------------------------------------------------------------------------------------------------------------------------------------
------------------------------------------------------------------------------------------------------------------------------------------------------------------------------------------------
----------------------------------------------------------------S-----S-----SS--------------------------------------------------SSSSSSSS----------------------------------------SSSSSSSSSSSSSSSS
------------------------------------------------------------------------------------------------------------------------------------------------------------------------------------------------
----------------------------------------------------------------------------------------oooo----------------------------------------------------------------------------------------------------
--------%%%%%%%%------------------SS-----------------QQQ-------o---------------------------------------QQ---------------------------------------------------------------------------------------
---------||||||------------------------------------------------#---------------------------------------------------------------------------------o----------------------------------------------
---------||||||-----------------------------------------------##-----------#---------------------------------------------------------------#----%%%---------------------------------------------
---------||||||----------------------------------------------###------------------------------#-------------------------------------------##-----|-------------#--------------------------------
------%%%%%%%%%%----------######---------%%%-----###--##-----###-----------#----#-#--2--------#-######QQQQ---US--------------------------###-----|------------##---------------------2----------
-------||||||||---------------------------|-------##--------####-----------#----#------------##-###------------------------------------#####-----|------------##----------------------------#---
-------||||||||---------------------------|-----####--------####--------####----#------------#TT#-#-----------------------------------######-----|-------------#---------------#o----------#----
-------||||||||---------------------------|-----####--------####--------####----#------k--#-##TT#--#------k-----#------k-----g-g-----#######-----|--------##---#-------------oor##--------##k---
XXXXXXXXXXXXXXXXXXXXXXXXXXXXXXXXXXXXXXXXXXX---%%XXXXXXXXXXXXXXXXXXXXXXXXXXXXXXXXXXXXXXXXXXXXXXXXXXXX--XXXXXXXXXXXXXXXXXXXXXXXXXXXXXXXXXXXXXXXXXXXXXXXXXXXXXXX-----XXX-XXXXXX%%%%XXXXXXXXXXXXXXXX
XXXXXXXXXXXXXXXXXXXXXXXXXXXXXXXX-XXXXXXXXXX---||XXXX-XXXXXXXXXXXXXXXXXXXXXXXX-XXXXXXXXXXXXXXXXXXXXXX--XXXXXXXXXXX-XXXXXXXXXXXXXXXXXXXXXXXXXXXXXXXXXXXXXXXXXXX-----XXX-XXXXXX-X|XXXXXXXXXXXXXXXXX
