-----------------------------------------------------------------------K---------------K-------------------------------------------------------------------------------K------------------------
-----------------------------------------------------------------------o---------------o-------------------------------------------------------------------------------o------------------------
----------------------------------------------------------------------%%--------------%%%-----------------------------------------------------------------------------%%%-----------------------
----------------------------------------------------------------------||---------------|----------------------------------------SSSSSSSSSSSSSSSS-----------------------|------------------------
----------------------------------------------------------------------||---------------|-------o-----------------------------------------------------------------------|------------------------
-----------------------------o----------------------------------------||---------------|------%%-----------------------------------------------------------------------|----------------------o-
--------%%%%%%%%---------------------QQQQ-----------------------%%%%--||---------------|------||-------U--------SSSS-SSSSSS-SSSS%%%-----------------QSQS---------------|--------SSSSS-----------
---------||||||--------------------------------------------------||---||----------%%%%%%------||---------------------------------|-------------------------------------|-------#----------------
---------||||||--------------------------------------------------||---||-----------||||-------||---------------------------------|-------------------------------------|------------------------
---------||||||----------------o---------------------------------||---|%%%---------||||---oo--||-----------SSS--Soo--------------|---------------------g---------------|------------------------
------%%%%%%%%%%----------------#--##--------#-------------------||---|-|----------||||--%%%--||------U-----S---SSS----------S-o-|---------------S--SSSS-----US--------|-------------S---SSSSSSS
-------||||||||------------------------------##------------------||---|-|----------||||---|--o||--------------------------------o|-------------------------------------|------or----------------
-------||||||||-----------------------------###--------------TT--||---|-|----------||||---|-%%%%--------------------------------%%-------------------------------------|-----%%%----------------
-------||||||||-k--------#---o--------------###--------------TT--||---|-|----------||||---|--||---#k--------k------gg----------g||-----------g-----k-kk---k-------or---|------|-----------------
XXXXXXXXXXXXXXXXXXXXXXX--X---%--XXXXXXXXXXXXXXXXXXXXXXXXXXXXXXXX-||---%%%XX-%%%-%%%%%%%%%-|--||-XXXXXXXXX--XXXXXXXXXXXXXXXXXXXXX||-XXXXXXXXX-X%XXXXXXXXXXXXXXXXX-%%%%%%%%%----|-XXXXXXXXXXXXXXXX
XXXXXXXXXXXXXXXXXXXXXXX--X---|--XXXXXXXXXXXXXXXXXXXXXXXXXXXXXXXX-||----|-XX--|---|||||||--|--||-XXXXXXXXX-XXXXXXXXXXXXXXXXXXXXXX||-XXXXXXXXX-X|-XXXXXXXXXXXXXXXX--|||||||-----|-XXXXXXXXXXXXXXXX
