-------------------------------------------------------------------------------------------------------------------------------------------------------K----------------------------------------
-------------------------------------------------------------------------------------------------------S---------------------------------------------o-o----------------------------------------
-----------------------------------------------------------------------------------------------------------------------------------------------------%%%%---------------------------------------
------------------------------------------------------------------------------------------------------------------------------------------------------||----------------------------------------
----------------------------------------------------------------------------------------------------------K-------------------------------------------||-------o--------------------------------
------------------------------------------------------------------------------------------oo----------------------------------------------------o-----||----r-%%ooo---------oooo----------------
--------%%%%%%%%------------------------------------------------------SSSSS---------------------------SQQ--------SSQQSSoo------------QQ---------%%----||--%%%%||------------------------S-------
---------||||||-------------------------------------------------------------------------------oo------------------------------------------------||----||---||-||--------------------------------
---------||||||--------------------------------------------------------------------------------------------------------------S------------------||-%--||---||-||--------------------------------
---------||||||----------------------------------------------------------------------------------------------------------------o----g-----------||-|--||-oooo-||---------oooo------------SSS----
------%%%%%%%%%%----------######-------TT------------------------------------------------------------SSQS---------#-S--------SSSSSS###----------||-|--||%%%%%-||--------%%%%%-------------------
-------||||||||------------------------TT---------------------------------------TT---------##------------------------------------------K--------||-|--||-|||-oo|---------|||--------tt----------
-------||||||||-----------------TT-----TT----#----------------------------------TT---------#------------------------------------TT--------------||-|--||-|||%%%%---------|||--------tt---#------
-------||||||||-----------------TT-----TT---g#---------------g------g-----------TT------####-----------------------k--k-----k---TT----k---------||-|--rrrrr|-||----r-----|||--------tt---------o
XXXXXXXXXXXXXXXXXXXXXXXXXXXXXXXXXXXXXXXXXXXXXXXXXXXXXXXXXXXXXXXXXXXXXXXXXXXXXXXXXXX--XXXXXXX----XXXX------XXXXXXXXXXXXXXXXX-XXXXXXXXXXXXXXXXXXXX||%%%%%%%%%%-||--%%%%%%%%%%%-%%%-XXXXXXXXXXXXXXX
XXXXXXXXXXXXXXXXXXXXXXXXXXXXXXXXXXXXXXXXXXXXXXXXXXXXXXXXXXXXXXX-XXXXXXXXXXXXXXXXXXX--XXXXXXX----XXXX--X---X-XXXXXXXXXXXXXXX-XXXXXXXXXXXXXXXXXXXX||-||||||||--||---|||||||||---|-XXXXXXXXXXXX-XXX
