------------------------------------------------------------------------------------------------------------------------------------------------------------------------------------------------
------------------------------------------------------------------------------------------------------------------------------------------------------------------------------------------------
------------------------------------------------------------------------------------------------------------------------------------------------------------------------------------------------
------------------------------------------------SSSSSSSSSSSSSSSSSSSSSSS---------SSSSSSSSSSSSSSSS-----------------SSSSSSSSSSSSSS-----------------SSS---------------------------------------------
-----------------------------------------------o------------------------------------------------------------------------------------------------------------------------------------------------
-------------------------------------------------------------------------------------------------oo-------o-------------------------------------------------------------------------------------
--------%%%%%%%%----------------------------------r----%%---------------------------------------%%%%-----%%%-----ooo---------oo-----------------------------------------------------------------
---------||||||---------------------------------%%%%%--||-------S--------------------------------||-------|----------------------oo---------------------------------------------S---------------
---------||||||---------------------------------#|||---||----------------------------------------||-------|-------------------SS-----------#-----------------------------------------TT---------
---------||||||----------------------------------|||---||---------------------o---------SSSS-----||--%%--ooo----o--------------o---------#o#--------%%%%SSS--------------------------TT---------
------%%%%%%%%%%----------######-----------------|||---||--#----TT-----TT-----------------------%||--||-%%%%%---S--SS----#---------------#%%---------||------------------------------##---------
-------||||||||---------------------------------o|||oo-||--#----TT-----TT-----------------------|||--||--|||------------###-------------###|---o-----||----------K------------------------------
-------||||||||---------------------------------%%|%%%-||#-#----TT-----TT-----------------------|||--||--|||%%%%-------####-----------#####|------o--||----------#-----TT----------------TT-----
-------||||||||-----------------------gg--------|||-|--||###----TT-----TT---k-------------------|||--||--|||-||-----o-#####----------######|----%%%%-||----------#-----TT---k---k--------TT-----
XXXXXXXXXXXXXXXXXXXXXXXXXXXXXXXXXXXXXXXXXXXXXXXX|||-|XXXXXXX---XXXXXXXXXXXXXXXXX--X--XXXXXXXXX-X|%%%%|%%%%%%-||-XXXXXXXXXXXXXXXXXXXXXXXXXXX|---X-||--||XXXXXXXXXXXXXXXXXXXXXXXXXXXXXXXXX-XXXXXXX
XXXXXXXXXXXXXXXXXXXXXXXXXXXXXXXXXXXXXXXXXXXXXXXX||X-|XXXXXXX---XXXXXXXXXXXXXXXXXX-X--XXXXXXX-X-X|-||-|-||||--||-XXXXXXXXXXXXXXXXXXXXXXXXXXX|---X-||--||XXXXXXXXXXXXXXXXXXXXXXXXXXXXXXXXX-XXXXXXX
