-------------------------------------------------------------------------------------------------------------------------------------------------------K----------------------------------------
-------------------------------------------------------------------------------------------------------------------------------------------------------o----------------------------------------
------------------------------------------------------------------------------------------------------------------------------------------------------%%%---------------------------------------
----------------------------------------------------------------S--SSS---------------------------------------------------------------------------------|----------------------------------------
-------------------------------------------------------------------------------------------------------------------------------------------------------|----------------------------------------
-----------------------------------------------------------oo------------------------------------------------------------------------------------------|------o---------------------------------
--------%%%%%%%%--------S------------SS---------%%%%%S----%%%%----------------------------------------SSSSSS------------------------Q----------U%------|-----%%%-----------------------S--------
---------||||||---%%%%%--------------------------|||-------||-----------------------------------------------------------------------------------|------|------|-%%%o-------o%%%%------------K---
---------||||||----|||---------------------------|||-------||------------------------------##---------------------------------------------------|------|------|--|---------#-||-----------------
---------||||||----|||---------------------------|||-------||--o---------------------#-----##--#------------------------------------------------|------|-ooooo|--|--------##-||---------#-------
------%%%%%%%%%%---|||-------------o-----------S-|||--%%%%%%%%%%%TT----TT------------------##-##---------SSSSS-------------------S--------------|------|%%%%--|--|--------##-||--------##-------
-------||||||||----|tt-------------------------S-|||---|||||||||-TT----TTT------------------####--------------------------#------S-------TT-----|------|-||--ooo-|-------###-||--------##-------
-------||||||||----|tt---------------------------|||---|||||||||-TT----TTt-----TT------TT--#####--------------------------#--------------TT-----|------|-||-%%%%-|------####-||-----####--------
-------||||||||----|tt----------------k--------S-|||---|||||||||-TT----TTt-----TT------TT--#####--------------------gg---##----#---k-kg--TT-----|--rr--rr||--||--|-----#####-||----#####--------
XXXXXXXXXXXXXXXX--XXXXXXXX--%%--XXXXXXXXXX---XXX%%%%%X%XXXXX||||XXXXXXXXXXXXXXXXXXXXXXXXXXXXXXXXXXXXXXXXXXXXXXXXXXXXXXXXXXXXXXXXXXXXXXXXXXXXXXXX%%%%%%%%%%%%-||--|XXXXXXXXX--||-XXXXXXXXXXXXXXXX
XXXXXXXXXXXXXXXX--XXXXXXXX--||--XXXXXXXXXX---XXXXX||-X|XXXXXX|||XXXXXXXXXXXXXXXXXXXXXXXXXXXXXXXXXXXXXXXXXXXXXXXXXXXXXXXXXXXXXXXXXXXXXXXXXXXXXXXX-||||||||||--||--|XXXXXXXXX--||-XXXXXXXXX-XXXXXX
