-----------------------------------------------------------------------K------------------------------------------------------------------------------------------------------------------------
-----------------------------------------------------------------------o------------------------------------------------------------------------------------------------------------------------
-----------------------------------------------------------------------%%-----------------------------------------------------------------------------------------------------------------------
------------------------------------------------SSSSSSSSSSSSSSSS-------||---------------------------------------------------------------------------------------SSSSSSSSSSSSSSSS---------------S
------------------------------------------------SS---SSS-----S---------||---------------------------------------------------------------------------------------SS------------------------------
-------------------------------S----------------SS---SSS----SSS---o----||%---------------------------------------oooo----o----------------------------------------------------------------------
--------%%%%%%%%--------------------------------S-----SSo---SSS-%%%%---|||-------------------------------------------------------------Soo-----o-----------------SS--SSSS----SSS----------------
---------||||||---------------------------------S----------------||----|||---%%%--------------------------------S----------------------------------------------o--------------------------------
---------||||||----------------------------###--S----------------||----|||----|---------------------------------------------------------------------------------------------------------------S-
---------||||||----------------------------###--So-oooooS-SSSSoS-||-%%%%%%----|----------------------------#----------------------------------------------------oo------------------------SSSSSS
------%%%%%%%%%%--------SS%S-------------####---SSSSSSSS-----SSS%%|--||||-----|--------------o-------------------TT-------------------------SS-------------#-------------------------------S-S--
-------||||||||-----------|--------------####oooS---------------|||--||||-----|--------tt------------------------TT----------------------------------------#------------------------------------
-------||||||||-----------|-------------######--S---------------|||--||||-----|--------tt------------------#-----TT--------------------------------------###-------------------------------S----
-------||||||||----r------|-----------g#######-------------ggg--|||--||||-----|---g----tt---k--g-------g---------TT---k--------o---k--------------------###----o-------------g-g----------------
XXXXXXXXXXXXXXXX--%%%----%%%----XXXXXXXXXXXXXXXXXXXXXXXXXXXXXXXX|||--|%%%%%%--|-XXXXXXXXXXXXXXXXXXXXXXXXXXXXXXXXXXXXXXXXXXXXXXXX--------XXXXXXXX-XXXXXXXXXXX-%%%XXXXXXXXXXXXXXXX--XX-----SSS-X-X
XXXXXXXXXXXXXXXX---|------|-----XXXXXXXXXXX-X-XXXXXXXXXXXXXXXXXX|||--|-||||---|-XXXXXXXXXXXXXXXXXXXXXXXXXXXXXXXXXXXXXXXXXXXXXXXX--------XXXXXXXX--XXXXXXXXXX--|-XXXXXXXXXXXXXXXX--XX---------XXX
