--------------------------------------------------------------------------------------------------------------------------------------------------------------------------------
--------------------------------------------------------------------------------------------------------------------------------------------------------------------------------
--------------------------------------------------------------------------------------------------------------------------------------------------------------------------------
----------------------------------------------S---SSSSSSSSSSSSSS----------------------------------------------------S-------------SSS------------------------------------SSS-S--
----------------------------------------------------------------------------------------------------------------------------------------------K---------------------------S-----
--------------------o-----------------------------------------------------------------------------------------------------------------------------------------------------------
--------%%%%%%%%-------#-----------------------------------------------------------------------------------------ooo-----oo-----------------------U------------o----------S-----
---------||||||--S----##-------------------------------------------------o------------------------------oo----------------------------#-----------------------------------------
---------||||||-S----###------------------------------------------%%%%%%-------------------------------------------------SS----------##--------------------------%%%------------
---------||||||-----####-------------------------------------------||||---SSSSS---------------------------------------------2-------###-------------------go------|--------r--r-
------%%%%%%%%%%---#####-TT----------------------------------------||||------------##----##------------------------#--------S------####-------------------SS----%%%%--%%%%%%%%%%
-------||||||||---######-##------K-----TT--------------------------||||-----------#-#----#-------------------------#--------------#####--------------------------||----||||||||-
-------||||||||--#######-#T------S-----TT--------------------------||||----------##-#-B--##----#-----------------#-#-------------######--------------------------||----||||||||-
-------||||||||-########-#T------------TT------------g-------------||||---------#---#-b--##----#-----------------#-#--#---------########---------------------k---||----||||||||-
XXXXXXXXXXXXXXXXXXXXXXXXXXXXXXXXXXXXXXXXXXXXXXXXXXXXXXXXXXXXXXXX-XXX|||----XXXX-XXXXXXXXXXX-XXXXXX--XX-XXXXXXXXXXXXXXXXXX---X---XXXXXXXXX---XXXXXXXXXXXXXXXXXXXX-X|----||||||||-
XXXXXXXXXXXXXXXXXXXXXXXXXXXXXXXXXXXXXXXXXXXXXXXXXXXXXXXXXXXXXXXX-XXX|||---XXXXX-XXXXXXXXXXXXXXXXXXX-XX-XXXXXXXXXXXXXXXXXX---X---XXXXXXXXX---XXXXXXXXXXXXXXXXXXXX-XX----||||||||-
