------------------------------------------------------------------------------------------------------------------------------------------------------------------------------------------------
------------------------------------------------------S---S-------------------------------------------------------------------------------------------------------------------------------------
------------------------------------------------------S-----------------------------------------------------------------------------------------------------------------------------------------
--------------------------------SSSSSSSSSSSSSSSS--S---------------------------------------------SS-------------------------------------------------------------S--------------------------------
--------------------------------S------S--------------------------------------------------------------------------------------------------------------------------------------------------------
----------------oooo---------------------------S---------------------------------------------------------------------------------------oooo---------------------------------------o------------o
--------%%%%%%%%------------------------------SSSSSSSSS---SSSSS----------------------------------or-----%------------U---------------------------------------------Q---SQS------%%%-------------
---------||||||---------------------------------------------------------------------------------%%%%%%--|--------------------S-K--------------oo-----------#---------------------|--------------
---------||||||----------------------------y-----------------------------------------------------||||---|--%%SSS-------------K-----------------------------#---------------------|--------------
---------||||||----------------------------##----ooo----------oo--------------------%%%----o-----||||---|--||-------g--------------------------------------#---------------------|-------ooo----
------%%%%%%%%%%-2-----@------------------###---SSSSSS-------SSS----------------%%%--|-----------||||---|--||-------S--------US--TT------TT----------------#-----S---SS@SS--S@S--|-----%%%%%%%%%
-------||||||||-------------------TT---TT-###------------------------------------|---|-----------|||tt--|--#|---SSS-S------------TT------TT--------------#-#---------------------|------|||||||-
-------||||||||-------------------TT---TT-###------------------------------------|---|-----------|||tt--|--#|--------------------TT------TT------------#####---------------------|------|||||||-
-------||||||||-------------------TT---TT-###--------------kk--------------------|---|-----------|||tt--|--#|------k-------------TT------TT-----k------#####-------U--------k----|-rr---|||||||-
XXXXXXXXXXXXXXXXXXXXXXXX--XXX--XXXXXXXXXXXXXXXXXXXXXXXXXXXXXXXXXXXXXXXXXXXXX%XXX-%%%-|-----X%%%%XXXXXXXXXXXXXX-XXXXXXXXXXXX-XXXXXXXXXXXXXXXXXXXXXXXXXXXXXXXXXXXX-XXXXXX-X-X-XXXX-%%%%%XXXXXX|||-
XXXXXXXXXXXXXXXXXXXXXXXX--XXX-XXXXXXXXXXXXXXXXXXXXXXXXXXXXXXXXXXXXXXXXXXXXXXXXXX--|--|-------||-XXXXXXXXXXXXXXXXXXXXXXXXXXX-XXXXXXXXXXXXXXXXXXXXXXXXXXXXXXXXXXXX-XXXX-X-X-X-XXXX--XX|X-XXXXX|||-
