------------------------------------------------------------------------------------------------------------------------------------------------------------------------------------------------
-------------------------------------------------------------------------------------------------------------------------------------------------SS-----------S--K------------------------------
-------------------------------------------------------------------------------------------------------------------------------------------------------------SSS--------------------------------
--------------------------------------------------------------------------------SSSSSSSSSSSSSSSS------------------------------------------------SSSSSSSSSSSSSSSS-------------------SSSS--------S
------------------------------------------------------------------------------------------------------------------------------------------------SSSSSSSSS---------------------------------------
--------------------------------------------------------------------------------------------------o--------------------------------------------oSSSSSSSS---SoSSS--------------------------------
--------%%%%%%%%-----SSS-------------------------------------------------------o---------------------------------orr---SS-----oo%%%%---------%%%SSSSSSSSo--SSSSSSSSSSSSSo---SS------------------
---------||||||-------------------------------------------------------------------------------------------------S%%%%%%o---y-----||-----------|-S-----------------------------------------------
---------||||||---------------------------------------------------------------#---------------------------------S-||||-------SSS-||-----------|---------------S---------------------------------
---------||||||-------g--------oS---------------------------------------------#------o----------------------------||||-------SSS-||-----------|-Soooo---------oo-------g-------oTTTT------------
------%%%%%%%%%%-S--SSSS-----U--SSS-------------------------------------------#------2------------TT-2--TT----TT--||||---#-S----%%%-----%%%%%-|-SSSSS--##-----SSSSSSSSSS--------TTTT------------
-------||||||||------SS------------------------------------------------------###--------TT----TT--TT----TT----TT--||||--##-------|-------|||--|--#----###-------S---S---------K-TTTT---TT-------
-------||||||||-------S--------------------S-K------------#------------------###TT------TT----TT--TT----TT----TT--||||-###-K-----|-------|||--%--#----###-------S---S-----------TTTT---TT-------
-------||||||||----k------k-------------------------------#-------ggg-------####TT----k-TT----TT--TT----TT----TT--|||#####-S-----|------k|||--|--##--####--kk------k-kk-----k---TTTT---TT----###
XXXXXXXXXXXXXXXXXXXXXXXXXXX-XXXX--XXX-XXX----X-XXXX-XXXXXXXXXXXXXXXXXXXXXXXXXXXXXXXXXXXXXXXXXXXXXXXXXXXXXXXXXXXXXXXXXXXXXXSS-XXX%%%%-XXXXXXX--%-XXXXXXXXXXXXXXXXXXXXXXXXXXXXXXXXXXXXXXXXXXXXXXXX
XXXXXXXXXXXXXXXXXXXXXXXXXXX-XXXX--XXX-XXX----X-XXXX-XXXXXXXXXXXXXXXXXXXXXXXXXXXXXXXXXXXXXXXXXXXXXXXXXXXXXXXXXXXXXXXXXXXXXX---XXX-||--XXXXXXX--|-XXXXXXXXXXXXXXXXXXXXXXXXXXXXXXXXXXXXXXXXXXXXXXXX
