----------------------------------------------------------------------------------------------------------------------------------------------------------------
----------------------------------------------------------------------------------------------------------------------------------------------------------------
-------------------------------U---------------------------------------------------------------U----------------------------------------------------------------
--------------------------------------------------------------------------------S-----S--S---S--SSSSSSSS---SSSSS------------------------------------------------
----------------------------------------------------------------------------------------------------------------------------------------------------------------
---------------------------------------------oo-----------------------------------------------------------------------------------------------------------------
-------SSSSS---S---------------------------------------------------------o-----------------------------------------QSSS-----------SQSSSSoSoS--@S--------S-------
------------------------oo-o--U-SS----SS------------##---oo--------SS-%%%-------------o---------------------------------------y---------------------------------
--------------------%%%%%%%%%---S--------------------------------------|------------%%%%%%%%%--------------------------------y----------S-----------------------
---------------------|||||||--1-S-----------------------SS-------------|-------------|||||||--------------------------------y#----------------------------------
-------SS------Q%%%--|||||||----------------TT-S-##-----------------TT-|-TT----------||||%%%%%%%-------------------SSS------##-------%SSS---y-------------------
-----------------|---|||||||----------------TT----------------TT#---TT-|-TT----------||||-|||||----------------------------###-------|--------------------------
-----------tt----|---|||||||-------------TT-TT----------------TT----TT-|-TT----T-----||||-|||||%--------------------------####-------|----%%--------------------
g----------tt----|---||||||g-------------TT-TT------------k---TT----TT-|-TT----T-----|g||-||||||-------------------g-----#####-------|----||--------------------
XXXXXXXXXXXXXXXX-|X--||||||XXXX-XXXXXXXXXXXXXXXXXXXXXXXXXXXXXXXXXXXXXXXXXXXXXXXX-X---||||-||||||XXXXX-X-------XXXXXXXXXXXXXXXXXX-XXXXXXX--||XXX-XXXXXXXXXXXXXXXX
XXXXXXXXXXXXXXXX-XX--||||||XXXX-XXXXXXXXXXXXXXXXXXXXXXXXXXXXXXXXXXXXXXXXXXXXXXXX-X---||||-||||||XXXXX-X-------XXXXXXXXXXXXXXXXXX-XXXX-XX--||-XX-XXXXXXXXXXXXXXXX
