------------------------------------------------------------------------------------------------------------------------------------------------------------------------------------------------
---------------------------------S-S--SS--S---S-------------------------------------------------------------------------------------------------------------------------------------------------
---------------------------------------------SSS------------------------------------------------------------------------------------------------------------------------------------------------
--------------------------------SSSSSSSSSSSSSSSS--------------------------------SSSSSSSS----------------------------------------------------------------------------------------------SS-SSSSSSS
--------------------------------SSSSSSSSS--SSS-S---------------o-----------------------------------------------U--------------------------------------------------------------------------------
--------------------------------SSSSSSSS---SSSSS--------------%%-----------------------------------------------------------------------------------------%--------------------------------------
--------%%%%%%%%----SQQQ--SS---oSSSSSSSSo---SSSS--------------||-------------------------------------------------------SSS-----o-------------------------|--------------------------------------
---------||||||-----------------------------------------------||--------------------------------------------------------------------------------%--------|----%%--------------------------------
---------||||||-----------------------------------------------||--------------------------------------------------------------------------------|--------|----||--------------------------------
---------||||||--------------#--ooooooooo-----oo----------oo--||-------------------------------------------------------------------------TT-----|--------|----||--------------------------------
------%%%%%%%%%%##----------###-SSSSSSSSSS---SSS%%-------%%%%-||--------%%%%%-----------------------------------#------------------------TT-----|--------|-#--||--------------------------------
-------||||||||------------###---SS-----S-------||--------||--||---------|||------------------TT-----------------------------------------TT-----|--------|-#--||--------------TT--TT------------
-------||||||||-----------####---S--------------||--------||--S%---------|||---%--------------TT-----------------------------------------TT-----|--------|-#--||--------------TT--TT----##------
-------||||||||----k-kgg--###----SS-------------||--------r|---|---o-----|||---|-----k--------TT---g----------------ok----#--------------TT----o|------g-|----||--gggg--------TT--TT----##------
XXXXXXXXXXXXXXXXXXXXXXXXXXXXXXXXXXXXXXXXXXXXXXXX||----%%%%%%%%%%%%%%XXXXXXXXXXXXXXXXXXXXXXXXXXXXXXXXXXXXXXXXXXXXXXXXXXXXXXXXXXXX--XXXXXXXXX----X|-----XXXXX---||XXXXXXXXXXXXXXXXXXXXXXXXXX---X-X
XXXXXXXXXXXXXXXXXXXXXXXXXXXXXXXXXXXXXXXXXXXXXXXX||-----||||||||||||XXXXXXXXXX-X-XXXXXXXXXXXXXXXXXXXXXXXXXXXXXXXXXXXXXXXXXXXXXXXX-XXXXXXXXXX----X|-----XXXXXX--||XXXXXXXXXXXXXXXXXXXXXXXXXX---X-X
