-------------------%------------------------------------------------------------------------------------------------------------------------------------------------------------
-------------------|------------------------------------------------------------------------------------------------------------------------------------------------------------
-------------------|------------------------------------------------------------------------------------------------------------------------------------------------------------
-------------------|------------------------------------------------------------------------------------------------------------------------------------------------------------
-------------------g------------------------------------------------------------------------------------------------------------------------------------------------------------
-------------------|------------------------------------------------------------------------------------------------------------------------------------------------------------
--------%%%%%%%%---|--r-----------------------------------------------r--------------------------------oooo---@%----------------SS----------------------------------------------
---------||||||-%-%|%%%%%---------------------------------------%%%%%%%%%------------------S-------------------|--------------------------------ooS----------------------g------
---------||||||-|-||-|||-----------------------------------------|||||||------------------SS------------SSSS-U-|--------------------------------------------------------%%%%%---
---------||||||-|-||-|||-----------------------------------------|||||||------------------S----------------Ky#-|---------------------------------------------------------|||----
------%%%%%%%%%%|-||-||So-------------------------------@-------QQ|||||SS----------------------------SSSS---##-|--S-----S----------------TT---------TT-TT---TT----2------|||--#-
-------||||||||-|-||-||--------------------------------------#----|||||------------------------------------###-|-------------------------TT---------TT-TT---TT-----------|||-##-
-------||||||||-|-||-||-------------------------------------##----|||||----------------##-----------------####-|-------------------------TT---------TT-TT---TT-----------|||###-
-------||||||||-|-||-||ggg--y--k-gg------g---------------k-####--gggg||--gggggg--k-----##----------g-----#####-|g-------y-ggg--------y---TT-------k-TT-TT---TT-----------||####-
XXXXXXXXXXXXXXXXXXXXXXXXXXXXXXXX-XXXXXXXXXXXXXXX--XXXXXXXXXXXXXXXXXXXXXXXXXXXXXXXXXXXXXXX--XXXXXXXXXXXXXXXXXXX-XXXXXXXXXXXXXXXXXXXXXXXXXXXXXXXXXXXXXXXXXXXXXXXXX-XXXXXXXXXXXXXXX
XXXXXXXXXXXXXXXXXXXXXXXXXXXXXXXX-XXXXXXXXXXXXXXX-XXXXXXXXXXXXXXXXXXXXXXXXXXXXXXXXXXXXXXXX---XXXXXXXXXXXXXXXXXXXXXXXXXXXXXXXXXXXXXXXXXXXXXXXXXXXXXXXXXXXXXXXXXXXX-XXXXXXXXXXXXXXX
