-------------------------------------------------------K-----------------------------------------------------------------------------------------------S----------------------------------------
-------------------------------------------------------o----------------------------------------------------------------------------------------------SS-SS-------------------------------------
------------------------------------------------------%%%----------------------------------------------------------------------------------------------So---------------------------------------
------------------------------------------------#------|-----------------------------------------------------------------------------------------------------------------------------SS---------
-------------------------------------------------------|---------------------------------------------------------------------------------------o-------o-o--------------------------------------
-------------------------------------------------------|--------------------------o---------o-oo------------ooo-------------------------------%%Q-----oS----------------------------------------
--------%%%%%%%%----------------ooo---SSS----So--------|--------------------------------------------------%%%----------Q--------%%%%----------||------S@SS----@------------------oo---oo--------
---------||||||----------------------------------oo----o---r-----------------------------------------------|-----------------oo--||--------o--||-------------------%%%%----y--SS-----------#----
---------||||||--------------------------------S%%%%-%%%%%%%%----------------------------------------------|---------------------||---%%%-%K%-||--------------------||-----#--------------##--SS
---------||||||-----------------S---------SSSSSS-||---||||||------------------------------oo---------------|---------------------||----|--|o|-||-------k---SSS---oo-||----##-------------###---o
------%%%%%%%%%%----------######S--------------S-||---||||||-----------%%%%%%-----------%%%%%--------S%%%%%%%S---#-##--##-------%%|----|--%%%-||-oQo--S@QS------%%%-||--####------------####----
-------||||||||----------------------------------||---||||||------------||||-ooo---------|||-----------|||||-----#-----##----#--|||----|---|--||-----------------|--||--####-----------#####----
-------||||||||----------------------------------||---||||||------------||||%%%%---------|||-----------|||||----TT--#####---##--|||----|---|-%%%-----------------|--||-#####----------######----
-------||||||||-------------------------k--------||---||||||------------||||-||----------|||-----------|||||----TT---#k##---##--|||----|---|--|------------------|--||#####----------#######----
XXXXXXXXXXXXXXXXXXXXXXXXXXXXXXXXXXXXXXXXXX--XXXX-||---%%%|||%%%%%%%%%%%XXXX|-||--%%%%%%%X|||-----%%%%%%%%%%|----XXXXXXXXXXXXXXXX|||---%%%%%|--|--XXXXXXXX----XXXXoXXXXXXXXXX-X-XXXXXXXXXXXXXXXXX
XXXXXXXXXXXXXXXXXXXXXXXXXXXXXXXXXXXXXXXXXX--XXXX-||----|-|||-|||||||||--XXX|-||---X||||--|||------||||||||-|----XXXXXXXXXXXXXXXX|||----|||-|--|--XXXXXXXX----XXXXXXXXXXXXXXX-XXXXXXXXXXXXXXXXXXX
