------------------------------------------------------------------------------------------------------------------------------------------------------------------------------------------------
------------------------------------------------------------------------------------------------------------------------------------------------------------------------------------------------
------------------------------------------------------------------------------------------------------------------------------------------------------------------------------------------------
------------------------------------------------------o-------------------------------------------------------------------------SS--------------------------------------------------------------
----------------------------------------------------------------------------------------------------------------------------------------------------------------------------------o-------------
------------------------------------------------------------------------------------------------------------------------------------------------------------------------------------------------
--------%%%%%%%%------------------------------------------ooo------------------------------------o------------o-------------------------------------------------SS----SS@S---S------------------
---------||||||---------------------------------------------------o-------------------------------------------------------------------------------------------------------------------oo---o----
---------||||||---------------------------------S-------SSSSSS---%%%--------------------------------------#--------S----------------------------------------------------------------------------
---------||||||---------------------------oo----------------------|--------------------------------------##----o------------------------------------------------------------------------------SS
------%%%%%%%%%%----------######-2--------------------------------|-------------------------------SS----##-----S----------------------tt-------------2-----------S--S--------U------------------
-------||||||||------------------o--------------------------------|-----------------------------------y###----------------------------tt----------------TT--------------------------------------
-------||||||||---------------------------------------------------|-----------------------------------####----------------------------tt----------------TT----TT----------------------------SS--
-------||||||||--------------------------------o-------------ggg--|------------o--k--g---------------#####----------------------#-----tt-----k--g-g-----TT----TT---k------k-k--------------r----
XXXXXXXXXXXXXXXXXXXXXXXXXXXXXXXXXXXXXXX------S%%XXXXXXXXXXXXXXXX--XXXXX--%%%%%%%XXXXXXXXXXXXXXXXXXXXXXXXXX---XXX-----------X----XXXXXXXXXXXXXXXXXXXXXXXXXXXXXXXXXXXXXXXXXXXXXXXX---%%%%%%%%%%%--
XXXXXXXXXXXXXXXXXXXXXXXXXXXXXXXXXXXXXXX-------|X--XXXXXXXXXXXXXX--XXXXX---|||||-XXXXXXXXXXXXXXXXXXXXXXXXXX--XXXX-----------X---XXXXXXXXXXXXXXXXXXXXXXXXXXXXXXXXXXXXXXXXXXXXXXXXX----|||||||||---
