-----------------------------------------------------------------------------------------------------------------------K------------------------------------------------------------------------
------------------------------------------------------------------------------------------S----------------------------o------------------------------------------------------------------------
------------------------------------------------------------------------------------------SS--S-----------------------%%------------------------------------------------------------------------
----------------SSSSSSSSSSSSSSSS------------------------------SS----------------SSSSSSSSSSSSS-S--#--------------------||--------#---------------------------------------------------------------
--------------------------------------o-----------------------------------------SSSSSSSSSSS---------------------------||------------------------------------------------------------------------
---------------------------------------------------------------------------------SSSSSS------oSS----------------------||-----------------------------------------------------------------------o
--------%%%%%%%%--o----------oo--oo---SSS----------------------------SQSSS----SSSSSSSSSS----SSS------QQo-------o------||-----------------------------------------------------------------------S
---------||||||--------------------%--o--------------------------------------------------------------------#----------||-----o---------------%-%-#----------------------------------------------
---------||||||--------------SSS---|-----------------------------------------------------------------------##---------||----%%-------------#-|-|------------------------------------------------
---------||||||----------------S---|----------------------------------------------ooo------------o---------##---------||----||----r----------|-|------------#-----------------------------------
------%%%%%%%%%%--------####---S---|-----#--------TT----------------S-S---------SSSSS------------##-------####--------||-%%%||--%%%----------|-|-----2-----##---%%%--------------------------SSS
-------||||||||---------###--------|----##--------TT----TT------------------------------------K--###----#####---------||--|-||---|-----------|-|--------TT-##----|------------------------------
-------||||||||-------#####--------|---###---#----TT----TT---------------------------------------###---######---------||--|-||---|-------#-#-|-|--TT----TT-##----|------------------------------
-------||||||||-----######k--------|k-####---#-#--TT----TT---------------------------kkk--k-k---####---######---------||--|-||---|-------##--|-|--TT----TT-##----|---------------ggg---k---g----
XXXXXXXXXXXXXXXXXXXXXXXXXXX--XXXXXXXXXXXXXX--XXXXXXXXXXXXXXXXXXXXXXXXXXXXXXXXXXXXXXXXXXXXXXXXXXXXXXXXXXXXXXXXXXX-%%---%X%-%%%%%%-|--XXXXXXXXXX-XXXXXXXXXXXXXXXXX%%%XXXXXXXXXXXX-XXXXXXXXXXXXXXXX
XXXXXXXXXXXXXXXXXXXXXXXXXXX-XXXXXXXXXXXXXX--XXXXXXXXXXXXXXXX-X-XXXXXXXXXXXXXXXXXXXXXXXXXXXXXXXXXXXXXXXXXXXXXXXXX-||---|-|--||||--|--XXXXXXXXXX-XXXXXXXXXXXXXXXXX-|-XXXXXXXXXXX--XXXXXXXXXXXXXXXX
