-----------------------------------------------------------------------K------------------------------------------------------------------------------------------------------------------------
-----------------------------------------------------------------------o---o--------------------------------------------------------------------------------------------------------------------
-----------------------------------------------------------------------%------------------------------------------------------------------------------------------------------------------------
--------------------------------SSSSSSSSSSSSSSSS-----------------------|--------SSS-----------------------------------------------------------------------SSSSSS----------------SSSSSSSSSSS----S
---------------------------------------S-------S-----------------------|-------------------------------------------------------#----------------------------------------------------------------
-----------------------------------------------S-----------------------|----oooo----------------------------o---------------------o-------------------------------------------------------------
--------%%%%%%%%-------------------------------SK--------S------%%%%%--|--%%%%%%-SSSSSS--------------------%%-----------------------------------------------------------------------------------
---------||||||--------------------------------------------------|||---|---||||----------------------------||-----------------------------------------------------------------------------------
---------||||||---------------------------------%----------------|||---|---||||----------------------o-----||-------------------------------------------oo-----------------#--------------------
---------||||||--------------------oo-----------|----------------|||---|-ooo|||--gggo---------oo-----------||-------------oo-----------------------------T-------oo--------##-------------------
------%%%%%%%%%%----------#####-TTUSSS----------|---------%%-----|||---%%%%%%%%%%##SS------#---S-----2---%%%%%%%-2-------%%S----------------------SS-SSSoT---#-------------###------------------
-------||||||||-----------------TTT--@--TT------|---------||-ooo-|||----||||||||TT-----TT--##-------------|||||----------||-------TT---------------------T---#-----------TT###------------------
-------||||||||-----------------TTt-----TT------|---------||-%%--|||----||||%%%%TT-----TT--###--o---------|||||----------||-------TT-----TT----------TT--T---#-----------TT###------------------
-------||||||||-----------------TTt-----TT------|---------||-||--|o|----||||-||-TT-----TT--###------------|||||----------||-------TT-----TT----------TT--T---#----ggggg--TT###----g----------k--
XXXXXXXXXXXXXXXXXXXXXXXXXXXXXXXXXXXXXXXXXXXXXXXX|-XX-----%%|-||-%%%%%%%%%XX|-||-XXXXXXXXXXXXXXXX%%%%---%%%XXXXXXXXXXXXXXXXXXXXXXXXXXXXXX-XXX----XXXXXXXXXXXXXXX-XXXXXXXXXXXXXXXXXXXXXXXXXXXXXXXX
XXXXXXXXXXXXXXXXXXXXXXXXXXXXXXXXXXXXXXXXXXXXXXXX|-X------|||-||--|||||||-XX|-||-XXXXXXXXXXXXXXXXX||-----|XXXXXXXXXXXXXXXXXX-XXX-XXXXXXXX-XXX----XXXXXXXXXXXXXXX-XXXXXXXXXXXXXXXXXXXXXXXXXXXXXXXX
