-----------------------------------------------------------------------------------------------------------------------K------------------------------------------------------------------------
------------------------------------------------------------------------------------------------------------------------------------------------------------------------------------------------
----------------------------------------------------------------------------------------------------------------------%%------------------------------------------------------------------------
--------------------------------------------------------------------------SS--------------------SSSSSSS---------S-----||-----SSS--------------SS----------------SSSSSSSSSSSSSSSS-------SSSSSSSSS
----------------------------------------------------------------------------------------------------------------------||----------------------------------------S-------------------------------
----------------------------------------------------------------------------------------------------------------------||------------------------------------------------------------------------
--------%%%%%%%%--------------------------SS------------------------------------SS----------------------%--oo---------||----------------------------------------------------------o----------oo-
---------||||||---------------------------------------------------------------------------------%%%%%%%%|-------------||-----%%%---------------#-%%%%%%-----------------------------------------
---------||||||--------------------------------------------------------------------------------K-||||||-|--SSS--------||------|-------------------||||---------------------y-SS--------------S-S
---------||||||-------------------#-----------------------ooo------------------------------------||||||-|--SSSS-------||------|----------------#--||||-----#---------------#---------------SSSSS
------%%%%%%%%%%----------######-##-------------%%%----%%%%%%----------------------SSSS---------S||||||-|-------%%----||------|-%--------------#--||||---###---------------#--------S----------S
-------||||||||----------------------------------|------||||------------------------------------o|||oo|-|-------||----||------r-o--------------#--||||---###-------------###--------------------
-------||||||||-----------------#----------------|------||||%%%%--------------------------------%%|%%%|-|-------||----||----%%%%%%-------#-#-#-#--||||-#####-------------###--------------------
-------||||||||-----------------#-----ky----k-kg-|------||||-||-------k------------k--k---------|||-|-|-|--k----||----||-----||||--------#-----#--|||#######-#----------####--------------------
XXXXXXXXXXXXXXXXXXXXXXXXXXXXXXXXXXXXXXXXXXXXXXXX%%%%%%%-||||-||-XXXXXXXXXXXXXXXXXXXXXXXXXXXXXXXX||XXXXXXXXXXXXXX||----||%%%%%||||------XXX%-----XXXXXXXXXXXXXXXXXXX-XXXXXXXXXXXXXXXXXXXXX---XXXX
XXXXXXXXXXXXXXXXXXXXXXXXXXXXXXXXXXXXXXXXXXXXXXXX-|||||--||||-||-XXXXXXXXXXXXXXXXXXXXXXXXXXXXXXXX||X-XXXXXXXXXXXX||----||-|||-||||------XXX|---o-XXXXXXXXXXXX-XXXXXX-XXXXXXXXXXXXXXXXXXXXX---XXXX
