------------------------------------------------------------------------------------------------------------------------------------------------------------------------------------------------
------------------------------------------------------------------------------------------------------------------------------------------------------------------------------------------------
------------------------------------------------------------------------------------------------------------------------------------------------------------------------------------------------
--------------------------------SSSSSSSSSSSS----------------------------------------------------------------------------------------------------------------------------------------------------
----------------------------------------------------------------------------------o-------------------------------------------------------------------------------------------------------------
------------------------------------------------------------------------------------------------------------o----------------------------------------------------------------------------------%
--------%%%%%%%%-------S-S-------oo---SS--##----------S--------o---------------o----------------%----------%%-------------------------------------------%%%%%%o----2---------S--%%----------%%-|
---------||||||---------------------------##----------------------------------------------------|----------||-------------------------------------%%%%%%-||||%%%---K------------||----------||-|
---------||||||--------------------------###---------------##-----------------------------------|----------||--------------------------------------||||--||||-|-----------------||----------||-|
---------||||||-------------------------####---#----------###------------------------------o----|-----#--oooo--------------------------------------||||--||||-|-----------ooo---||-------oooo|-|
------%%%%%%%%%%------S@----SS---------#####---#---------###------------------------------------|-------%%%%%-----------------------------##-------||||--|%%|-|----o---------S--%%------%%%%%%-|
-------||||||||-----------------------y####----#--------####-------------------#----------------|--------|||---o-------------##----------##--------||||--||||-o-----------------||-------||||-oo
-------||||||||----------------------#######---#-------#######-----------------#----------------|--------|||-%%--------------##---------####-------||||--|||%%%%----------------||-------||||%%%
-------||||||||---------------------########---#----g-########-----------------#----------------|--------|||-||------g-------##-------g#####-------||||--|||-||-----------------||oo-----||||-|-
XXXXXXXXXXXXXXXXXXXXXXX-----XXXXXXXXXXXXXXX--XXXXXXXXXXXXXXXXXXX--XXXXXXXXXXXXXX--XXXXXXXX---X-X|%%%%%%%%%%%-||-XXXXXXXXXXXXXXXXXXXXXXXXXXXXXXXX%%%%%%%%%%%%-||-XXXXXXXX-----X--|%%%%-%%%XX||-|-
XXXXXXXXXXXXXXXXXXXXX-X-----XXXXXXXXXXXXXX---XXXXXXXXXXXXXXXXXXX--XXXXXXXXXXXXXX--XXXXXXXX---X-X|-|||||||||--||-XXXXXXXXXXXXXXXXXXXXXXXXXXXXXXXX-||||||||||--||-XXXXXXXX-----X-X|-||---|-X-||-|-
