---------------------------------------------------------------------K-K------------------------------------------------------------------------------------------------------------------------
---------------------------------------------------------------------o-o------------------------------------------------------------------------------------------------------------------------
--------------------------------------------------------------------%%%%%-----------------------------------------------------------------------------------------------------------------------
---------------------------------SS----------------------------------|||--------------SS----------------------------------------SSSSSS---------------------------------------------------SSS----
---------------------------------------------------------------------|||------------------------------------------------------------------------------------------------------------------------
-----------------oooo------------------------------------------------|||------%%---------------------------o------------------------------o-----------------------------------------------------
--------%%%%%%%%------------------------------------------------%----|||------||-SSSS--------SSS-----------%%--o--------------------------------------------------------------------------------
---------||||||----------------------------------------o--or----|-orr||o------||----------------%%%%-------||%%%--------------%%-o--------------------------------------------------------------
---------||||||---------------------------------------%%%%%%%---%%%%%%%%%--%--||-----------------||--------||-|#--------------||----------------------------------------------------------------
---------||||||----------------------------------------|||||-----|||||||---|--||TToooo---------o-||--------||-|#--------------||----------------------------------------------------------------
------%%%%%%%%%%---------------------------------------|||||-----|||||||---|--||TTSSSS-----------||-------%%|-|#%-------------||--------TT------------------------TT----TT----------------------
-------||||||||---TT-----------------------------------|||||-----|||||||---|--||TT---------------||-------|||-|#|-------------||--------TT--------TT--------------TT----TT--------TT------------
-------||||||||---TT-----------------------------------|||||-----|||||||---|--||TT---------------||-------|||###|-------------||--TT----TT---TT---TT--------------TT----TT--------TT-----#------
-------||||||||---TT--------------g--#--g--#gk---------|||||-----|||||||---|--||TT--------#------||----r--|||-##|-------------||--TT--k-TT---TT---TT-----g--------TT----TT-----k--TT-----#---ooo
XXXXXXXXXXXXXXXXXXXXXXXXXXX-XXXXXXXXXXXXXXXXXXXXXXXXXXXXXXXX-----||||%%%%%%%-%%|XXXXXXXXXXXXXXXX%%%%%%%%%%%%|---|------XXXXXX-||XXXXXXXXXXXXXXXXXXXXX-XXXXXXXXXXXXXXXXXXXXXXXXXXXXXXXXXXXXX-XXXX
XXXXXXXXXXXXXXXXXXXXXXXXXXXXXXXXXXXXXXXXXXXXXXXXXXXX-XXXXXXX---X-||||-|||||--|||XXXXXXXXXXXXXXXX-||||||||||-|--o|------XXXXXX-||XXXXXXXXXXXXXXXXXXXXX-XXXXXXXXXXXXXXXXXXXXXXXXXXXXXXXXXXXX--XXXX
