-------------------------------------------------------------------------------------------------------K---------------K------------------------------------------------------------------------
-------------------------------------------------------------------------------------------------------S---------------o------------------------------------------------------------------------
------------------------------------------------#---------------------------------------------------------------------%%%-----------------------------------------------------------------------
--------------------------------SSSSSSSSSSSSSSSS##----------------------------------------------SS---------------------|----------------------------------------SSSSS-SSoSS--SSSSSSSSSSoooooSSSS
--------------------------------S--------------------------------------------------------------------------------------|-------o-----------------------------------------------------%%%--------
---------------------------------------------------------------------------------------oooo----------------------------|------%%------------------------------------------------------|---------
--------%%%%%%%%----------------------------------------S----------------------------------------------%%--------------|------||---------------o----------------%%%-------o-----------|---------
---------||||||----------------------------#---#%-%%%%%--------%-----------------#------------oo%%%%%--||----%%%-------|------||---------------------------------|--------------------|---------
---------||||||----------------------------#####|--|||-----#---|---------------------------------|||---||-----|--------|------||--------------S-------K----------|--------S-----------|---%%%---
---------||||||---------------------------###---|--|||-----#---|-----g---------o--TT-------------|||---|SSS--S|-ro-----|------||---------------------------------|--------------------|----|----
------%%%%%%%%%%----------######---------####---|--|||-----#---|----SSS------SS---TT-------------|||---|------|-%%%----|------||--------------------------------%|--------------------|----|---#
-------||||||||-------------------------#####--#|--|||-----#---|------------------TT----TT-------|||---|------|--|-----|------||--------------------------------||--------------o-----|----|---#
-------||||||||------------------------######--#|--|||---###---|------------------TT----TT-------|||---|------|--|-----|----%%%%-----------------TT-------------||--------------%o----|----|---#
-------||||||||-----------------------######---#|--||k--####---|k---------k-------TT----TT----o--|||---|------|o-|oo---|-----||---kk-k-k---gk----TT---kk---kk---||-----------ggo%%%---|---g|---#
XXXXXXXXXXXXXXXXXXXXXXXXXXXXXXXXXXXXXXXXXXXX---XXXXXXXXXXXXXXXXXXXXXXXXXXXXXXXXX-XXXXXXXXXXXXXXX-|||---X--%%%%%%-%%%%-%%%%---||-XXXXXXXXXXXXXXXXXXXXXXXXXXXXXXXX||---XXXXXXXXXX%-|---XXXXXXXX-XX
XXXXXXXXXXXXXXXXXXXXXXXXXXXXXXXXXXXXXXXXXXXX--XXXXXXXXXXXXXXXXXXXXXXXXXXXXXXXXXXXXXXXXXXXXXXXXXX-|||---X---||||---||---||----||-XXXXXXXXXXXXXXXXXXXXXXXXXXXXXXXX||---X-XXXXXXXXX-|---XXXXXXXX-XX
