--------------------------S---------------------------------------------------------------------------------------------------------------------------------------------------------------------
-----------------K----S--SS---------------------------------------------------------------------------------------------------------------------------------------------------------------------
-------------------------SSS--------------------------------------------------------------------------------------------------------------------------------------------------------------------
-----------------SSSSSSSSSSSSSSS----------------SSSSSSSSSSSSSSSS--------------------------------------------------------------------------------------------------------------------------------
-----------------SS-SSSSSSSSSSSS------------------S--SS-----------------------------------------------------------------------------------------------------------------------------------------
----------------SSSSSSSSSSSSSSSS------------------S-------------------------------------oooo-----------------------------------oQ------------------------------o--------------------------------
--------%%%%%%%%SSSSSSSS-----SSS-------%%%--------So---------------------------------------------------SSS-----o--------------------------------%%%---------------------------------------------
---------||||||-------------------------|------------------------------------------------------o--------------------------------o----------------|----------------------------------------------
---------||||||-------------------------|--------------------------------------------------------------------------------------------------------|------------------------#---------------------
---------||||||-oooggooo------oo--------|-------Sooooooo------------------------TT-------------------------------oo------------------------------|------------------------#---------------------
------%%%%%%%%%%SSSSSSSS-S----SS%-------|-------SSSSSSS----------S---SS#--------TT---2------##---##---------SSS--SS------------S-----------------|----------------------####--------------------
-------||||||||---SSS-SSSS------|-------|------#-----------------S--------------TT-----TT--###---------------------------------------------------|---------------------####---------------------
-------||||||||--------S--------|-------|------#--------------------------------TT-----TT--###---------------------------------------------------|-----------%%%------#####-----o--------TT-----
-------||||||||----k--k---g-----|-------|------#----------------g----k-----g----TT----kTT--###-----k-----------k--gggg-----------------k---------|g-----------|------######-----%--------TT----o
XXXXXXXXXXXXXXXXXXXXXXXXXXXXXXXX|----XXXXXXXXXXXXXXXXXXXXXXXXXXXXXXXXXXXXXXXXXXXXXXXXXXXXXXXXXX-X------XXXXXXXXXXXXXXXXXXXXXXXXXXXXXXXXXX-XXXXXXXXXXXXXXXXXXXX|-XXXXXXXXXXX--XXX|-----%%%%XX%%%X
XXXXXXXXXXXXXXXXXXXXXXXXXXXXXXXX|-----XXXXXXXXXXXXXXXXXXXXXXXXXXXXXXXXXXXXXXXXXXXXXXXXXXXXXXXXXXX------XXXXXXXXXXXXXXXXXXXXXXXXXXXXXXXXXX-XXXXXXXXXXXXXXXXXXXX|-XXXXXXXXXX---X-X|------||-XX-|-X
