-----------------------------------------------------------------------------------------------------------------------SSS-------------K-------------------------------K------------------------
-----------------------------------------------------------------------------------------------------------------------SSS-------------o-------------------------------o------------------------
-----------------------------------------------------------------------------------------------------------------------SS--------------S------------------------------%%%-----------------------
---------------------------------SS--SSSSSSSSSSS---------SSSoSSS-------------------------------------------------------------------------------------------------------|------------------------
-------------------------------o---------------------------------------------------------------o-----------------------------------------------------------------------|------------------------
-------------------------------------------------------------------------------o--o-----------%%-----------------Q-Q---------------------------%-----------------------|------------------------
--------%%%%%%%%----QQQ-----------------------------------------%%%--------%%%%-%%%%----------||Soo-QSQSSSSSSSSS-------------------------------|-----QSS--------%%-----|--------oooo------------
---------||||||----------------------------#---------------------|----------||---||-----------||---------------------------------------o-------|----------------||----oo------------------------
---------||||||----------------------------#---------------------|----------||---||-----------||--------------------------------%%----%%-------|----------------||---%%%%-----------------------
---------||||||-----------------ooo--------#--------------SS-SSS-|----------||---||-------oo--||oo-------------------------SSSS-||----||--oo---|----------------||----||------------------------
------%%%%%%%%%%-##----------------------------------------------|-------%%%||--%||------%%%%-||SSQ----QS----U---Uoo--US--------||----||%%%%---|--------SS-SSSS-||----||-%%%%%%%SSS------------S
-------||||||||--##---------------------TT-----------------------|--------|-||--|||-------||--||--------------------------------||----||-||---o|----------------||----||--|||||-----------------
-------||||||||--#---------------------#TT-----------------K-----|-----TT-|-||--|||-------||--||-------------#------------------||----||-||-%%%%----------------||----||--|||||-----------------
-------||||||||-##-k--ky----kkk-------##TT-----#------------rr---|-----TT-|-||--|||-------||--oo---k----------------------------||-rrr|rrrr--||----ggg----------||o---||--|||||o----------------
XXXXXXXXXXXXXXXXXXXXXXXXXXXXXXXXXXXXXXXXXXXXXXXX----------%%%%%%X%%XXXXXXXXXX|--|%%%%-%%%%||%%%%XXXXXXXXXXXXXXXXXXXX--K------XXX|%%%%%%%%%%%%||-XXXXXXXXXXXXXXXX|%%%-X%XXXXX||%%-XXXXXXXXX--XXXX
XXXXXXXXXXXXXXXXXXXXXXXXXXXXXXXXXXXXXXXXXXXXXXXX-----------||||-XXXXXXXXXXXXX|--|-||---||-||-||-XXXXXXXXXXXXXXXXXXXX--X------XXX|-||||||||||-||-XXXXXXXXXXXXXXXX|-|---|XXXXX|||XXXXXXXXXXX--XXXX
