-------------------------------------------------------K-----------------------------------------------------------------------------------------------K----------------------------------------
-------------------------------------------------------o-----------------------------------------------------------------------------------------------o----------------------------------------
------------------------------------------------------%S-----------------------------------------------------------------------------------------------%----------------------------------------
--------------------------------SSSSSSSS--------------|-------------------------SSSSSSSSSSSSSSSS-#----------------------------------------------SSSS---|------------------------SSSS------------
------------------------------------------------------|------------------------------------------------------------------------------------------------|--------#-------------------------------
------------------------------------------------------|--------------------ooo-o-----------------------------------------------------------------------|----------------------------------------
--------%%%%%%%%--------------------------------------|--------------------------------------------------S--------------------------QQQQQS-------------|-------------------------o--------------
---------||||||----------------------------#----------|o---oo--------------ooooo---------------------------------------------ooo-----------------------o--orrr----------------------------------
---------||||||----------------------------#--SS------%%%-%%%%--------------------------------------------------------------------------------------%%%%%%%%%%%---------------------------------
---------||||||-----------------o--------------o-------|---||----------------------------------------------------------------------------------------|||||||||----------------------------------
------%%%%%%%%%%----------######S--------------S-------|---||----#o----#-----------------------------------------#---------------------QSS--SSS-S----|||||||||----------------------------------
-------||||||||-------------------------#--------------|---||----------------oo---TT--K-TT----------------------##------------------------------o----o||||||||---------------------------------#
-------||||||||------------------------##-------%------|---||---------------------TT----TT----------------#-----TT-----TT----------#------------%%---|||||||||---------------------------------#
-------||||||||-----------------------###--k-k--|------|---rrro----#--------------TT--k-TT----------------#-----TT-----TT---#------r------------||---|||||rrrrrr--gggg----#-----------g-------##
XXXXXXXXXXXXXXXXXXXXXXXXXXXXXXXXXXXXXXXXXXXXXXXX|-----XX%%%%%%%%XXXX--XXXXX--XXXXXXXXXXXXXXXXXXXXXXXXXXXXXXXXXXXXXXXXXXXXXXXXXXXXX%%%-XXXXXXXXXX||---|%%%%%%%%%%XXXXXXXXXXXXXXXXXXXXXXXXXXXXXXXX
XXXXXXXXXXXXXXXXXXXXXXXXXXXXXXXXXXXXXXXXXXXXXXXX|--------||||||-XXXX--XXXXX--XXXXXXXXXXXXXXXXXXXX-XXXXXXXXXXXXXXXXXXXXXXXXXXXXXXX-XX---XXXXXXXXX||---|-||||||||-XXXXXXXXXXXXXXXXXXXXXXXXXXXXXXXX
