------------------------------------------------------------------------------------------------------------------------------------------------------------------------------------------------
---------------------------------------S--------------------------------------------------------------------------------------------------------------------------------------------------------
------------------------------------------------------------------------------------------------------------------------------------------------------------------------------------------------
-------------------------------------------------#-----------------------------------------------------------------------------S----------------------------------------------------------------
-------------------------------#----------------------------------------------------------------------------------------------------------------------------------------------------------------
---------------------------------------------------------------------------------oooo----o------------------------------------------------------------------------------------------------------
--------%%%%%%%%----------------S---------------------------------------o------o-----------------Soo-----------------------------oo--SSSSS----SS--------o-------SSSSS----------S----------------
---------||||||----------------------------------o-------------------------------------------------------------------------------------------------------------------------------U----------oo--
---------||||||----------------------------------------------------------------------------------------------S----------------------------------------------------------------------------------
---------||||||------------------------k------------------------------------------------------------------SSSS--------------------------------------------------ooo-----------------------------
------%%%%%%%%%%-----------------SQo---@-------------------------###--------------TT----TT----TTSSS------------------------------------------------SS-----------SSSSS--------@S---TT------------
-------||||||||-----------------------------------------TT--------#---------------TT----TT----TT-------------------------#---#----------------------------------------------------TT----------TT
-------||||||||-----------------------------------------TT--------#---------------TT----TT----TT-----------------------###---#-----------#--------------------#-------------------TT----TT----TT
-------||||||||--------------ooo------------------g-----TT--------#---------k-kg--TT----TT----TT----------------g-----####---#-------y---#-------------------###--gggg----k-------TT--k-TT----TT
XXXXXXXXXXXXXXXXXXXXXX-------%%%-XXX--K--SSS----XXXXXXXXXXXXXXXXXXXXXXXXXXXXXXXX-XXXXXXXXXX---XX--XXX-XXX----XXXXXXXXXXXXXX--XX-XoXXXXXXXXX-XXXXXXXXXXXXXXXXXXXXXXXXXXXXXXXXXXXX-XXXXXXXXXXXXXXX
XXXXXXXXXXXXXXXXX--XXX--------|--XXX--X---------XXXXXXXXXXXXXXXXXXXXXXXXXXXXXXXXXXXXXXXXXXX-------XXX-XXX----XXXXXXXXXXXXXX--XXXXXXXXXXXXXX-XXXXXXXXXXXXXXXXXXXXXXXXXXXXXXXXXXXXXXXXXXXXXXXXX--X
