------------------------------------------------------------------------------------------------------------------------------------------------------------------------------------------------
-------------------------------------------------------------------------------------------------K----------------------------------------------------------------------SSS---------------------
------------------------------------------------------------------------------------------------------------------------------------------------------------------------------------------------
------------------------------------------------SSSSSSSSSSSSS---------------------------------------------------SSSSSSSSSSS---SS----------------------------------------------------------------
------------------------------------------------------------------------------------------------------------------------------------------------------------------------------------------------
---------------------------------------------------------------------------ooooo-----------------------------------------------------------------------------------@-o--------------------------
--------%%%%%%%%-----------------%%--------K-------------------------------%%%%%-o-----SS------o-------------S---oo--------#--o-----SSQQ--------------------------------------------------------
---------||||||------------------||-----------------------------------------|||-%%%----------------------------------------y-------------------------------------------------------------------K
---------||||||------------------||----TT-----------------------------------|||--|---------#-----S-----------------------#####S------------------------TT--------------------------------------#
---------||||||------------------||----TT--------------------------------ooo|||--|---------#-----------------------------####-------gggg---------------TT----S------------SSS-------------------
------%%%%%%%%%%----------######-||----##SSS---------------------------%%%%%%%%%S|---------###-----SSS-------US--------#######--##SS####S---------#----##----S---S---------------------------SS-
-------||||||||------------------||-------------------#-----------------|||||||--|--tt---######-----------------------y#######--TT----------------#--------------S------------------------------
-------||||||||------------------||--------------######-#---------------||||%%%%%|--tt---######---------------------##########--TT---------------###--------------------------------------------
-------||||||||------------------||--------o----#######-k---------------||||-|||-|--tt--#######-----------U---------##########--TT---k----k-----####-------k------Sk--k-------------------------
XXXXXXXXXXXXXXXXXXXXXXXXXXXXXXXX-|%%--X-%%%%----XXXXXXXXXXXXXXXX%%%%%%%%%%%|-|||-XXXXXXXXXXXXXX-XXXXXXXXXXXXXXXXXXXXXXXXXXXXXXXXXXXXXXXXXXXXXXXXXXXXXXXXXXXXXXXX--XX-----------XXXXXXXXXXXXXXXXX
XXXXXXXXXXXXXXXXXXXXXXXXXXXXXXXX-|||-----||-----XXXXXXXXXXXXXXXX-|||||||||-|-|||XXXXXXXXXXXXXXXXXXXXXXXXXXXXXXXXXXXXXXXXXXXXXXXXXXXXXXXXXXXXXXXXXXXXXXXXXXXXXXXX--XX-----------XXXXXXXXXXXXXXXXX
