------------------------------------------------------------------------------------------------------------------------------------------------------------------------------------------------
------------------------------------------------------------------------------------------------------------------------------------------------------------------------------------------------
------------------------------------------------------------------------------------------------------------------------------------------------------------------------------------------------
---------------------SSS---------------------------------------------------------------S-SSS----------------------------------------------------------SSSSSSSSSSSSSSSS-S--------SSSSSSSSSSS-----
------------------------------------------------------------------------------------------------------------------------------------------------------------------------------------------------
------------------------------------------------------------------------------------------------------------------------------------------------------------------------------------------------
--------%%%%%%%%-------SS--------------------------------------------------------oo---SSo------------------------oo---SS------------QQQQS------o--o--------------SSSSSSS----SS----------------SS
---------||||||----%%---------------------------------------------------------------------------------------------------------------------------------------------------------------------------
---------||||||----||--------------------------------------------------------------------------S-------------o----------------------------------------------------------------------------------
---------||||||----||-----SS---------------------------------------------------------------SSooo----------------------------------------------------------SS-----------------o-----------------#
------%%%%%%%%%%---||------------------------S--------------------------------------------------------------S@-------------------------------------------#------SSSSSSSS----------------------##
-------||||||||----|tt---#------------------------------------------------------------------------------------------------------------------------------##------S------K--------------tt---#-###
-------||||||||----|tt---#-------------------------------TT----#-----------------------------------------------------------------------------------##--###----------------------------tt---#####
-------||||||||----|tt---#-#-----------------------------TT----#------k---------------------------ok-----------g-----g-----------------------------###-###------------kk--------------tt---#####
XXXXXXXXXXXXXXXXXXXXXXXXXXXXXXXX--%%%%%------%--XXXXXXXXXXXXXXXXXXXXXXXXXXXXXXXXXXXXXXXXXX--XXXXXXXXXX--XXXXXXXXXXXXXXXXXXX-XXXXXXXXXXXXXXXXXXXXXXXXXXXXXX--XXXXXXXXXXXXXXXXXXXXXXXXXXXXXXXXXXXX
XXXXXXXXXXXXXXXXXXXXXXXXXXXXXXXX---|||-------|--XXXXXXXXXXXXXXXXXXXXXXXXXXXXXXXXXXXXXXXXXX--XXXXXXXXXX--XXXXXXXXXXXXXXXXXXX-XXXXXXXXXXXXXXXXXXXXXXXXXXXXXX--XXXXXXXXXXXXXXXXXXXXXXXXXXXXXXXXXXXX
