------------------------------------------------------------------------------------------------------------------------------------------------------------------------------------------------
----------------------------------------------------------S-------------------------------------------------------------------------------------------------------------------------------------
----------------------------------------------------------SS-SSo--------------------------------------------------------------------------------------------------------------------------------
------------------------------------------------SSSSSSSSSSSSSSSS--------------------------------SSS-------------SSSSSSS-------------------------S-----------------------------------------------
------------------------------------------------SSS-S-SSSSSSSSS---------------------------------------------------------------------------------------------------------------------------------
------------------------------------------------SSSSSSSSSSSSSoSS-------------------------------------------------------------------------------------------------ooo-----------o-oooo-----------
--------%%%%%%%%-------------------------------oSSSSSSSSSSSSSSSS---------------------SSSSS----@--%%-------------------------------------------------r---%%----------------------%%%%%-----------
---------||||||------------------o------------##-------------------------------------------------||-----------------------------------------------%%%%%%||---%%%-----------------|||------------
---------||||||----------------------------#####-------------------------------------------------||-o----------------------------------------------||||-||----|------------------|||------------
---------||||||-----------------ooo--------#####oooooo--------oo----%%%%-------------------------||%%%%--------------------------------------------||||-||----|------------------|||------------
------%%%%%%%%%%--------------------------######SSSSSS-------SSS-----||---------QQQQ----S#-------||-||-------------------------------S-TT----------||||-||----|------------------|||------------
-------||||||||-------------------------#######--------TT------------||--TT----------------------||-||---------------------------------TT----------||||-||----|----------------o-|||------------
-------||||||||----------#--------------#######--------TT--------o---||--TT--------------#-------||-||---------------------------------TT----------||||-||----|------------------|||------------
-------||||||||-------------------k----########--------TT-------%%%--||--TT----g------g-##------%%%-||-k------g#--k----k-----g-g-----kkTT----------||||-||----|---g--------------|gggg-k--------
XXXXXXXXXXXXXXXX----------%%%%%%XXXXXXXXXXXXXXX-XXXXXXXXXXXXXXXX-|---||--XXXXXXXXXXXXXXXXXX-XXXXX|--XXXXXXXXXXXXXXXXXXXXXXXXXXXXXXXXXXXXXXXXXXXX---|||XXXXXX--|-XXXXXXXXXXXXXX--XXXXXXXXXXXXXXXX
XXXXXXXXXXXXXXXX------XX---||||-XXXXXXXXXXXXXXX-XXXXXXXXXXXXXXXX-|---||---XXXXXXXXXXXXXXXXX-XXXXX|--XXXXXXXXXXXXXXXXXXXXXXXXXXXXXXXXXXXXXXXXXXXX---|||XXXXXX--|-XXXXXXXXXXXXXX--XXXXXXXXXXXXXXXX
