---------------------------------------K--------------------------------------------------------------------------------------------------------------------------------------------------------
---------------------------------------o-------------SS-----------------------------------------------------------------------------------------------------------------------------------------
--------------------------------------%%%-------------------------------------------------------------------------------------------------------------------------------------------------------
---------------------------------------|----------------------------------------------------------------------------------------SSSSSSS---------------------------------------------------------
---------------------------------------|-------oQ------g-g-o-------------------------------------------------------------------o----------------------------------------------------------------
---------------------------------------|------o%-------S--------------------------------ooo------------------------------------------------------------------o----------------------------------
--------%%%%%%%%--------------------rro|----%%%|-------@S------------------------%%-----------------------------------------------------------------QQQQ---------------------------------------S
---------||||||-------------------%%%%%%-----|-|-------U---ooo-------------------||--------------#-------------------------------------------------------------------------ooo-----------------o
---------||||||--------------------||||------|-|---------------------------------||-------------------------------------------------------------------------------------------------------------
---------||||||--------------------||||---ooo|-|-------k-----S-------------------||-------------------------------------------------------------------------------------------------------------
------%%%%%%%%%%----------######---||||-%%%%%|-|-oo---S@oS---SS------------------||------------------------------------TT------------------------#---SS2-----S----------##----------------------
-------||||||||--------------------||||--|||-|-|---------------------------------||----#----------TT-------------------TT---TT-----------------------------------------###----------------------
-------||||||||--------------------||||--|||%%%%---------------------------------||----#----------TT----###-------TT---TT---TT----------------------------------------####----------------------
-------||||||||--------------------||||--|||-||----------------------------------||----#-----g----TT---####-------TT---TT---TT---#---k-k-----kkg---k-----------k-----#####--------gggg----y----k
XXXXXXXXXXXXXXXXXXXXXXXXXXXXXXXX%%%%%%%%%X||-||--XXXXXXXX----XXXX%%--XXXXXXXX%XXXX|--XXXXXXXXXXXXXXXXXXXXXX-----XXXXXXXXXXXXXXXXXXXXXXXXXXXXXXXXXXXXXXXXXXXXXXXX-XXXXXXXXX------XXXXXXXXXXXXXXXX
XXXXXXXXXXXXXXXXXXXXXXXXXXXXXXXX-|||||||XX||-||-XXXXXXXXX----XXXX||--XXXXXXXXXXXX-|--XXXXXXXXXXXXXXXXXXXXXX----XXXXXXXXXXXXXXXXXXXXXXXXXXXXXXXXXXXXX-XXXXXXXXXXX-XXXXXXXX-------XXXXXXXXXXXXXXXX
