-----------------------------------------------------------------------------------------------------------------------------------------------------------------------K------------------------
-----------------------------------------------------------------------------------------------------------------------------------------------------------------------o------------------------
----------------------------------------------------------------------------------------------------------------------------------------------------------------------%%%-----------------------
---------------------------------------------------------------------------SSSSS---------------------------------------------------------------------------------------|------------------------
-----------------------------------------------------------------------------------------------------------------------------------------------------------------------|------------------------
-----------------------------------------------------------------------------------------------------------------------------------------------------------------------|------%%----------------
--------%%%%%%%%----------------%-----------------------------------------------------------------------oo-----o---------------o---------------------------------------|-%----||---------------o
---------||||||-----------------|-----------------------------------------------------------------------------##-----------#-------------------------------------------|-|----||----------------
---------||||||-----------------|-------------------TT-------------------------------------------------------###-----------#--------TT-------------------------#-------|-|----||----------------
---------||||||-----------------|--------oooo-------TT-------------------------------------------------------###-o--------###-------TT---------------------------------|-|-o--||----------------
------%%%%%%%%%%----------######%%------%%%%%---TT-%%%-------------------------------2-----------------QQ--#-###----------###-------##---------------------------------|%%%%--||----------------
-------||||||||-----------------||-------|||-oooTT--|---------------------------TT-----TT----TT------------#####--------#####---TT-------TT--------------TT------------|-||--oo|-###------------
-------||||||||-----------------||-------|||%%%%TT--|---TT----------------------TT-----TT----TTT#----------#####-------######---TT-------TT---##---------TT------------|-||-%%%%-###------------
-------||||||||-----------------||-rr--rrr||-||-TT--|---TT--k--------------r----TT-----TT----TTt#----------#####--ggg-#######---TT-------TT--###---------TT------------|-||--||-#####---#-------
XXXXXXXXXXXXXXXXXXXXXXXXXXXXXXXX|%%%%%%%%%%%-||-XXXXXXXXXXXXXXXXXXX---XX-XXX---XXXXXXXXXXXXXXXXXX-X----XXXXXXXXXXXXXXXXXXXXXXXXXXXX--XXXXXXXXXXXXXXXXXXXXXXXXXXX-%%%%%%%%||--||-XXXXXXXXXXXXXXXX
XXXXXXXXXXXXXXXXXXXXXXXXXXXXXXXX|-|||||||||--||-XXXXXXXXXXXXXXXXXXX---XX-XXX--XXXXXXXXXXXXXXXXXXX------XXXXXXXXXXXXXXXXXXXXXXXXXXXX--XXXXXXXXXXXXXXXXXXXXXXXXXXX--||||||-||--||-XXXXXXXXXXXXXXXX
