-------------------------------------S-S-----------------------------SS-------------------------------------------------------------------------------------------------------------------------
---------------------------------------S---------------------------SSSS-----------------------------------------------S-------------------------------------------------------------------------
--------------------------------------%---------------------------------------------------------------------------------------------------------------------------------------------------------
--------------------------------S-----|-----------------------------------------SSSSSSSSSSSSSSSS-----------------SS-----------------------------------------------------------------------------
--------------------------------------|----------------------------------------------------------------------------------------------------------------------------------U----------------------
--------------------------------------|--------------------------------------g------------------------------------------------------------------------------------------------------------------
--------%%%%%%%%SSSSSSSSSS---SSS------|----%--------------------SSSS-SSS----SS---------------o---------------------------------------QSQQS----o----------------------SSS-S----------------------
---------||||||-----------------------|----|----%%%%%------o----------------SS--S----------------#-------------o-----------oK-------------------------------------------------------------------
---------||||||-----------------------|----|-----|||--%%%-%%%---------------SS--S-------------------------------------------------------------------------------------------------#-------------
---------||||||--g--------------------|----|-----|||---|---|----------------SS--S------------SSS----------------Soo---------------------------------------------------------------#-------------
------%%%%%%%%%%SSSSS-------SSSS------|----|-----|||---|---|----SSSSSSSSS----------------###--------------------SSS----TT----------o------------------%%%%%%%%S---Q-------------####-----###----
-------||||||||-----------------------|----|-----|||---|---|-------SSSSSS----------------###-----------##----#---------TT------------------------------||||||-------------------####-----###----
-------||||||||-----------------------|----|-----|||---|-#-|-------SSSSSS--------------#####------TT--###----#---------TT------------------------------||||||-------------------####---#####----
-------||||||||------gy---k-----%%%---|----|-----|||---|---|--ro---SSkSSS---k--S------######-#----TT--###----#---------TT--------------------------r---||||||-----gg------------####---#####---#
XXXXXXXXXXXXXXXXXXXXXXXXXXXXXXXX-|---%%%%%%%%----|||-XXX--%%%%%%XXXXXXXXXXX-XXXXXXXXXXXXXXXX-X-XXXXXXXXXXXXXXXXXXXXXXXXXXXXXXXXXXXXXXXXXXXX-XXXX-%%%%%%|||XXXX-XXXXXXXXXXXX-XXXXXXXX-XXXXXXXXXXX
XXXXXXXXXXXXXXXXXXXXXXXXXXXXXXXX-|----|||||X---X-|||-XXX---||||-XXXXXXXXXXXXXXXXXXXXXXXXXXXX-X-XXXXXXXXXXXXXXXXXXXXXXXXXXXXXXXXXXXXXXXXXXXX-XXXX--||||-|||XXX---XXXXXXXXXXX-XXXXXXX--XXXXXXXXXXX
