------------------------------------------------------------------------------------------------------------------------------------------------------------------------------------------SS----
-------------------------------------------------------------------------------------------------------------------------------------SS--SS---------------------------------------S-------SS--S-
------------------------------------------------------------------------------------------------------------------------------------------------------------------------------------------SS--SS
--------------------------------SSS-------------------------------------------------------------SSSSSSSSSSSSSSSS--------------------------------SSSSSSSSSSSSSSSS----------------SSSSSSSS------SS
-------------------------------------------------------------------------o----------------------S----------------------------------------o--------------------------------------SS--------------
---------------------------------------------------------------------------------------------------------------S----------------------------------------------------------------SS--------oooooS
--------%%%%%%%%-----S-----#--#----------------------------------------------------------------------SSS------SS%%%-------------SSo@-SSSoS---S-------------------------%%%%%%%--SSSSSSSSSSSSSSSS
---------||||||------------#------------------------------------------oo-----------------------------------------|----------------------------------------------%-------|||||-------------------
---------||||||-----------###--S---------------------------------------------------------------------------##----|----------------------------------------------|-------|||||-------------------
---------||||||-----------###--o----------------------------------------------------g---------------o------###---|---------------------g------------------------|-------|||||-----------------oo
------%%%%%%%%%%--------#####--------------------------------------------S------TT--###------------S-------####--|--------------SSSoSSSSS----SS----------##--#--|-------%%%%%%-----SS----------S
-------||||||||--------######---------------------------------------------------TT---------------------TT--###---|------------------------------------y-###--#--|--------||||-o-----------------
-------||||||||-------#######----------------------------TT---------------------TT---------------------TT--###---|-----------%%%----------------------#####--#--|--------||||%%%-------TT-------
-------||||||||-----g########-----k----k-#----------g----TT---------------------TT----k--k-------------TT--####--|------------|-------k---------k----######--#--|oorrr---||||-|--------TT---#---
XXXXXXXXXXXXXXXXXXXXXXXXXXXXXXXXXXXXXXXXXXXXXXXXXXXXXXXXXXXXXXXX---%%%%%%%%%-S%-XXXXXXXXXXXXXXXXXXXXXXXXXXXXXXXX%%%%---XXXXX-XX-XXXXXXXXXXX-XXXXXXXXXXXXXXXXXXXX%%%%%%%%%||||%%-XXXXXXXXXXXXXXXX
XXXXXXXXXXXXXXXXXXXXXXXXXXXXXXXXXXXXXXXXXXXXXXXXXXXXXXXXXXXXXXXX----|||||||---|-XXXXXXXXXXXXXXXXXXXXXXXXXXXXXXXX-||----XXXXX--X-XXXXXXXXXXX-XXXXXXXXXXXXXXXXXXXX-|||||||-||||||-XXXXXXXXXXXXXXXX
