-----------------------------------------------------SSS--------------------------------------------------------------S-------------------------------------------------------------------------
-----------------------------------------------------SS---------------------------------------------------------------S-------------------------------------------------------------------------
-----------------------------------------------------SSS-------------------------------------------------------------SSSSSSSSS------------------------------------------------------------------
----------------SSSSSSSSSSSSSSSS--------------------------------------------------------------------------------SSSSSSSSSSSSSSSS----------------SSSSSSSSSSSSSSSSSSS---SS-SSSSSSS--SSSSSSSSSS-SSS
----------------------------------------------------------------------------------------------------------------SSSSSSSSSSSSSSSS----------------------------------------------------------------
---------------------------------------------------------------------------------ooo----oo----------------------SSSSSSSSSSSSSSSS----------------------------------------------------------------
--------%%%%%%%%--------------------------------------SSSS-----------QQQQ---------------------------------------SSSSSSSSSSSSSSSS%%%%------------------------------------------------------------
---------||||||---------------------------##--------S%oo-----------------------------------------o--------##---------------------||-------------------------------------------------------------
---------||||||-----------#--------------###---------|----------------------------------------------------##-------------------S-||-------------S-SSSS------------------------------------------
---------||||||----------##--------------###---------|------SS--------g----------------------------------##-----oooooooo------oS-||-------------------------------------------------------------
------%%%%%%%%%%---------#--------TT-----##----------|-------S------SS#S--------------------------TT-----##-----SSSSSSS-------SS-||------%%%-%-%------------------##---##-----------------------
-------||||||||-------y###--------TT----###----------|--------------------------TT------TT--------TT----###----------------------||-------|--|-|--------------TT-####--#--------SSSS-S----------
-------||||||||-----######--------TT--#####----------|-----------#--------------TT------TT--------TT---####--TT------------------||-------|--|-|--------TT----TT#####--#-----#------------------
-------||||||||----#######--------TT--#####----------|-----k----##--------k-k---TT------TT--------TT--#####--TT----------g---ooo-||----g--|--|-#--------TT----TT#####--k-----#------------------
XXXXXXXXXXXXXXXXXXXXXXXXXXXXXXXXXXXXXXXXXXX-XXXXXXXXX|XX---X-S%-XXXXXXXXXXXXXXXXXXXXXXXXXXXXXX--XXXXXXXXXXXXXXXXXXXXXXXXXXXXXXXX%%%%XXXXXXXXXXXXXXXXXXXXXXXXXXXXXXXXXXXXXXXXXXXXXXXXXXXXXXXXXXXX
XXXXXXXXXXXXXXXXXXXXXXXXXX--XXXXXXXXXXXXXXX-XXXXXXXXX|XX---X--|-XXXXXXXXXXXXXXXXXXXXXXXXXXXXXX-XXXXXXXXXXXX-XXXXXXXXXXXXXXXXXXXX-||--XXXXXXXXXXXXXXXXXXXXXXXXXXXXXXXXXXXXXXXXXXXXXXXXXXXXXXXXXXX
