----------------------------------------------------------------------------------------------S-------------------------------------------------------------------------------------------------
------------------------------------------------------------------------------------------------------------------------------------------------------------------------------------------------
------------------------------------------------------------------------------------------------------------------------------------------------------------------------------------------------
--------------------------------------------------------------------------------SSSSSSSS----------------------------------------S---------------SSSSSSSSSSSSSSSS--------------------------------
------------------------------------------------------------------------------------------------------------------------------------------------------------------------------------------------
--------------------------------------------------------------------------------------------------------------------------ooo-------------------------------------------------------------------
--------%%%%%%%%----------------------------------o----------------------------------------------------SSS------------------------oo---------o-o----------------------------------SSSSSS--------
---------||||||--------------------------------------------------------------------------------------ooo---o------------------------------------------------------------------------------------
---------||||||------------------------------------------------------------------------------------------------------------------------------SS-------------------------------------------------
---------||||||------------------------------------------------------------------------------------------------------------------------------SS-----------------------------------------------oo
------%%%%%%%%%%----------------%----------------------------U---S----%%%%%%%%Ko------------------------------------------------%----------------TT----------------------TT------#--------------
-------||||||||-----------------|--------------------------------------||||||---------------------------------------------------|----------------TT-----TT--------TT-----TT---------------------
-------||||||||----------#------|--------------%-----------------------||||||---TT----------------------------------------------|--------#-K-----TT-----TT--------TT-----TT---TT----------------
-------||||||||-----------------|-k--k---------g------------------gg---||||||---TT---------------------------------------------#|--------#-o-----TT---#####-------TT-----TT---TT------------#---
XXXXXXXXXXXXXXXX--XXXXXXXXXXX--XXXXXXXXXXXXXXXXX-XXXXXXXXXX-XXXXX%%XXXXXXXXX|---XXXXXXXXXXXXXXXX-----------S---XXXXXXXXXXXXXXXXX|------XXX%S%---XXXX--XXXXX-XXXX-XXXXXXXXXXXXXXXXXXXXXXXXXXXXXXX
XXXXXXXXXXXXXXXX--XXXXXXXXXXX--XXXXXXXXXXXXXXXXXXXXXXXXXXXX-XXXXXXXXXXXXXXXX|---XXXXXXXXXXXXXXXX---------------XXXXXXXXXXXXXXXXX|-----XXXX|-|---XXXXXXXXXXX-XXXXXXXXXXXXXXXXXXXXXXXXXXXXXXXXXXXX
