--------------------------------------------------------------------------------------------------------------------------------------------------------------------------------
--------------------------------------------------------------------------------------------------------------------------------------------------------------------------------
--------------------------------------------------------------------------------------------------------------------------------------------------------------------------------
----------------SSSSSSSSSSSSSSSS--------------------------------------------------------------------------K-------------------------------------------SSSSSSSSSS----------------
--------------------SSSS--SS-SSS--------------------------------------------------------------------------S-----------------------------------------SSSSSSSSSSoo----------------
--------------------SSS-------------------------------------------------------------------o-----------------------kk---g--oo--o------------oo-------SSSSSSSSSSSS----------------
--------%%%%%%%%-------------------------------------------------------#------------------S---------------SQ-----####------------------------------SSSSSSSSSSSSS----------------
---------||||||-----------------------------------o--------------------#--------------------------------------------S-#---------S-----------------------------------------------
---------||||||------------------------------------------------------#-#---------------------------------------------##---------S-----------------------------------------------
---------||||||--------r-----SS-------------------------------------####----------------------oo--------------------###--------------------------ooS-SSoooooS-------------------
------%%%%%%%%%%%%%%%%%%%%%%%%%%---------------TT---#----TT--------#####---------------------%%%-----%%%%---%%%%----###-----------TT-------------------%-----SSS-%%----%%%------
-------||||||||--||||||||||||||----------TT----TT---#-#--TT-------######----------------------|-------||-----||---#-###-----------TT--------TT---------|---SSSS--||-----|-------
-------||||||||--|||||||||%%|||----------TT----TT---#----TT------#######----------------------|-------||-%%%%||--##-###-----------TT--------TT---------|---------||-----|--%----
-------||||||||--||||||||||||||----------TT----TT---#-#--TT----#########-------------------gg-|-------||--||-||-###-###-----------TT-----y--TT---------|----k-#-K||-----|--|----
XXXXXXXXXXXXXXXX-%%%%%%|%%%%%%|-XXXXXXXXXXXXXXXXXXXXXXXXXXXXXXXXXXXXXXXXXXXXXXXXXXXXXXXXXXXXXXX-%%----||-%%%%%%-XXXXXXXX----XXXXXXXXXXXXXX--XX-X---S---|--XXXXXX-||--X--|-XXXXX-
XXXXXXXXXXXXXXXX--||||-|-||||-|-XXXXXXXXXXXXXXXXXXXXXXXXXXXXXXXXXXXXXXXXXXXXXXXXXXXXXXXXXX-XXXX-||----||--||||--XXXXXXXXX---XXXXXXXXXXXXXX--XX-X-------|--XXXXXX-||--X--|-XXXXX-
