-------------------------------------------------------------------------------------------------------------------------------------------------------K----------------------------------------
------------------------------------------------------------------------------------------------------------------------------------------------------------------------------------------------
------------------------------------------------------------------------------------------------------------------------------------------------------------------------------------------------
----------------SSSSSS------------------------------------------------------------------------------------------------------------------------------------------SSSSSSSSSSSSSSSS----------------
------------------------------------------------------------------------------------------------------------------------------------------------------------------------------------------------
---------------------------o-------------------------------------------------g----------------or----------------------------------o--------------------------o----------------------------------
--------%%%%%%%%--------------------------------------------------o----------S--------------%%%%----------------------SS------------------------%%%%------%%%%----------------------------------
---------||||||-------------K----o--------2--------------------------------------------------||----------------------------oo--------------------||--------||-----------------------------------
---------||||||--------TT-----------------#--------------------------------------------------||-------K------------------------------------------||--------||-----------------------------------
---------||||||--------TT---------TT-----------------------S-------------------o---------oooo||-------------------------------------------oo-----||--------||-----------------------------o-----
------%%%%%%%%%--------TT---------TT-----#-------SSo----------------SSSS-----SS-------%%%%%%%||------------------SS----@SSS----------------------||----%%%%%%---##############----So------------
-------|||||||--------TT----TT----TT----##---------------------------------------------|||||-ooo-------------------------------------------------||-----||||----#######-######------------------
-------|||||||--TT----TT----TT----TT----##---------------------------------------------|||||%%%%-------------------------------------------------||-----||||-%%%######--######------------------
-------|||||||--TT----TT----TT----TT--####----------------------------------------rr---|||||-||---g----------------------------------------------||-----||||--|-##############------------------
XXXXXXXXXXXXXXXXXXXXXXXXXXXXXXXX--XX--XXXXX------XXXXXXXX----S--XXXXXXXXXXXXXXXX%%%%%%%%%%%|-||-XXXXXXXXXXXXXXXX-XXX--XXXX------XXXXXXXXX-------%%%%-X-XXXXX--|-XXXXXXXXXXXXXXXXXXXXXXXXXX---XXX
XXXXXXXXXXXXXXXXXXXXXXXXXXXXXXXX-XXXXXXXXXX-----XXXXXXXXX-------XXXXXXXXXXXXXXXX-|||||||||-|-||-XXXXXXXXXXXXXXXX-XXX--XXXX-----XXXXXX-XXX--------||--X-XXXXX--|-XXXXXXXXXXXXXXXXXXXXXXXXXX---XXX
