------------------------------------------------------------------------------------------------------------------------------------------------------------------------------------------------
------------------------------------------------------------------------------------------------------------------------------------------------------------------------------------------------
------------------------------------------------------------------------------------------------------------------------------------------------------------------------------------------------
--------------------------------------------------------------------------------------------------------------------------------------------------------------------------------SSSSSSSSSSSSSSSS
-----------------------------------------------------%%%%%--------------------------------------------------------------------------------------------------------------------------------------
------------------------------------------------------|||-----%%--------------oo----------------------------------------------------------------------------o-----------------------------------
--------%%%%%%%%--------------------------%%%%%-%-----|||-----||--------------%%------Q--------o-----------------------------------------------------QQS----------------------------------------
---------||||||----------------------------|||--|-----ooo--o--||--------------||-----------y---#----------------------------------------------%%-------------ooo-SSS-%K-------------------------
---------||||||----------------------------|||--|----%%%%%%%%-||--------------||----------#####-----------------------------------------------##---------------------|--------------------------
---------||||||---------------------------o|||--|-----||||||--||--------------||-o--------####-----------------------------------------------###---------------------|----S---------------------
------%%%%%%%%%%----------######------%%%%%%%|--|-----||||||--||-S-----%%%%%%-||-##----#######-------2-----------------%%%%%%%-------------#####-------QQS-----------|--------------------------
-------||||||||------------------------|||||-|--|-----||||||--||--------||||--||-##----##--###---TT-----TT--------------|||||--------------#####---------------------|---#--------TT------------
-------||||||||------------------------|||||-|--|-----||||||-%%%--------||||--||-#---#####-###---TT-----TT--------------|||||-------------######-------------------##|-###--------TT----TT------
-------||||||||------------------------|||||-|--|-----||rrrr--|---g-----||||--||##----####-###---TT-----TT--------------|||||-----g------#######---------------k#--#######---#--k-TT----TT------
XXXXXXXXXXXXXXXXXXXXXXXXXXXXXXXX%%%%%%%%%%X|-%%%|-----%%%%%%%-|XXXXXXXXXXX||--||XXXXXXXXXXXXXXXXXXXXXXXXXXXXXXXX-%%%%%%%|||||%--XXXXXXXXXXXXXXXXXXXXXXXXXXXXXXXXXXXXXXXXXXXXXXXXXXXXXXXXXXXX-X-X
XXXXXXXXXXXXXXXXXXXXXXXXXXXXXXXX-||||||||--|--|-|------|||||--|-XXXXXXXXXX||--||XXXXXXXXXXXXXXXXXXXXXXXXXXXXXXXX--|||||-||||||--XXXXXXXXXXXXXXXXXXXXXXXXXXXXXXXXXXXXXXXXXXXXXXXXXXXXXXXXXXXXXX-X
