------------------------------------------------------------------------------------------------------------------------------------------------------------------------------------------------
-----------------S-k-SS-------------------------------------------------------------------------------------------------------------------------------------------------------------------------
------------------------------------------------------------------------------------------------------------------------------------------------------------------------------------------------
--------------------------------SSSSSSSSSSSSSSSS---------------------------------------------------------------------------------------------------------------------------------------------SSS
-------------------------------------------------------------------------------------------------------------------------------U----------------------------------------------------------------
----------------So-----------------------------------------------------------------------------------------------ooo-----------------------------------------------------o----------------------
--------%%%%%%%%S--------------------------#---o%%%o--------------------o------o----------------------------------------------------------------------------------------------------------------
---------||||||----------------------------##----|-----o---o-------------------------------------#----------------------------------------------------------------------------------------------
---------||||||---------------------------####-#-%%%%%%%%-%%%-----------------------------------------------------------------------------------------------------------------------------------
---------||||||---------------------------####----||||||---|--oo----------------------------------------------------------SSSS----------------------------o-------------------------------------
------%%%%%%%%%%SSSSSSSS-----------------######---||||||-%%%%%%%-------------------------SSS---o--------TT---------------------------------------QQ----------SS--------------------------TT-----
-------||||||||-S-SSSSSSS--------------########---||||||--|||||-----------------------------------TT----TT------------------------------TT-----------------------TT-----TT---------------TT-----
-------||||||||-S-SSSSSSo-------------##########--||||||--|||%%%--------------##------------------TT----TT----TT------------------------TT---U-------------------TT-----TT---------------TT-----
-------||||||||-SSSSSSSS---------g---###########--||||rrrrr||-|---------------##---gggg-----------TT----TT----TT---------------------k--TT---#-----k--y----------TT-----TT---------------TT----o
XXXXXXXXXXXXXXXXXXXXXXXXXK---XXXXXXXXXXXXXXXXXXX-%%%%%%%%%%%|-|X--XXXXXXXXXXXXXXXXXXXXXXXXXX-XXXXXXXXXXXXXXXXXXXXXXXXXXXXXXXXXXXXXXXXXXXXXXXXXXXXXXXXXXXXXX-XXXXXXXXXXXXXXXXXXXXXXXXXXXXXXX-----
XXXXXXXXXXXXXXXXXXXXXXXXXX---XXXXXXXXXXXXXXXXXXX--|||||||||-|-|X--XXXXXXXXXXXXXXXXXXXXXXXXXX-XXXXXXXXXXXXXXXXXXXXXXXXXXXXXXXXXXXXXXXXXXXXXXXXXXXXXXXXXXXXXX-XXXXXXXXXXXXXXXXXXXXXXXXXXXXXX------
