-------------------------------------------------------K----------------------------------------------------------------------------------------------------------------------------------------
-------------------------------------------------------o----------------------------------------------------------------------------------------------------------------------------------------
------------------------------------------------------%%%---------------------------------------------------------------------------------------------------------------------------------------
-------------------------------------------------------|-----------------------------------------SS------SSSSSSS----------------SSSSSSS---------------------------------------------------------
-------------------------------------------------------|----------------------------------------------------------------------------------------------------------------------------------------
----------------------------------o---------------o----|---oo-%%---------------------------------------------------o---ooooo--------------------------------------------------------------------
--------%%%%%%%%--------------------------------%%%%---|--%%%%||-------------S--------------------------------------------------------------------------------------QQQQQ-----------------------
---------||||||----------------------------------||----|---||-||--------------------------------------------------------------------------------------------------------------------------------
---------||||||----------------------------------||----|---||-||-----------------------------------------------------------------------------------------------------------------------U--------
---------||||||----------------------------------||----|-ooo|-||-----------------------------------------------------------------------------------------------------gg----------------##------S
------%%%%%%%%%%----------######-U---------------||----|%%%%|-||QQQo---------------SS2-----------------------------------------------------------------TT-------#######S-----U---------###-----S
-------||||||||----------------------------------||----|-||-|-||---------------------------------------------------------------o--TT----TT---TT--------TT------------------------------##-------
-------||||||||----------------------------------||----|-||-%%%%-------------------------TT---------------------------------------TT----TT---TT--------TT----U---------------#------#####-------
-------||||||||-------------------gk-------------|o----|-||--||-------k---------g--------TT------------------------------------k--TT----TT---TT--------TT----#--------------##------#####-------
XXXXXXXXXXXXXXXXXXXXXXXXXXXXXXXXXXXXXXXXXXXXXXXX-%%%--%%%%|--||-XXXXXXXXX----XXXXXXXXXXXXXXXXXXXXXXXXXXXXX-----XXXXXXXXXXXX-XXXX-XXXXXXXXXXXXXXXXXXXXXXXXXXXXXXXXXXXXXXXXXXXXXXXXXXXXXXXX---XXXX
XXXXXXXXXXXXXXXXXXXXXXXXXXXXXXXXXXXXXXXXXXXXXXXX--|----||-|--||-XXXXXXXXX----XXXXXXXXXXXXXXXXXXXXXXXXXXXXX-----XXXXXXXXXX-X--XXXXXXXXXXXXXXXXXXXXXXXXXXXXXXXXXXXXXXXXXXXXXXXXXXXXXXXXXXXXX--XXXX
