----------------------S----------------K---------------------------------------------------------------K----------------------------------------------------------------------------------------
----------------------S----------------o---------------------------------------------------------------o----------------------------------------------------------------------------------------
--------------------------------------%%%-----------------------------------------------------S-------%%%------%--------------------------------------------------------------------------------
---------------------------------------|-----------------------S----------------SSSSSS-----------------|-------|------------------------SSSSSSSS----------------SS------------------------------
---------------------------------------|----------------------------------------S----------------------|-------o--------------------------------------------------------------------------------
---------------------------------------|---oo-------------------------------o--------------------------|------%%--------------------------------------------------------------------------------
--------%%%%%%%%------SSS--------------|--%%%------------------------SS----S----S------SSSSSSSSS-------|------||--------------------------------------------------------------------------------
---------||||||------------------------|---|---o--------------------------------S----------------------|------||----------------------------S----------------------------------#----------------
---------||||||------------------------|---|---#-----------------------------------------------#-------|--%%%-||----------------------------S--S--------------------o---------------------------
---------||||||------------SS----------|---o---#--------------------------------S-------------##----%%%|---|--||------U----------------------ooo--------------------##----------------------#---
------%%%%%%%%%%-----------------------|%%%%---------------------------S%SSS-@--S-----S------###%%---|-|---|--||-S--------------------SSS------S---------------------2--------------------###-#-
-------||||||||------------------------|-||--oo-------------------------|--------------------###||---|-|---|--||--------------------------------o------------#----------------------------###-#-
-------||||||||------------------------|-||-%%%%------------------------|----#--------------####||---|-|---|%%%%--------------------------------%------------#---------tt-----------------###-##
-------||||||||------------------------|-||--||--------------------ggg--|----#-------------#####%|---|-|---|-||o---k----------------------oo----|------------#---------tt------#-----k-k--###-##
XXXXXXXXXXXXXXXX--XXXXXXXXXXXX%X-%%%%%%%%%%%-||---XXX-XX-X------XXXXXXXXXXXXXX--XXXXXXXXXXXXXXXX|%%%-|%%%--|%%%%XXXXXXXXXXX-XXXXXXXXXXX-------XXXXXXXXXXXXXXXXXXXXXXXXXXXXXXXXXXXXXXXXXXXXXXXXXX
XXXXXXXXXXXXXXXX--XXX-XXXXXXXXXX--|||||||||--||---XXX-XX-X------XXXXXXXXXXXXXXX-XXXXXXXXXXXXXXXX|-|--|-|---|-||-XXXXXXXXXXX-XXXXXXXXXXX------XXXX-XXXXXXXXXXXXXXXXX-XXXXXXXXXXXXXXXXXXXXXXXXXXXX
