-----------------------------------------------------------------------------------------------------------------------K------------------S-----------------------------------------------------
-----------------------------------------SS----------------------------------------------------------------------------o---------K--------S-----------------------------------------------------
----------------------------------------------------------------------------------------------------------------------%%%-----------------------------------------------------------------------
------------------------------------------------------------------------------------------------SSSSSSSSSSSSSSSS-------|------------------------------------------------------------------------
-----------------------------------------------------------------------------------------------------------------------|-------S--------------SS------------------------------------------------
--------------------------------------------------o------------------------------------------------------------S-------|------oS-------SSS---g---------------------------ooo--------------------
--------%%%%%%%%----------------------------------------------------QQQQQS-----S------SSSS----o------------#--SS-------|-----%%%------------SS------------------------------------SSSSS---------
---------||||||------------------------------S-------------------------------------------------------------#-------r---|------|-------------SS-------------oooo-------------K-------------------
---------||||||------------------------------S--------K--------------------------------------------------####--S-%%%%%-|------|-----------------------------------------------------------------
---------||||||----------------------------------------------------------------o-----------o-------------###---o--|||--|--ooo-|-----g--------ooo------------------------------------gg--------oo
------%%%%%%%%%%-------------------oS----------------------------SQ----SS-------Sooo----SS%S------------#####-----|||--|%%%%%-|--S-SSSS--------S-#-----TT--------------------------S#S----------
-------||||||||--------------------------SS-----TTTT--------------------------------------|------------######-----|||--|-|||--o--SoSS------------#-----TT--------------#-------------K-TT-------
-------||||||||---------------------------------TTTT-----TT-------------------------------|-----------#######-----|||--|-|||%%%%%SSSSS-S---------#-----TT--------------#--------TT-----TT----#--
-------||||||||-----------g----#----------------TTTT-----TT--------k------k---------------|----------#########----|r|--rr|||-|||---SSSk---U-k----#-----TT----k---------#--------TT---k-TT---##--
XXXXXXXXXXXXXXXXXXX--XXX-XXXX--XXXXXXXX--SS-XXXXXXXXXXXXXXXXXXXXXXXXXXXXXXXXXXXX-------XXX|-----XXXXXXXXXXXXXX---%%%%%%%%%%%-%%|XXXXXXXXXXXXXXXXXXXXXXXXX-XXXXXX-XXXXXXXXXXX-X--XXXXXXXXXXXXXXXX
XXXXXXXXXXXXXXXXX----XXX-XXXX-XXXXXXXXX-----XXXXXXXXXXXXXXXXXXXXXXXXXXXXXXXXXXXX-------XXX|-----XXXXXXXXXXXXXX-X--|||||||||--|||XXXXXXXXXXXXXXXXXXXXXXXXX-XXXXXX-XXXXXXXXXXX----XXXXXXXXXXXXXXXX
