------------------------------------------------------------------------------------------------------------------------------------------------------------------------------------------------
------------------------------------------------------------------------------------------------------------------------------------------------------------------------------------------------
------------------------------------------------------------------------------------------------------------------------------------------------------------------------------------------------
------------------------------------------------SSSSSSSS--------SSS--------S-SSS--------------------------SS----SSSSS-------------------------------------------SSSSSSSSSSSSSSSS----------------
------------------------------------------------------------------------------------------------------------------------------------------------------------------------------------------------
---------------------------------------------ooo-----------o----------------------------------oo----------------------------------------------------------------------------------------------oo
--------%%%%%%%%-----------------------------------------SSSS--------------------------S---------oo----------------------------#-ooo-S------------------------------------------SS-S---------SSS
---------||||||--------------------------------------------------------------------------------o------------------------------##------------------------------------------------S---------------
---------||||||------------------------------------------------------------------------------------------------------------#####-----------------------------------SSS---------SS---------------
---------||||||--------------------------oooo--------------------------------------------------------------------oo--------#####ooo--------------oo----------------------------SSoo------------o
------%%%%%%%%%%----------######--------%%%%%---------tt--------------------------------%%%%%------------#o---------------######---------TT------------------------------------SSSS----------SSS
-------||||||||--------------------------|||----------tt-----------------------#---------|||--oo---------#----------------######---------TT----#-K-----U-----------------------U-------TT-------
-------||||||||--------------------------|||----------tt-----------------------#---------|||---%-------###---------------#######---------TT---##-#-----TT----------------------#-------TT-------
-------||||||||--------------------------|||----------tt-----g--%%%------------#---------|||---|-----#####-------------#########----gggg-TT--###-#-----TT---k------------------#--g----TT-------
XXXXXXXXXXXXXXXXXXXXXXXXXXXXXXXXX%%%XXXXXXXXXXX-XXXXXXXXXXXXXXXX-|-XXXXXXXXXXXXX%%%%%XXXXX||---|XXXXXXXXXXX-XXXXXXXXXXXXXXXXX-X-XXXXXXXXXXXXXXXXXXXXXXXXXXXXXXXXXXXXXXXXXXXXXXXXXXXXXXXXXXXXXXXX
XXXXXXXXXXXXXXXXXXXXXXXXXXXXXXXXXXXXXXXXXXXXX-X-XXXXXXXXXXXXXXXX-|-XXXXXXXXXXXXX-|X|-XXXXX||---|XXXXXXXXXXX-XXXXXXXXXXXXXXXXX-ooXXXXXXXXXXXXXXXXXXXXXXXXXXXXXXXXXXXXXXXXXXXXXXXXXXXXXXXXXXXXXXXX
