----------------------------------------------------------------------------------------------------------------------------------------------------------------------S-------------------------
----------------------------------------------------------------------------------------------------------------------------------------------------------------------S-------------------------
------------------------------------------------------------------------------------------------------------------------------------------------------------------------------------------------
-----------------------------------------------------------------S-------------------------------------------------------SSSSSS---------------------------------S-------------------------------
------------------------------------------------------------------------------------------------------------------------------------------------------------------------------------------------
-----------------------------------------------------------------------------------------------------------------------------------------------------------------------------------------o-----#
--------%%%%%%%%---------------------QQQQS-----S------SSSSS--SSS---------------#------------------o----------oo--SSS--S------SSS---------------------------------------S%%S--------------------#
---------||||||--------------------------------#---S--o-----------------------##-----------------------------------------------------------o------------------------%%%-||--------------------##
---------||||||-------------------------------#------------------------------###------------------------------S------------------------------------------------------|--||------------------####
---------||||||-------------------------------#-----------------------------####------------------------------------o------------------------------------------------|--||-----------------#####
------%%%%%%%%%%----------######------SQQQ---##------------------###-------#####---------TT--------------#------S--SS------------------------------------------------|--||-----------------#####
-------||||||||------------------------------##------------------##--------#####--TT-----TT-------------##-----------------------------------------------------------|--||---------------######-
-------||||||||-----------------------------###------------------##-------######--TT-----TT-----------#-##---------------------------------------------tt------------|--||---------------######-
-------||||||||--------------------#--------####-----k---------g-##-----########--TT-----TT-----------#-##---------------------------------------------tt------------k--||--------------########
XXXXXXXXXXXXXXXXXXXXXXXXXXXXXXXXXXXXXXXXXXXXXXXXXXXXXXXXXXXXXXXXXXXXXXXXXXXXXXXXXXXXXXXXXXXXXXXXXXXXXXXXXX--XXXXXXXXXXXXXXXXXXXXXXXXXXXXXX----XX%%%XXXXXXXXX%%%%XXXXXXXXXXXXXX%XXXXXXXXXXXXXXXX-
XXXXXXXXXXXXXXXXXXXXXXXXXXXXXXXXXXXXXXXXXXXXXXXXXXXXXXXXXXXXXXXXXXXXXXXXXXXXXXXXXXXXXXXXXXXXXXXXXXXXXXXXXXX-XXXXXXXXXXXXXXX-XXXXXXXXXXXXXX---XXXXXXXXXXXXXXX-||-X-XXXXXXXXXXXX|XXXXXXXXXXXXXXXX-
