---------------------------------------------------------------------------------------------------------------------------------------K--------------------------------------------------------
---------------------------------------------------------------------------------------------------------------------------------------o--------------------------------------------------------
--------------------------------------------------------------------------------------------------------------------------------------%%%-------------------------------------------------------
----------------SSSSSSSSSSSSSSSS-SSSSSSSSSSSSSSSS-------------------------------------------------------------------------------#------|--------------------------------------------------------
---------------------------------------------------------------------------------------------------------------------------------------|--------------------------------------------------------
-----------------------------o------------------------------------------------------------------------------------oo-------------------|------%%----------------------------------o-------------
--------%%%%%%%%------------SS---ooo--SS-------oorrr-o%%%----oo-----QQQQ-------------------------------SSSSSSS-------------------------|------||------------------------------------------------
---------||||||----------------------------#----%%%%%%%|----------------------------------------------oo---------@---------------------o---o--||------------------------------------------------
---------||||||---------------------------##-----|||||-|-----SS-----------------------------------------------------------------------%%%-%%%-||------------------------------------------------
---------||||||--------------------------###-----|||||-|--SSSSS------------------------------------------------------------------------|--o|--||------------------------------------------------
------%%%%%%%%%%------------------------####----S|||||-|--------##---------------------S-----U--------------------TT-------------------|-%%%--||------------------------------------------------
-------||||||||---------#-------------y#####-----|||||-|---K------------------------------------------------------TT---TT--------------|--|---||------------------------------------------------
-------||||||||---------#----------#########-----|||||-|----------------------------------------------------------TT---TT----TT--------|--|---||------------------TT---#------------------------
-------||||||||---------#--------#-#########-----|||||-|-----------k--gg-----------kgg-------------r--------------TT---TT----TT-----r--rrrrr--||--------k---------TT---#----kkk-----------Uo----
XXXXXXXXXXXXXXXXXXXXXXXXXX------XXXXXXXXXXXXXXXX-|||||-X-----%%-XXXXXXXXXXXXXXXXXXXXXXXXXXXXXXXX-%%%%%%%-------XXXXXXXXXXXXXXXXX----%%%%%%%%%%%%XXXXXXXXXXXXXXXXXXXXXXXXXXXXXXXXXXXXXXX---XXX---
XXXXXXXXXXXXXXXXXXXXXXXXXX-----XXXXXXXXXXXXXXXXX-|||||-X-----||-XXXXXXXXXXXXXXXXXXXXXXXXXXXXXXXX--|||||--------XXXXXXXXXXXXXXXXX-----||||||||||-XXXXXXXXXXXXXXXXXXXXXXXXXXXXXXXXXXXXXXX---XXX--X
