---------------------------------------------------------------------%----------------------------------------------------------------------------------------------------------
---------------------------------------------------------------------|-----------------------------------------------------------------------K----------------------------------
---------------------------------------------------------------------|----------------------------------------------------------------------------------------------------------
----------------------------------o----------------------------------|--------------------------------------------------------------------------SSSSSSSSSSSSSSSS----------------
---------------------------------------------------------------------|-----------------------------------------------------------------------------SSSSSSSSSSSS-----------------
---------------------------------------------------------------------|----------SS------------------------------------------------------------------SSSSSSSSSSSU----------------
--------%%%%%%%%-----------------------------------------------------|--------------------------------U-S-----------------------------------------SSSSSSSSSS-SSS--------SS-----S
---------||||||-------#--------------------K-------------oo------o---|-------------------------------%%------------------ooo----------------------SS-S---------S----------------
---------||||||------##----------%%%%%%%%%-2----------%%%%%%%%-------|-------------------------------||-------------------------------------------------------------------------
---------||||||-----###-----------|||||||--------------||||||--------|-------------------------------||--------------------------------r-----------ooo---ooo--------------------
------%%%%%%%%%%---####-----------|||||||--------------||||||--------|-------------------------------|SSS--------S----------------%%%%%%%%%%%%--%%%%%%%%-%%---S-----------QQQQ--
-------||||||||---#####-----------|||||||--------------||||||--------|-------------------------------|-----------------TT---TT-----||||||||||----||||||--||S--------------------
-------||||||||--######-----------|||||||--------------||||||--------|-#-----------------------------|-----------------TT---TT-----||||||||||---SSSS|||--SSSS-------------------
-------||||||||-#######-----------|||||||--------------||||||--------|-#--------k----###-------k-----|--ggggg-g--------TT-k-TT-----||||||||||-------|||--------------g---------y
XXXXXXXXXXXXXXXXXXXXXXXX-----X-X-X|||||||--2--X--XXXX--XXXXXXXXXXXXXXXXXXXXXXXXXXXXXXXXXXXXXXXXXXXXXXXXXXXXXXXXXXXXXXXXXXXXXXXXX%%%%%%%%%%|||-----%%%||--XXXXXXXXXXXXXXXXXXXXXXX
XXXXXXXXXXXXXXXXXXXXXXXX----XX-X-X|||||||--X--X--XXXX--XXXXXXXXXXXXXXXXXXXXXXXXXXXXXXXXXXXXXXXXXXXXXXXXXXXXXXXXXXXXXXXXXXXXXXXXXg||||||||-g||---g--|-||--XXXXXXXXXXXXXXXXXXXXXXX
