--------------------------------------------------------------------------------------------------------------------------------------------------------------------------------
--------------------------------------------------------------------------------------------------------------------------------------------------------------------------------
--------------------------------------------------------------------------------------------------------------------------------------------------------------------------------
----------------------------------------------------------------------------------------------------------------SSSSSSSSSSSSSSSS------------------------------------------------
-----------------------------------------------------------------------------------------------------------------SSSSSSSSSSSSSSS------------------------------------------------
-------------------------------------------------------------------------------------------------------------------SSSSSSSSSSSSS------------------------------------------------
--------%%%%%%%%--------------------------------------------------------------QS------S-----------------------------------S---------------------QQQQQ---oSS2--@%SS---------QQQQo
---------||||||----------------------------------------------------------------------------------------------------------SSSSSSS-------------------------------|----------------
---------||||||-------------------------------------------------------------------------------------------------o---------SS-----------------------------------|----------------
---------||||||--------------------------------------------------------------g----------------------------------SoSSSSS---SSSSSS-------------------------------|----------------
------%%%%%%%%%%--------------------------------------------------yS---------QQQ-##------------------------------------------SSS---------------#U--y-@--QQQQQ--|----Q-----Q-----
-------||||||||-----------------------------------------------------K-----------#---TT---------T----------------SS------------S----------------#---------------|----------------
-------||||||||-T----------tt---------------------------------------------------#---TT---TT----T----------------SSS----------------#-----------#---------------|T---------------
-------||||||||-T----------tt-g--------------------k-----------------K--g---g---#---TT---TT----T-k-------------------------k-------#--#--------#---gggy------g-gT-------------gg
XXXXXXXXXXXXXXXXXX--XXXXXXXXXX%%XXXXXXXXXXXXXXXXXXXXXXXXXXXXXXXXXXXXXXXXXXXXXXXXXX--XXXXXXXXXXXXXXXX----X-----X-S-SSS------SS-XXXXXXXXXXXXXXXXXXXXXXXXXXXXXXXXXXXXXXXXXXXXXXXXXX
XXXXXXXXXXXXXXXXXX--XXXXXXXXXXX|XXXXXXXXXXXXXXXXXXXXXXXXXXXXXXXXXXXXXXXXXXXXXXXXXX--XXXXXXXXXXXXXXXX---XX-----X---------------XXXXXXXXXXXXXXXXXXXXXXXXXXXXXXXXXXXXXXXXXXXXXXXXXX
