-----------------------------------------------------------------------------------------------------------------------K-------------------------------K----------------------------------------
-----------------------------------------------------------------------------------------------------------------------o-------------------------------o----------------------------------------
----------------------------------------------------------------------------------------------------------------------%%%-----------------------------%%%---------------------------------------
-----------------------------------------------------------------------------------------------------------------------|-------------------------------|----------------------------------------
-----------------------------------------------------------------------------------------------------------------------|-------------------------------|----------------------------------------
-----------------------------------------------------------------------------------------------------------------------|-------------------------------|-----o----------------------------------
--------%%%%%%%%----------------------SSSS-----S-----------------%%%%%-------------------------------------------------|------------------------S------|---%%%------Q---------------------------
---------||||||------------------#--------------------------------|||--------------------------------------------%%%---|------------------------o------|---ooo----------------------------------
---------||||||---------------------------------------------------|||---------------------------------------------|----|----------------------S-%%-----|----|-----------------------------------
---------||||||---------------------------------------------------|||-------#-------------------------------------|----|--oo--------------------||-----|---o|------------------------------o----
------%%%%%%%%%%----------######----------------------------------|||------##-------------------------------------|----|%%%%%-------------------||-----|-%%%|---------------S@S----------%%%----
-------||||||||---------------------------------------------------|||------##-------------------------------------|----|-|||-oo-----------------||-----|--|-|-----------------------------|-----
-------||||||||-----------------------------------------TT--------|||-----####------------------------------------|----|-|||%%%%----------------||-----|--|-%%%%--------------------------|--%%%
-------||||||||-------------------gy---k-----g-g--------TT--------|||----####-#--------------------ggg------------|r---r-|r|-||----k-k--------ko||-----r--|--||---ggogy---k---------------|---|-
XXXXXXXXXXXXXXXXXXXXXXXXXXXXXXXXXXXXXXXXXXXXXXXXXXXXXXXXXXXXXXXX%%%||XXXXXXXXXX-XXXXXXXXX----S%-XXXXXXXXXXXXXXXX-%%%%%%%%%%%%||-XXXXXXXXXXXXXXXX%%%%%%%%%%%%%||-XXXXXXXXXXXXXXXX--%%%%%%%%%%%%%%
XXXXXXXXXXXXXXXXXXXXXXXXXXXXXXXXXXXXXXXXXXXXXXXXXXXXXXXXXXXXXXXXX|-||XXXXXXXX-X-XXXXXXXXX----X|-XXXXXXXXXXXXXXXX--||||||||||-||-XXXXXXXXXXXXXXXX-|||||||||||-||-XXXXXXXXXXXXXXXX---||||||||||||-
