-------------------------------------------------------------------------------------------------------------------------------------------------------K----------------------------------------
--------------------------------------------------S----------------------------------------------------------------------------------------------------o-------------ooo------------------------
------------------------------------------------------------------------------------------------------------------------------------------------------%%%-----------%%%%%-----------------------
------------------------------------------------SSSSSSSS--SSSSSS---------------------------------------------------------------------------------------|-------------|||--------------------SS--
-------------------------------------------------------------------------------------------------------------------------------------------------------|-------------|||------------------------
-----------------------------------------------------------------------------------------------o----------------------------o--------------------------|-------------|||------------------------
--------%%%%%%%%----------------S-------------------------------------SSS-------%%%%--------------oo----o----S----------------------------------%%%%---|-------------|||--%%%%%-----------------
---------||||||-----------------S-------------------------------------o----------||------------------------------------------------------------#-||----o---o----oo%%-||o---|||------------------
---------||||||-----------------S----S-------------------------------------------||----------------------------S----------------------------####-||---%%%-%%%---%%||-|||---|||------------------
---------||||||-----------------S-----------------------------------------SS--S--||-------oo-------------------S---------------------------#####ro|----|---|----||||-|||---|||------------------
------%%%%%%%%%%----------######---------------------2--------------------------%%%------%%%%---S------------SSS#----SSSS----@So%----------#####%%%----|---|----||||-|||---|||----TT----TT------
-------||||||||---------------------------------TT-------------------------------|--------||------------------------------------|---------######-|-----|---|----||||-|||---|||----TT----TT------
-------||||||||---------------------------------TT-------------------------------|--------||---------------------------------##-|--------#######-|-----|---|%%%%||||-|||---|%%%%--TT----TT--TT--
-------||||||||-----------------k------------g--TT----ok-------k-----------------|--------||---------------------------------###|-------########-|-----|--rr-||-||||-||rrrr|-||---TT----TT--TT--
XXXXXXXXXXXXXXXXXXXXXXXXXXXXXXXXXXXXXXXXXXXXXXXXXXXXXXXXXXXXXXXXXXXXXXXXXX---XXX%%%%XXXXXX||-%%%--XXXXXXXX--XXXXXXXXXXXXXXXXXXXX|--XXXXXXXXXXXX--%%%-%%%%%%%%||-%%%%%%%%%%%%-||-XXXXXXXXXXXXXXXX
XXXXXXXXXXXXXXXXXXXXXXXXXXXXXXXXXXXXXXXXXXXXXXXXXXXXXXXXXXXXXXXXXXXXXXXXXX---XXXX|XXXXXX-X||--|---XXXXXXXX-XXXXXX-XX--XXXXXXXXXX|--XXXXXXXXXX-X---|---||||||-||--||||||||||--||oXXXXXXXXXXXXXXXX
