------------------------------------------------------------------------------------------------------------------------------------------------------------------------------------------------
------------------------------------------------------------------------------------------------------------------------------------------------------------------------------------------------
------------------------------------------------------------------------------------------------------------------------------------------------------------------------------------------------
----------------------------------------------------------------------------------------------------------------SSS---SS------S-----------------------------------------------------------------
------------------------------------------------------------------------------------------------------------------------------------------------------------------------------------------------
------------------------------------------------------------------------------------------------------------------------------------------------------------------------------------------------
--------%%%%%%%%-------------------Q-----------o-------S------------QQQS--------SSSSSSSSS----SSS-------------------------------------------------------------------------------o----------------
---------||||||----------------------------------------------------------------------------------------------------------------#-----------------------------------------------#----------------
---------||||||-------------------------------#------------------------------------------------------------------------------#------------------------------------------------#-----------------
---------||||||------------------------------##-S------------SS-----------------o-------------oo---------------------------#--------------------------------------------------#---g-------------
------%%%%%%%%%%---------%%%-------------TT--##---------##-------SQ--SSSSSSSS@S-S---SS-------SSS-------##-----------------#####---------------------S--------SSS----#---------#-SSSS--SS--------
-------||||||||-----------|--------------TT---#--------###---------------------------------------#-----##----------------######------------------------------------------##--##--S--------------
-------||||||||-----------|--------------TT--###------####---K-----------------------------------#-----##--------------########--------tt--------------------------------##--##-----------------
-------||||||||-----------|--------k-gg--TT#####-----#####---#-----y----------------gg----k------#-----##-------#------########--------tt------------g--------------ggg--######-----------------
XXXXXXXXXXXXXXXXXXXXXXXXX-|-----XXXXXXXXXXXXXXXXXXXXXXSXXS--XXXXXXXXXXXXXXXXXXXXXXXXXXXXXXXXXXXXXXXXXXXXXXXXXXXXXXXXXXXXXXXXXXX-XXXXXXXXXXXXXXXXXXXXXXXXXXXXXXXXXXXXXXXXXXXXXXXXXXXXXXXXXXXXXXXX
XXXXXXXXXXXXXXXXXXXXXXXXX-|-----XXXXXXXXXXXXXXXXXXXXSSXXXX---XXXXXXXXXXXXXXXXXXXXXXXXXXXXXXXXXXXXXXXXXXXXXXXXXXXXXXXXXXXXXXXXXX-XXXXXXXXXXXXXXXXXXXXXXXXXXXXXXXXXXXXXXXXXXXXXXXXXXXXXXXXXXXXXXXX
