------------------------------------------------------------------------------------------------------------------------------------------------------------------------------------------------
------------------------------------------------------------------------------------------------------------------------------------------------------------------------------------------------
------------------------------------------------------------------------------------------------------------------------------------------------------------------------------------------------
----------------SSSS----------------------------------------------------------------------------SSSSSSSSSSSSSSSS------------------------------------------------#-------------------------------
-----------------------------------------------------------------------------------------------------------------------------------------------------------------------o------------------------
-----------------------------------------------------------------------------------------------%----------------------------------------------------------------------%-%-----------------------
--------%%%%%%%%%%%%--------------------------------------------------------------------%%-K---|--------------------------------------QQSSSS-------------%--------r-r-o%%%-----o-------SoSS--SSS
---------||||||||||-------------------------------------------------------------%%%%%%%%||-o---|-----------------------------------------------#---------|------%%%%%%%%|----%%%S---------------
---------||||||||||--------------------------------------------------------------||||||-||%%%--|----------------------------------------------##---------|-------||||||-|-----|-S---------------
---------||||||||||--------------------------------------------------------------||||||-||-|---|----------------------------------------------##---------o-------||||||-|-----|-S--------------S
------%%%%%%%%%%|||--------#---------------------------------------------%%%-----||||||-||-|---|--------------------------------------QQQ-----##---------|-------||||||-|-----|-----@SQ-Q---SSSS
-------||||||||-|||--------#-----------TT---------TT----------------------|------||||||-||-|---|--------TT-------------tt--------------------###---------|-------||||||-|--#-#|-----------------
-------||||||||-|||-------##-----------TT-----TT--TT----------------------|------||||||-||-|-%%%--------TT----TT-------tt-------------------####---------|----TT%%|||||-|--#-#|-----------------
-------||||||||-|||------###------g--g-TT-----TT--TT----------------------|------|o||||-||-|--|------k--TT----TT--g----tt---#-##------------####-%%%-----g----TT|||||||-|--#-#|----k------k-k---
XXXXXXXXXXXXXXXX|||-XXXXXXXXX--XXXXXXXXXXXXXXXXXXXXXXXXXXXXXXXXX--XXXXXXXXX--%%%-%%%||%%%|%%%-|-XXXXXXXXXXXXXXXXXXXXXXXXXXXXXXXXXXXX--XXXXXXXXXX--|-XXXXXXXX-%%%|||||||X%XXX--|XXXXXXXXXXXXXXXXX
XXXXXXXXXXXXXXXXX||-XXXXXXXXX--XXXXXXXXXXXXXXXXXXXXXXXXXXXXXXXXX--XXXXXXXX----|---|-||-|-|-|--|-XXXXXXXXXXXXXXXXXXXXXXXXXXXXXXXXXXXX--XXXXXXXXXX--|-XXXXXXXX--|-|||||||XXXXX--ooXXXXXXXXXXXXXXXX
