---------------------------------------------------------------------------------------K--------------------------------------------------------------------------------------------------------
---------------------------------------------------------------------------------------o--------------------------------------------------------------------------------------------------------
---------------------------------------------------------------------------------------%--------------------------------------------------------------------------------------------------------
------------------------------------------------SSSSSSSS-------------------------------|----------S---SSSSSS-SSS----------------------------------------------------------------SSSSSSSS--------
---------------------------------------S-----------------------------------------------|--------------S-----------------------------------------------------------------------------------------
---------------------------------------------------------------------------------------|----------------------SS--------------------------------------------------------------------------oo----
--------%%%%%%%%---------------------SSSQ---------------------o----------------o-------|--------S--oo---o----SSS-------SS--%---o%%%---------------------S--------%------------------------------
---------||||||-------------------------------------------------------oo---------------o---o----S---------------%%%%%%%%---|---%-|-----------------------------#-|------------------------------
---------||||||----------------------------------------------SSS-----------#----------%%%-%%%---S--------------S-||||||----|---|-|-----------------------------#-|------------------------------
---------||||||------------------------g-------o---------------------------#-----------|---o----Sooogooo------oS-||||||----|---|-|-----------------------------#-|------------------------------
------%%%%%%%%%%----------######SSS--SSSQS---SS----------------------------------------|-%%%----SSSSSSSSS-----SS-||||||----|---|%|----------------------------##-|---2-----------------TT-------
-------||||||||-----------------SS--------------o------------------------##------------|--|--or------------------||||||----|---|||----------------------------##-|-------------TT------TT---TTTT
-------||||||||---------------------------------%-----------------------####-#-S-------|--|-%%%%-----------------||||||----|-#-|||---------------------------###-|-------------TT------TT---TTTT
-------||||||||---------------------------------|----------k-k------g--#####-#-#-------|--r--||-----------k------||||||----|---|||-------------#----------o-####-|-----------k-TT------TT---TTTT
XXXXXXXXXXXXXXXXXXXXXXXXXXXXXXXXXXXXXXXXXXXXXXXXX-XXXXXXXXXXXXXXXXXXXXXXXXXXXXXX-------|%%%%-||-XXXXXXXXXXXXXXXX-|%|||%XXXX|---|%%%%---XXXXXXXXX--XXXXXXXXXXXXXX%%XXXXXXXXXXXXXXXXXXXXXXXXXXXXXX
XXXXXXXXXXXXXXXXXXXXXXXXXXXXXXXXXXXXXXXXXXXXXXXXX-XXXXXXXXXXXXXXXXXXXXXXXXXXXXXX-------|-||--||-XXXXXXXXXXXXXXXX-||||||--XXX--oo-||------XXXXXXX--XXXXXXXXXXXXXX||XXXXXXXXXXXXXXXXXXXXXXXXXXXXXX
