-------------------------------------SSSSSS--------------------------------------------------------------------------K-K------------------------------------------------------------------------
------------------------------------SSSSSSS--------------------------------------------------------------------------o-o------------------------------------------------------------------------
---------------------------------------SS---------------------------------------------------------------------------%%%%------------------------------------------------------------------------
---------------------------------------SS------S-----------------#--------------------SSSSSSS------------------------||------------------------------------SSS--SSSS--S---------S---------------
---------------------------------------SS------S---------------------------------------------------------------------||-------------------------------------------------------------------------
--------------------------------SQ-Q-@SSSS------------------------------------------------------------------------o--||-------------------------------------------------------------------------
--------%%%%%%%%----------------------------------o---SSSSS--SSS----------------Sooo----o----Soo------S--------o%%%%-||----S%---------SS--------------------------------------------------------
---------||||||------------------------------------------------------%-------------------------------------------||--||-----|--------------------------------------------------------------o----
---------||||||------------------------------------------------------|------------------------S------------#---S-||--||---%%|---------------------------------------#-----------------------%---
---------||||||------------------------------S--oo-------------------|--------#-oo-----------ooo-----------#-----||--||---|||----------------------------SSS--------------------------------|---
------%%%%%%%%%%----------######SSSSSSSS--------S-----------SoS------|-------##-SSSS---------SSS---------##------||--||---|||---------------------------------------------------------------|---
-------||||||||-----------------SSSSSSSS-----------------------------|tt---#-###------------------------###------||--||---|||---------------------------------------------------------------|---
-------||||||||-----------------SSSSSSSSK-----------------------#----|tt---#####--------#--------------####------||--||---|||----------------------------#---------------------------------K|---
-------||||||||-----------------SSSSSSSS--U----------kk-----k---#----|tt---#####------####------------#####------ooo-||-rrrr|----------------------------#--------------------kg-----------#|---
XXXXXXXXXXXXXXXXXXXXXXXXXXXXXXXXXXXXXXXXX-XXXXXXXXXXXXXXXXXXXXXXXXXXXXXXXXXXXXXX-XXXXXXXXX--XXXXXXXXXXXXXXXXXXXX%%%%%|%%%%%%%--X--XXXXXXXXXXXXXX-XXXXXXXXXXXXXXXXXXXXXXXXXXXXXXX-XXX-XXXXXXX|---
XXXXXXXXXXXXXXXXXXXXXXXXXXXXXXXXXXXXXXXXX-XXXXXXXXXXXXXXXXXXXXXXXXXXXXXXXXXXXXXXXXXXXXXXXX--XXXXXXXXXXXXXXXXXXXX-|||-|-|||XX---X--XXXXXXXXX-XXXXXXXXXXXXXXXX-X-XXXXXXXXXXXXXXXXXXXXX-XXXXX-X|---
