----------------------------------------------------------S-------------------------------------------------------------------------------------------------------------------------------------
-------------------------------------------------S-S-SS---SS------------------------------------------------------------------------------------------------------------------------------------
----------------------------------------------------------S---S---------------------------------------------------------------------------------------------------------------------------------
-----------------S------------------------------SSSSSSSSSSSSSSSS----------------------------------SSSSSSSSSSSSSSSSSSSSSSSSSSSSSS----------------------------------------------------------------
------------------------------------------------SSS-SSSSSSSSSSSS--------------------------------------------------------------------------------------------------------------------------------
------------------------------------------------SSSSSSSSSSSSSSSS------------o-----------------------------------------------------------o-------------------------------------------------------
--------%%%%%%%%--------------------------------SSSSSSSS----SSSS----------------------------------------------------------SS--------------------------QSQS--------------------------------------
---------||||||---------------------------------------------SS----------------------------------------------------------------------------------S-----------------------------------------------
---------||||||---------------------------------------------SS-S--------------------------------------------------------------------------------------------------------------------------------
---------||||||-------------#-#o------------------oooo-------ooS----------oo--------------------------------------------------------------------------------------o-----------------------------
------%%%%%%%%%------2------####-----2------##o-SSSSSSSS-SS---SS-SS---%%%%%%%S---------TT------------------------------------------------TT----------SSQQ---SU----------------------------------
-------|||||||-------2-TT--####-------------#---SSSSSSSSSSS------------|||||-----------TT----------------------------------#------TT-----TT-----------------------------TT----------------------
-------|||||||---------TT--####--------TT---#---SSSSSSSSSSS------------|||||-----------TT-----------tt-------------------###---#--TT-----TT-----------------------------TT----------------------
-------|||||||--g-g--k-TT--####-g-g----TT-###---SSSSSSSSSSS----o-------|||||------g----TT--gy-------tt---------g-----k---###---#--TT-----TT--------k------k-k-----k-----TT----g---------------oo
XXXXXXXXXXXXXXXXXXXXXXXXXXXXXXXXXXXXXXXXXXXXXXXXXXXXXXXXXXXXXXXX-%%%%%%|||||-%%%XXXXXXXXXXXXXXXXXXXXXXXXXXXXXXXX--XXXXXXXXXXXXXXXXXXXXXXXXXXXXXXXXXXXXXXXXXXXXXXXXXXXXXXXXXXXXXX%%%%--%XXXXX%%%%
XXXXXXXXXXXXXXXXXXXXXXXXXXXXXXX-XXXXXXXXXXXXXXXXXXXXXXXXXXXXXXXX--||||-|||||--|-XXXXXXXXXXXXXXXXXXXXXXXXXXXXXXXX--XXXXXXXXXXXXXXXXXXXXXXXXXXXXXXXXXXXXXXXXXXXXXXXXXXXXXXXXXXXXXX-||---|X-XXX-||X
