------------------------------------------------------------------------------------------------------------------------------------------------------------------------------------------------
------------------------------------------------------------------------------------------------------------------------------------------------------------------------------------------------
------------------------------------------------------------------------------------------------------------------------------------------------------------------------------------------------
--------------------------------------------------------------------------------SSSSSSSSSSSSSSSS-SSSSSSS--------------------------------------------------------------SS--------SSSSoooo--------
------------------------------------------------------%%%----------------------oSSS--SSSSS-SSS-----------------------------------------------------------------------------------------%--------
-------------------------------------------------------|------------------------SSS--SSSSSSSSSSS---------------------------------------------------------------------------------------|--------
--------%%%%%%%%---------------------------------------|--------------------------SSSSSSSSSSSSSS--------------------------------SSSSSSSSSSS---SS---------------SS----SSS-----SSo-------|--------
---------||||||--------------------------------------rro---o--------------------S-------------------------------------------------------------------------------S--------------#-------orrrr----
---------||||||---------------------------------%%%%%%%%%-%%%--------------------------------------------------S----------------------------------------------------------------%%%%%%%%%%%%%---
---------||||||----------ooo---------------------|||||||---|--------------------Sooooooo------oS--------------------------------ooo---------------------------------g----------#-|||||||||||----
------%%%%%%%%%%-%%------%%%-----##--###---------|||||||---|---------2----------SSSSSSSS-----------------#----------------------SSS----------SSS---SSS------So-----SS#--------##-|||||||||||----
-------||||||||--||-------|--o-o###--------------|||||||---|--------------------------------------------##--------TT----------------------------------------------------##---###-|||||||||||----
-------||||||||--||----#--|--%%-###--------------|||||||---|-%--------------------------TT------------####--------TT--------------------------------------------------####--####-|||||||||||----
-------||||||||--||----#--|--||-###k--------k----|||||||--rr-|---------k--k--kk---------TT--k--------#####---g----TT----##--------gggg----k--------k-g---------g------#####-####-|||||||||rrrr--
XXXXXXXXXXXXXXXXXo%X--XX--|--||-XXXXXXXXXXXXXXXX-|||||%%%%%%%%--XXXXXXXXXXXXXXXXXXXXXXXXXXXXXXXXXXXXXXXXXX--XXXX-XXXXXXXXX------XXXXXXXXXXXXXXXXXXXXXXXXXXXXXXXXXXXXXXXXXXXXXXXX-||XXXXX%%%%%%%X
XXXXXXXXXXXXXXXX-|XX---X--|--||-XXXXXXXXXXXXXXXX-|||||-||||||---XXXXXXXXXXXXXXXXXXXXXXXXXXXXXXXXXXXXXXXXXX--XXXX-XXXXXXXXX-----XXXXXXXXXXXXXXXXXXXXXXXXXXXXXXXXXXXXXXXXXXXXXXXXX-|XXXXXXXXXX||-X
