-----------------------------------------------------------------------------------------------------------------------K--------------------------------------------------S---------------------
-----------------------------------------------------------------------------------------------------------------------o------------------------------S----------S--------SS--------------------
----------------------------------------------------------------------------------------------------------------------%%%-----------------------------------------------------S-----------------
-----------------------------------------------------------------------------------------------------------------------|-------S----------------SSSS------------SSSSSSSSSSSSSSSS----------------
-----------------------------------------------------------------------------------------------------------------------|-------o--------------------------------SSS--SSSSSSSSSSS----------------
-------------------------------------------------------------------------oo--oo----------------------------------------|------%%----------oo--oo----------------SSSSSSSSSSSSSSSS----------------
--------%%%%%%%%---SSSSSoS---------------------o------SS--------------------------------------------------------%%-----|------||----------------------------------SSSSS-----SSSS----------------
---------||||||---------------------------------SS---------ooo----------------oo---------------#----------------||-----o---o--||--------------oo------------S--------------------------o--------
---------||||||-------------------------------------------------------------------------------------------------||%%%%%%%-%%%-||---------------------------------------------S------------------
---------||||||----g---o------------------------SS--------------------------------------------------------------||-|||||---|--||---------------o------------------ooooo------ooo-------k--------
------%%%%%%%%%%-SSSSSSSQ----SSS-------------S---------#-------------2-------------------------------2----------||-|||||---|--||TT---2-TT---#-------------------TTSSSSSS-SS--SSS-SS----#--------
-------||||||||-S@-------------------------------------##----------------TT--------------------o---------TT-----||-|||||---|--||TT-----TT--##-------------------TTSS-----SS---------------------
-------||||||||-TT------------------------------------##-----------------TT------------------------------TT----#||-|||||---|%%%%TT-----TT--##---###----------K--TT-----S------------------------
-------||||||||-TT--------k-k------------------g---#--##-------g--g------TT----o---------------og-gg---k-TT---##||-|||||rrr|-||-TT-----TT--###--###----k---k-#--TT--------S---k----------------g
XXXXXXXXXXXXXXXXXXXXXXXXXXXXXXXXXXXXXXXXXXXXXXXXXXXXXXXXXXXXXXXXXXXXXXXXXXXXXXXXXXXXXXXX-X------XXXXXXXXXXXXXXXX||-|||%%%%%%-||-XXXXXXXXXXXXXXXXXXX--XXXXXXXXXXXXXXXXXX--XXXXXXXXXXXXXXXXXXXXXXX
XXXXXXXXXXXXXXXXXXXXXXXXXXXXXXXXX--XXXXXXXXXXXXXXXXXXXXXXXXXXXXXXXXXXXXXXXXXXXXXXXXXXXXXXX------XXXXXXXXXXXXXXXX||-|||-||||--||-XXXXXXXXXXXXXXXXXXX--XXXXXXXXXXXXXXXXXX-oXXXXXXXXXXXXXXXX-XXXXXX
