-------------------------------------------------------K---------------K---------------------------------------------------------------SSS------------------------------------------------------
-------------------------------------------------------o---------------o-------------------------------------------------------------SSSSSS----------------------------o------------------------
------------------------------------------------------%%---------------%---------------------------------------------------------------S--------------------------------------------------------
--------------------------------SSSSSSSSSSSSSSSS------||---------------|--------SSSSSSSSSSSSSSSS------------------------------------------------SSSSSSSSSS---SSS--------------------------------
------------------------------------------------------||-------o-------|---------S--------------------------------------------------------------------------------------------------------------
------------------------------------------------------||-------%o-o----|-----------------------------------------------------------Q----------------------------------------ooo-------------o---
--------%%%%%%%%---------S-------Soo----------o--%%o--||-------|%%-----|---------S------------oo-o------S------oSSSSSSSSSS---S----------------------------------S---------%%%%%-----------%%%---
---------||||||----------------------------------||---||---r---|||-----|---------------------------------------#------------------------------------------------o----------|||-------------|----
---------||||||----------------------------#-----||%%%%%%%%%%--|||-----|-------------------#--SS---------------#-----------------------------------SSS%%%%------%%---------|||-------------|----
---------||||||-----------------o---------##---o-||-||||||||---|||-----|-oooo---oooooo--------oo--------------##-------g-------o-----------------------||-------||-------ooo||-----------oo|----
------%%%%%%%%%%------------Soo-S--------###-----||-||||||||---||%%----|%%%%%K--SSSSSS---------S--------------##SSSSSSSSS----SSS-Soo---@---------------||-------||------%%%%||---------%%%%%%%--
-------||||||||-------------------------####-----||-||||||||---||||----|-|||-o------------------------#-------##--------------------------------o------||-------||-------||-|oo---------|||||---
-------||||||||----------------K-------#####-----||-||||||||---||||----|-|||%%%-----------------------#------###--------------------------------%------||-------||-------||-%%%%--------|||||---
-------||||||||---ggg----------g------######-----|o-||||rrr|--o||||r---|-|||-|------------y-k---------#-----####----------U---------------------|------||-------||rrr--r-||--||---------|||||---
XXXXXXXXXXXXXXXXXXXXXXXXXXXXXXXXXXXXXXXXXXX----X-%%%||%%%%%%%%%%|%%%%%%%%%%%-|--XXXXXXXXXXXXXXXXXXXXXXXXXXXXXXXXXXXXXXXXXXX-XXXX--XXX--------SS-|--XXXXXX%%%%%%X%%%%%%%%%%%%-||-%%%%%%%XXXXX|%%%
XXXXXXXXXXXXXXXXXXXXXXXXXXXXXXXXXXXXXXXXXXX---XX--|-||-||||||||-|-|||||||||--|--XXXXXXXXXXXXXXXXXXXXXXXXXXXXXXXXXXXXXXXXXXX-XXXX--XXX-----------|--XXXXX-X||||-X-||||||||||--||o-|||||-XXXXX|-|-
