---------------------------------------------------------------------------------------K--------------------------------------------------------------------------------------------------------
---------------------------------------------------------------------------------------o-------------------------S------------------------------------------------------------------------------
---------------------------------------------------------------------------------------S--------------------------------------------------------------------------------------------------------
----------------SS----------------------------------------------SSSSSSSSSS------------ooo------o-----------------------SS-------------------------------------------------------SSSSSSSSSSSSS---
-------------------------------------------------------------------------------------%%%%%%-----------------------------------------------------------------------------------------------------
--------------------------------------------oooo--------------------------------------||||--------------------------------------------------------------------------------ooo-------------------
--------%%%%%%%%----------------%%---------%%%%%------------------------%-------------|||ooo------oorooooo------SS---SS------S---------------------------------------------------oo-------------
---------||||||---------------##||----------|||-------------------%%%---|------------r|o||-rr-----S%%%%-----------------------------------------------------------------------oo-##-------------
---------||||||--------------###||----------|||--------------------|----|--S-SSS---%%%%%%%%%%%------||-------S----------------------------------------------------------------------------------
---------||||||--------------###||-------oooo||--------------------|----|-----------|||||||||---S---||-----S-S-----gg----------o-----------------------------------------------#-----------#----
------%%%%%%%%%%-----------#####||------%%%%%||--------------------|----|-----------|||||||||---S---||-----S----SSSSSS-SSS-----S---------------------So-----SS-----------------#---------###----
-------||||||||-----------######||-------|||-|o---TT-----------oo--|tt--|-------o---|||||||||-------||-----K----S-SSSSSSS#---------------#-------------------------------------#--------####---#
-------||||||||----------#######||-------|||%%%%--TT-----TT---TT%%-|tt--|#-#----%%--|||||||||%S%----||----------S-SSSSSS##---#-----------#-------------------------------------#----tt-#####---#
-------||||||||--------#########||-----rrrr|-||---TT-----TT---TT||-|tt--|--#----||--||||||||||-|----|k---#-g----k--SSS####---#-----k----##------#-----------gg--g-------------##----tt######---#
XXXXXXXXXXXXXXXXXXXXXXXXXXXXXXXX|%%%%%%%%%%%-||--XXXXXXXXXXXXXXXX|-|XXXXXXXXX---||--||%%%%%%%%%%XXXXXXXXXXXXXXXXXXXXXXXXXXXXXXXXXXXXX-XXXXX--XXXXXX----XXXXXXXXXXXX----XXXXX--XXXXXXXXXXXXXX---X
XXXXXXXXXXXXXXXXXXXXXXXXXXXXXXX-|-|||||||||--||-XXXXXXXXXXXXXXXXX|-|XXXXXXXXX--X||--||-||||||||-XXXXXXXXXXXXXXXXXXXXXXXXXXXXXXXXXXXXX-XXXX---XXXXXX----XXXXXXXXXX------XXXXX-XXXXXXXXXXXXXXXo-XX
