----------------------------------------------------------S-------------------------------------------------------------------------------------------------------------------------------------
----------------------------------------------------------S-------------------------------------------------------------------------------------------------------------------------------------
------------------------------------------------------------------------------------------------------------------------------------------------------------------------------------------------
----------------------------------------------------------SSSSS------------------------------------------------------------------SSSSSSSS----------------------------------------------SSSSSSSSS
------------------------------------------------------------------------------------------------------------------------------------------------------------------------------------------------
------------------------------------------------------------------------------------------------------------------------------------------------------------------------------------------------
--------%%%%%%%%---------------------------------oo-----oo--oo----oo----ooo--o-o----------------S-------%%%%%%%-----QQQoo------o-------oSo-----------------------SoSSSSSo-----SS----------------
---------||||||----------------------------------------------------------------------------o-------------|||||----------------------------------------------S-----------------------------------
---------||||||----------------------------#----------S-S-SSSS-S--------SSSS-SSS%%%%%%%%%-%%----%%-------|||||----------------------------------------------------------------------------------
---------||||||----------------------------##---------S-S-SSSS-S-----------------|||||||--||----||-------|o|||-----------------------------------------------------gg----------o----------------
------%%%%%%%%%%----------######-TT-------####--S------------SS---------------S--|||||||--||----||------%%%%%|---------------U-----------------------------------#SSSS--------S-----------------
-------||||||||------------------TT-----TT####-----------------------------------|||||||--||----||-------|||-|------------------------------------TT-----------TT#-----------------------TT-----
-------||||||||------------------TT-----TT####-----------------------------------|||||||--||----||-------|||-%%%----------------------------------TT-----------TT#-----------------------TT-----
-------||||||||------------------TT-----TT####-----------------------------------|||||||--|rrr-o||rr---rrr||--|----k-ggg----k---------------------TT-------oooo%##--------#-----k--------TT-----
XXXXXXXXXXXXXXXXXXXXXXXXXXXXXXXXXXXXXXXXXXXXXXX--XXXX-------XXXX---X--XXXXXXXXXX-||||%%%%%%%%%%%%%%%%%%%%%%%%%%%XXXXXXXXXXXXXXXX--X--XXXXX-%%--XXXXXXXXXX----%%|XXXXXXXXXXXXXXXXXXXXXXXXXXXXXXXX
XXXXXXXXXXXXXXXXXXXXXXXXXXXXXXXXXXXXXXXXXXXXXXXX-XXXX-X-----XXXX---X--XXXXXXXXXX-||||-|||||||||||||||||||||||||-XXXXXXXXXXXXXXXX--X--XXXXX-||-XXXXXXXXXXX----|||XXXXXXXXXXXXXXXXXXXXXXXXXXXXXXXX
