-------------------------------------------------------------------------------------K-K--------------------------------------------------------------------------------------------------------
-------------------------------------------------------------------------------------o-o---------------------------------SS---------------------------------------------------------------------
------------------------------------------------------------------------------------%%%%%-------------------------------------------------------------------------------------------------------
--------------------------------SSSSSSSS---------------------------------------------|||--------------------------------------------------------------------------------------------------------
-------------------------------------------------------------------------------------|||---------------------------------------------------------------------------------------o----------------
-------------------------------------------------------------------------------------|||-------------------------------------------------------------------------oooo---o-----------------------
--------%%%%%%%%-----------------------------------------------o---------------------|||--------------------------------------------------------------------------------------------------------
---------||||||------------------------------------------------#-----------k---#%%%%%|||--%%%%%%-o--------##-------------------------------------------o--oooo----------------------------------
---------||||||---------------------------------------------####-----------####--|||-|||---||||-----------##------------------------------------------------------------------------------------
---------||||||---------------------------------ooo--------#####--------##-###---|||-|||---||||----------###-----------------------------SSS-SS-------------------------------------------------
------%%%%%%%%%%----------#####--------TT-------SS---------#-###-------#######-#-|||-|||---||||----------###--TT----------------------------------S--------------U------------------SS-------SS-
-------||||||||-----------------TT-----TT----TT------------#####------##########-|||-|||---||||---TT----###---TT----------------------------------------#-----------------------S--------TT-----
-------||||||||-----------------TT-----TT----TT------------#####-----###########-|||-|||---||||---TT---####---TT-------------------------#-K-----------##--------------------------------TT-----
-------||||||||-----------------TT-----TT----TT-----gggg-#######----############-|||-|||---||||---TT--#####---TT-Skk--k-------kS---------#------------###------------k----------k--------TT-----
XXXXXXXXXXXXXXXXXXXXXXXXXXXXXXXXXXXXXXXXXXXXXXXXXXXXXXXXXXXXXXXXXXXXXXXXXXXXXXXX-%%%-|%%%-%%%||-XXXXXXXXXXXXXXXXXXXXXXXXXXXXXXXX--XXXXXXXX-S%%XXXXXXXXXXXXXXXXXXXXXXXXXXXXXXXXXXXXXXXX---XXXXXXX
XXXXXXXXXXXXXXXXXXXXXXXXXXXXXXXXXXXXXXXXXXXXXXXXXXXXXXXXXXXXXXXXXXXXXXXXXXX-XXX---|--|-|---|-||-XXXXXXXXXXX-XXXXXXXXXXXXXXXXXXXX--XXXXXXXX--|XXXXXXXXXXXXXXXXXXXXXXXXXXXXXXXXXXXXXXXXX----XXXXXX
