-------------------------------------------------------------------------------------------------------------------------Q------------------------------------------------------
--------------------------------------------------------------------------------------------------------------------------------------------------------------------------------
--------------------------------------------------------------------------------------------------------------------------------------------------------------------------------
--------------------------------SSSSSSSSSSSSSSSS-------------------------------------------------------------------------------S------------------------------------SSS---------
-------------------------------------------------------------------------------------------------------------------------o------------------------------------------------------
---------------------------------------------------------------U--##--------------------------------------------%%%%-----S----------------------------ooo-----------------------
--------%%%%%%%%-----SooSS-----%-------------------SQ-SSUS-----%-------------------------------------------------||---------------Q------------o------SSS-----------------------
---------||||||----------------|-----oo-r----------------------|-------------------------------------------------|Q----------S---------------------oo---------------------------
---------||||||----------------|-%%%%%%%%%%%-------------------|-----------------------%%------------------------%%%---------S--------------------------------------------------
---------||||||----------------|--|||||||||------------------R-|-----------------------||-------------------------|----USSSSSSSS------------------------------------------------
------%%%%%%%%%%--2S--SSS------|-%%%|||||%%%%%%%--%%-%%%%%%----|-------TT--------------||-----%%------------------|----%-%---%%---@--------------------S------------------------
-------||||||||----------------|--|-|||||-|||||---||--||||-----|----K--TT--------------||-----||------------------|----|-|---||-----------------TT-----------------------TT-----
-------||||||||----------------|--|-|||||-|||||-%%%|--||||-----|-------TT--------------||-----||-----------%------|----|-|---||-----------------TT-----------------------TT-----
-------||||||||---------k----#-|--|-||o||-|||||--g-g--||||---#-|-------TT-------------gg|-----g|-----------|--g---|----|-|-o-||-K----------g----TT-----------------------TT-----
XXXXXXXXXXXXXXXXgXXXXXXXXXXXXXXX--|-||%%%-|||||--|XX--XXXXXXXXXXXXXXXXXXXXXXXXXXXXXXXXX||-----X|XXXXXXX---XXXXXX--|--%%|%%%--||--XXXXXXXXXXXXXXXXXX-X----XX-XXXXXXXXXXXXXXXXXXXX
XXXXXXXXXXXXXXXXXXXXXXXXXXXXXXXX--|-||-|g-|||||--|XX--XXXXXXXXXXXXXXXXXXXXXXXXXXXXXXXXX||-----X|XXXXXXXX--XXXXXX--|--|||-|---||--XXXXXXXXXXXXXXXXXX-XX---XX-XXXXXXXXXXXXXXXXXXXX
