--------------------------------------------------------------------------------------S--------------------------------------------------------------------------------K------------------------
-------------------------------------------------------------------------------------------------------------------------------------------------k---------------------o------------------------
----------------------------------------------------------------------------------------------------------------------------------------------------------------------%%%-----------------------
--------------------------------SSSSSSSSSSSSSSSS--------------------------------SSSS----------------------------SSSSSSSSSSSS---------------------#---------------------|------------------------
--------------------------------SS---S-S----------------------------------------------------------ooo------------------------------------------------------------------|------------------------
---------------------------------S----S-------SS------------------------------------------------------------------------------------------------------------------o----|------------------------
--------%%%%%%%%---------------------SS---SS--SS--------------------------------------------SS------------------oooo----oo----SS--------------------------------%%%----|-----%%%----------------
---------||||||---------------------------------SU------------------------------------------S----------------------------------------------------K---------------|o----o------|-----------------
---------||||||-----------------------------#------------------------------------------TT------------------------------------------------------------------------%%%%%%%%-----|-----------------
---------||||||----------------------------##------------------------------------------TT---S------------ooo------------------------------------------------------||||||-oooo-|-----------------
------%%%%%%%%%%----------#####-TT--------####----TT---------------------#-------------##-------oooo-----%%%----S-------------------------------------------------||||||%%%%%-|------@----------
-------||||||||-----------------TT---K-TT#####----TT---------------------#--------------------------------|-------------------------------------------------------||||||-|||--oo---------TT-----
-------||||||||-----------------TT-----TT#####----TT-------------------###------------#-------------------|------------------------------TT--------------TT-###---||||||-|||-%%%---------TT-----
-------||||||||-----------------TT---k-TT#####----TT-----g------------####------------#-------------------|----------g-------------------TT-------g---#--TT-###---rrrrrrrrr|--|------k---TT-----
XXXXXXXXXXXXXXXXXXXXXXXXXXXXXXXXXXXXXXXXXXXXXXXXXXXXXXXXXXXXXXX---XXX-XXX------XXXXXXXXXXXXX-X----XXXXX---|-----XXXXXXXXXXXXXXXXXXXXXXXXXXXXXXXXXXXXXXXXXXXXXXXX%%%%%%%%%%%%%%%%XXXXXXXXXXXXXXXX
XXXXXXXXXXXXXXXXXXXXXXXXXXXXXXXXXXXXXXXXXXXXXXXXXXXXXXXXXXXXXXXX--XXX-XXoo-----XXXXXXXXXXX-X-X-X--XXX-X---|-----XXXXXXXXXXXXXXXXX-XXXXXXXXXXXXXXXXXXXXXXXXXXXXXX-||||||||||||||-XXXXXXXXXXXXXXXX
