-----------------------------------------------------------------------------------------------------------------------KS-----------------------------------------------------------------------
-----------------------------------------------------------------------------------------------------------------------oo-----------------------------------------------------------------------
----------------------------------------------------------------------------------------------------------------------%%%-----------------------------------------------------------------------
-----------------------------------------------------------------------------------------------------------------------|--------SSSSSSSSSSSS--------------------SSSSSSSSSSSSSSS-----------------
--------------------------------------------------------------------------------------%%%%-----o-----------------------|----------------------------------------------SS------------------------
---------------------------------------------------------------------------------------||-----%%-----------------------|----o-----------------------------------------SS-----oo-----------------
--------%%%%%%%%------------------------o------U----------------SSSSSSSS---------------||-----||-----------------------|--%%%%-----------------S-------@--------SSSSSSSSo----SSSSSSSSSS------SS-
---------||||||---------------------------------------------ooo------------------------o|--o--||--------------##-------|---||-------------------------------------------------------------------
---------||||||------------------------------o---------------------------------------%%%%%%%%-||------------####-------|---||--------------y----------------------------------------------------
---------||||||--------------------------o--------------------------------------------||||||--||-----------#####-------|-ooo|--------------##-------------------Soooo---------oo---------------o
------%%%%%%%%%%----------######------------S@------------------SSSSSSSS-----SSS------||||||--||TT-----TT--#####-------|%%%%%-------------###---Q----SS#S----S--SSSSS--#-----SSSSSQSSSSSSSSSSSSS
-------||||||||-----------------------------------------------------------------------||||||--||TT-----TT--#####-------|-|||-------------####--------------------------@------------------------
-------||||||||-----------------------------------------------------------------------||||||-%%%TT-----TT--####--------|-|||-------------####--------------------------#------------------------
-------||||||||-------------------kk-----------g--------#-------------------------o---|o||||--|-TT-----TT######--------|-|||---o-----g-k-####-------------k-----------#-k-----------gg----------
XXXXXXXXXXXXXXXXXXXXXXXXXXXXXXXXXXXXXXXXXXXXXXXXXXXXXXXXX-------XXXXXXXXXXXXXXXX-%%%--%%%%%|-%%-XXXXXXXXXXXXXXX--%%%%%%%%|||%%%%XXXXXXXXXXXXXXXXXXXXXXXXXXXXXXXXXXXXXXXXXXXXXXXXXXXXXXXXXXXXXXXX
XXXXXXXXXXXXXXXXXXXXXXXXXXXXXXXXXXXXXXXXXXXXXXXXXXXXXXXXX-------XXXXXXXXXXXXXXXX--|----|||-|-||-XXXXXXXXXXXXXXX---||||||-|||-||-XXXXXXXXXXXXXXXXXXXXXXXXXXXXXXXXXXXXXXXXXXXXXXXXXXXXXXXXXXXXXXXX
