--------------------------------------S---S--------------------------------------------------------------------------------------------K---------------K----------------------------------------
----------------------------------S---S---S--------------------------------------------------------------------------------------------o---------------o----------------------------------------
---------------------------------------SSSSSSSSS---------------------------------------------------------------------------------------%--------------%%%---------------------------------------
--------------------------------SSSSSSSSSSSSSSSS---------------------------------------------------------------------------------------|--------S------|------------------------SSSSSSSSSSS----S
--------------------------------SSSSSSSSSSSSSSSS---------------------------------------------------------------------------------------|---------------|----------------------------------------
--------------------------------SSSSSSSSSSSSSSSS-----------------------------------------------------------oo--------------------------|-------o-------|----------------------o-----------------
--------%%%%%%%%----------------SSSSSSSSSSSSSSSS-----------------SS--SSSS--SSS----------------------------%%%--------------------------|---------------|----------------------------------------
---------||||||------------------------------------------------%-----------------o-------------------------|----------oo---------------|--------%%%%---|-----%%%--------------------------------
---------||||||------------------------------------------------|---------------------------#------S--------|---------------------------|---------||----|------|---------------------------------
---------||||||-----------------oooooooo-----ooo---------------|--------------oo-----------#---------------|---------------------------|--oo-----||----|------|---------------------------------
------%%%%%%%%%%----------######SSSSSSSSSS---SSS---------------|S------#-----SSS---------###---------------|---------------------------|-%%%----%||----|------|-------%%%%%%%%------------------
-------||||||||------------------------SSS---------------------|-------##----------------###---------------|---------------------------|--|---oo|||----|------|#-------||||||-oo-------tt-------
-------||||||||------------------------------------------------|------###----#---------#####---------------|---------------------------|--|-%%%%|||----|------|#-------||||||----------tt----TT-
-------||||||||----------------------oooooo-------g-------#----#-----####-------------######---------------|---------------------------|--|--||-|||----|------|#-------||||||--#-------tt----TT-
XXXXXXXXXXXXXXXXXXXXXXXXXXXXXXXXXXXXXXXXXXXXXXXXXXXXXXXXXXXXXXXXXXXXXXXXXXXXXXXXXXXXXXXXXXX-----XXXXXXXXXXXXXXXX------%%%%%%%%%%%%%%%%%%%%|--|%%|||----|-XXX--|XX%%%-X-|XXXXXXXXXXXXXXXXXXXXXXXX
XXXXXXXXXXXXXXXXXXXXXXXXXXXXXXXXXXXXXXXXXXXXXXXXXXXXXXXXXXXXXXXXXXXXXXXXXXXXXXXXXXXXXXXXXXX-----X-XXXXXXXXXXXXXX-------||||||||||||||||||-|--||||||----|-XXX--|XXXX--X-|XXX-XXX-XXXXXXXXXXXXXXXX
