---------------------S--SS---------------------------------------------------------------------------------------------------------------------------------------------S------------------------
-------------------SSSSSSSS---------------------------------------------------------------------------------------------------------------------------S----------------S------------------------
-----------------------------------------------------------------------------------------------------------------------------------------------------------------------S------------------------
----------------------------------------------------------------------------------------------------------------SSSSSSSSSSSSSSSS#---------------SSSSSSSSSSSSSSSS--------------------------------
-----------------------SSSS--SSS------------------------------------------------------------------------------------------------K--------------o------------------------------------------------
-----------------------SSS---g--------------------------------------------------------------------------------------------------o--------------S-------------------o------@---------------------
--------%%%%%%%%------------SS--%%---------------------%%%----------------------------------------------------------------------%------------------------------------------------------SS------o
---------||||||-------------SS--||---%%%----------------|-----------------------------------------------------------------------|-o---------------%%%%%--------------------o--------------------
---------||||||-----------------||----|-----------------|-----------------------------------------------------------------##----|%%%---------------|||---------------------------------------S--
---------||||||-------------SS--||----|--oooo-----------|---------------------------------------------------------------TT##----|-|-------oo-------|||----S--SS--------k--SoSSS------------S-S--
------%%%%%%%%%%-SSSSSSS-------S||----|-%%%%%-----------|------------------------SQ----2-SSSSSS------2------------------TT##----|-|-----%%%%%------||#-----------ooo---@----------#---------SS--
-------||||||||-SSSSSSSS-------S||----|--|||--o---------|----------------------------------------TT------TT-------TT----TT------|-|------|||--oo#--||#-----#----------------------#-------------
-------||||||||-SSSSSSSSK------S||----|--|||-%%%--------|----------------#-----------------------TT------TT-------TT----TT-----#|-|------|||-%%%%--||#---#-#----------------------##------------
-------||||||||-SSSSSSSS------SS|ooo--|--|||--|------k--|------r---------#---------g-------------TT----k-TT-------TT----TT-----#|-|rr----|||--||#--||#---#-#--------------------####-------k----
XXXXXXXXXXXXXXXX-XXXXXXXXoX-XXXX%%%%%%%%%|%%%%%%---XXXX-|--%%%%%--XXXXXXXXXX-%--XXXXXXXXXXXXXXXXXXXXXXXXXXXXXXXXXXXXXXXXXXXXXXXX|%%%%%%%%%%%--||XXXXXXXXXXXXXXXX--XX--K---------XXXXXXXXXXXXXXXX
XXXXXXXXXXXXXXXXXXXXXXXXXXX-XXXX-|||||||-|-||||----XX-XX|---|||---XXXXXXXXX--|--XXXXXXXXXXXXXXXXXXXXXXXXXXXXXXXXXXXXXXXXXXXXXXXX|-|||||||||---||XXXXXXXXXXXXXXXX--XX--X---------XXXXXXXXXXXXXXXX
