---------------------------------------------------------------------------------------K-------------S-----------------K------------------------------------------------------------------------
---------------------------------------------------------------------------------------o-----------------SS------------o------------------------------------------------------------------------
---------------------------------------------------------------------------------------%------------------------------%%%-----------------------------------------------------------------------
---------------------------------------------------------------------------------------|-------------------------------|---------SS-----------------------------SSSSSSSSSSSSSSSSSSSSSSSS--------
---------------------------------------------------------------------------------------|-------------------------------|----------------------------------------S-------------------------------
------------------------------------------oo-----------------oo------------------------|---oo-o-Qoooo--SS--------------|-------------------------------------------------------------------o----
--------%%%%%%%%-----------------------------------------------------------------%%----|--%%%%-------------------------|-------------------o--------------------------SS--SSSSSS----------------
---------||||||------------------------------------------------------------------||----|---||--o-----------------------|-------------------#----------------------------------------------------
---------||||||------------------------------------------------------------------||----|---||--------------------------|-------------------#----------------------------------------------------
---------||||||-----------------------------------------------oo----------SS-----||----|---||--#------------o----------|-o-o--------------------------------------------------------------------
------%%%%%%%%%%----------######-------------------------------------------------||----|%%%%|--#--TT------------%%%%---|%%%%------------###--------------TT----------------------------TT-------
-------||||||||------------------------------------------------------------------||----|-||-|-----TT-------------||----|-||--ooo--------##---------------TT---------------------TT-----TT---TTTT
-------||||||||--------------------------------TT------TT------------------------||----|-||-|%%%#-TT-------------||----|-||-%%%%-------####---TT---------TT----------tt---------TT-----TT---TTTT
-------||||||||---------------------------##---TT------TT----------#-------------||----|-||-|-|-S-TT-k------k----||r---|-||--||------######---TT--kggggg###----------tt------g--TT-----TT---TTTT
XXXXXXXXXXXXXXXXXXXXXXXXXXXXXXXXXXXXXXXXXXXXX-XXXXXXXXXXX-XXXXXXXXXXXXXXXX--XXXX%%%%%%%%%%%X|-|-XXXXXXXXXXXXXXXX-%%%%%%%%%%%-||--XXXXXXXXXXXX-XXXXXXXXXXXXXXXXXXXXXXXXXXXXXXXXXXXXXXXXXXXXXXXXXX
XXXXXXXXXXXXXXXXXXXXXXXXXXXXXXXXXXXXXXXXXXXXX-XXXXXXXXXXX-XXXXXXXXXXXXXXXX--XXXX-|||||||||XX|-|oXXXXXXXXX-XXXXXX--|||||||||--||--XXXXXXXXXXXX-XXXXXXXXXXXXXXXXXXXXXXXXXXXXXXXXXXXXXXXXXXXXXXXXXX
