-------------------------------------------------------K----------------------------------------------------------------------------------------------------------------------------------------
-------------------------------------------------------o-------------------------------------------------------------------------------------------------------------------------K--------------
------------------------------------------------------%%%---------------------------------------------------------------------------------------------------------------------------------------
----------------SSSSSSSSSSSSSSSS-----SSSSSSSSSSS-------|-----------------------------------------#----------------------------------------------------------------------------------------------
-------------------------------------------------------|----------------------------------------------------------------------------------------------------------------------------------------
-------------------------------S----------------roo----|------oo-----------oo-------------------------------------------------------------------------------------------------------------------
--------%%%%%%%%SSSSSSSSo----SSo----------------%%%%---|----%-%%%%%-------%%%%%----------------------QQooo-----o----------------------------------------------------------------SSSSS---o------#
---------||||||----------------#-----------------||----|----|--|||---------|||-------------#----S-----------------------------------------------------------------------------------------------
---------||||||---------------##-----------------||----|----|--|||---------|||------------##--------------------------------------------------------------------------------------------------o-
---------||||||-ooooo--------###----------SS-----||----|-oooo--|||--------o|||-----------####------------------------------------------------------------------------%%%SSSSSSS-o---------------
------%%%%%%%%%%SSSSSSS--#-#####--------#--------||----|%%%%%--|||----%%%%%%%%-----------####----####----------------2--TT--------------------------------------------|---------------------SSSS
-------||||||||----------#######--TT---###-------||----|-|||-oo|||-----||||||-oo--------####-----###--------------------TT-------S----------------------TT------------|-------------------------
-------||||||||--------#########--TT--####-------||----|-|||%%%%||-----||||||%%%-------#####----####------------TT------TT----TT------------------------TT-----K------|-------------------------
-------||||||||------###########--########-------oor---r-|||-||-||-----||||||-|------#######---####----y--------TT------TT----TT------------------g-----TT-----g%%%%%-|------g-----k-kko--------
XXXXXXXXXXXXXXXXXXXXXXXXXXXXXXXX-XXXXXXXXX--XXXX%%%%%%%%%%%|-||-%%%%%%%%%%%||-|-XXXXXXXXXXXXXXXXXXXXXXXXXXXXXXXXXXXXXXXXXXXXXXXXXXXX--X---XX---XXXXXXXXXXXXXXXXXX|||--|--XXXXXXXXXXXXXXXXXXXXXXX
XXXXXXXXXXXXXXXXXXXXXXXXXXXXXXXXXXXXXXXXXX--XXXX-|||||||||-|-||o-|||||||||-||-|-XXXXXXXXXXXXXXXXXXXXXXXXXXXXXXXXXXXXXXXXXXXXXXXXXXXX--X---XX-XXXXXXXXXXXXXXXXXXXX|||--|--XXXXXXXXXXXXXXXXXXXXXXX
