--------------------------------------------------------------------------S----------S----S------------K-------------------------------SSSS-----------------------------------------------------
-----------------------------------------------------------------------------------------SS------------o----------------------------SSSSSSS-----------------------------------------------------
------------------------------------------------------------------------------------------------------%%%------------------------------S--------------------------------------------------------
--------------------------------SSSSSSSSS-SSSSSS-----------------------------------------SSSSSSS-------|----------------------------------------------------------------------------------------
-------------------------------------------------------------------------------------------------------|-------------------------------o-g------------------------------------------------------
-------------------------------------------------------------------------------------------------------|-----ooo---------------o-----@SSS-------------------------------------------------------
--------%%%%%%%%------------------------------------------------o-oooSSSoS----@------U----------S------|----%%%%-----------------------------------------------#@SSSSSSS-----S-------SSSSS---S--
---------||||||-----------------%%%%-------#-%S%----------------S-------------------------------o------o-----||------------------------------------------------#-------------U------------------
---------||||||------------------||--------#-|-|----------------S------------------------------S%%%%--%%%----||-----------------------------------------------##--------------------------------
---------||||||------------------||--------#-|-|----------------S------o----SSSS---------------S-||----|-ooo-||----------oooo---------@---SSSSSS--------------##--------------------------------
------%%%%%%%%%%----------######%||------###-|-|---------%%%%%SSSSSS-SSSQ----S-S-S-SSSS--------S-||----|%%%%-||----------%%%%---------U---------------------####SSSSSSSSS--------QQ----S--------
-------||||||||-----------------|||------###-|-|----------|||----k-K------------SSSSSSLS---------||----|-||--|o-----------||------------------------------#-####------S-------------------------
-------||||||||-----------------|||----#####-|-|----------|||-%%----------------SSSSSSSS---------||----|-||-%%%%----------||---------o--------------------#####------SS-------------------------
-------||||||||-----------------|||----#####-|-|----------|||-||---k-------k----SSSSSSS----------||r--rrr||--||----g------||----------------------ggg-----#####-----------------------#---------
XXXXXXXXXXXXXXXXXXXXXXXXXXXXXXXX|||-XXXXXXXX-|-|-------XXXXXXXX|XXXXXXXXXXXXXXXXXXXXXXXXXX--XXXX%%%%%%%%%%%%-||-XXXXXXXXX-||----------------S---XXXXXXXXXXXXXXXXXXXXXXXXXXX-XXXXXXXXXXXXXX--XXXX
XXXXXXXXXXXXXXXXXXXXXXXXXXXXXXXX|||-XXXXXXX--|-X-------XXXX-XXX|XXXXXXXXXXXXXXXXXXXXXXXXXX--XXXX-||||||||||--||-XXXXXXXXX-||-------X-----------oXXXXXXXXXXXXXXXXXXXXXXXXXXXXXXXXXXXXXXXXXX--XXXX
