-------------------------------------------------------------------------------------------------------K-----------------------------------------------K----------------------------------------
-------------------------------------------------------------------------------------------------------o-----------------------------------------------o----------------------------------------
------------------------------------------------------------------------------------------------------%%-----------------------------------------------%----------------------------------------
------------------------------------------------------------------------------------------------------||--------SSSSSSSSSSSSSSSS-----------------------|--------SSSS----------------------------
------------------------------------------K-----------------------------------------------------------||-------o---------------------------------------|----------------------------------------
-------------------------------#----------------------------------o------------------------------ro---||-------S-------------------------------o-------|---ooooo--------------------------------
--------%%%%%%%%--------------------QSSQQ----------------------------------#-----SSSSSQ------2--%%%%--||---------------------------------------%-------|---%%-----------------------------------
---------||||||----------------o-------------------------------#----------##---------------------||---|o---------------------------------------|-------|---||--o-----------#--------------------
---------||||||------------------------------------------------#---------####--------------------||---%%%--------------------------------------|-------|---||-------------####------------------
---------||||||--TT--------------------g-----------------------#--------#####--------------------||----|-ooooo--oo-----------#-----------------o-------|-ooo|-------------####------------------
------%%%%%%%%%%-TT----TT--------S---SSSS----U-----------TT-------------######-----SSS-----------||----|%%%%%%---------TT---###----------%%%%%%%-------%%%%%%------------####-------------------
-------||||||||--##----TT--------------------------------TT------------#######-------------------||----|-||||----------TT---###-----------|||||---------||||-oo--------######-------------------
-------||||||||--##----TT--------------------------------TT----------#########-------------------||----|-|||%%%-------TT---####-----------|||||---------||||%%%%------########-#----------------
-------||||||||--------TT--#---------------------g---#---TT---##-----#########-------kk---k-k----|rrrrrrrrr|-|--------TT---####-----------|||||---------||||-||------#########-#%---------------
XXXXXXXXXXXXXXXXXXXXXXXXXXXXXXXXXXXXXXXXXXXXXXXXXXXXXXXXXXXXXXXXXXXXXXXX---XXX--XXXXXXXXXXXXXXXX%%%%%%%%%%%%-|--XXXXXXXXXXXXXXX-%%%%%XXXXXXX|||-%%%%%%%%%%||-||-XXXXXXXXXXXXX-XX|---XXXXXXXXX%%%
XXXXXXXXXXXXXXXXXXXXXXXXXXXXXXXXXXXXXXXXXXXXXXXXXXXXXXXXXXXXXXXXXXXXXXXXXXXXXXX-XXXXXXXXXXXXXXXX-||||||||||--|--XXXXXXXXXXXXXXX--|||-XXXXXXX|||X-||||||||-||-||-XXXXXXXXXXXXX-XX|----XXXXXXXX-|X
