------------------------------------------------------------------------------------------------------------------------------------------------------------------------------------------------
------------------------------------------------------------------------------------------------------------------------------------------------------------------------------------------S-----
------------------------------------------------------------------------------------------------------------------------------------------------------------------------------------------------
------------------------------------------------------------------------------------------------SSSSSSSSSSSSSSSS##------------------------------SSSS-----------------------------------SSSSSSSSS
------------------------------------------------------------------------------------------------S----SS-----------------------------------------------------------------------------------------
-----------------------------------------------------------------------------ooo----------------------------------------------------------------------------------------------------------------
--------%%%%%%%%----------------@SS@SSSSoS---SSS----------------%%---------%%%%%----------------SSSo-----oo--o--------------------------------------SS-----------------------SSS----------------
---------||||||--------------------------------------------o----||----------|||-----------------------------------------------%%----------------------------------o-----------------------------
---------||||||-------------------------------------------#-----||----------|||-----------------------SSSSSS---S-------------###---------------------------------%%%--------------------K-------
---------||||||-----------------g------------------------##-----||-------ooo|||-----------------ooooo---------oo------------####--------------------gg---------o--|--------------------TT-------
------%%%%%%%%%%----------######SSQSSSSS-----SSS--SS----##------||----%%%%%%%%%%----------------SSSSSS---------S-----------#####---------------TTTT-##S-----------|------%%%%%S---SSSSTT--------
-------||||||||----------------------------------------###------||-----||||||||--------------------------------------------#####---------#----TTTTT---------------|-------|||-----SSSTT------#--
-------||||||||---------------------------------------####---K--||-----||||||||-------------------------------------------######---------#----TTTTT---------------|-------|||-%-TTSSSTT###---#--
-------||||||||--------------------k-ky---k----------#####---#--||-----||||||||-------------------------------------------#-####---------#----TTTTT------g--------|-------|||-|-TT---TT###---#--
XXXXXXXXXXXXXXXXXXXXXXXXXXXXXXXXXXXXXXXXXXX-XXXXXXXXXXXXXX--XXXX|%%%%%%%%%%||||-XXXXXXXXXXXXXXXXXXXXXXXXXXXXXXXX-------XXXX-XXX-XXXXXXXXXXXXXXXXXXXXXXXXXXXXXXXX-%%%%-%%%%%||-|-XXXXXXXXXXXXXXXX
XXXXXXXXXXXXXXXXXXXXXXXXXXXXXXXXXXXXXXXXXXX-XXXXXXXXXXXXXX--XXXX|-||||||||-||||-XXXXXXXXXXXXXXXXXXXXXXXXXXXXXXXX-------XXXX-X-X-XXXXXXXXXXXXXXXXXXXXXXXXXXXXXXXX--||---|||-||-|-XXXXXXXXXXXXXXXX
