-------------------------------------------------------------------------------------------------------------------------------------S--SS-----------------------------------------K------------
------------------------------------------------------------------------------------------------------------------------------------SSSSSSS-----------------------------------------------------
------------------------------------------------------------------------------------------------------------------------------------------------------------------------------------------------
--------------------------------SSSSSSSSSSSSSSSS----------------------------------------------------------------------------------------------------------------#---------------%---------------
--------------------------------SS-SSS-S-SSS-------------------------------------------------------------------------------------------SS---------------------------------------|---------------
--------------------------------S--SSSS---oo------------------------------------------------------o---------oooo-------------------oo--SSSS-------------------------------------|--------------%
--------%%%%%%%%----------------SSSSSSSSSSSSSSS--SSSSSSS---#-------------------o-------SS-------%%%--------------------------S--------------------------------------------------|--------------|
---------||||||--------------------------------------------#-------------------#-----------------|--------------------------S---------------So-------------------o--------------|-oo---o---o---|
---------||||||-------------------------------------------###------------------#-----------------|-------------------------------------------S----------------------------------|-----%%%-%%%--|
---------||||||-------------------ooo---------------------###--o--------------##---------------o-|------------------g##---------------------oS----g--g---------------------#----|------|---|---|
------%%%%%%%%%%----------######SSSS--------------------#####---------SS-----###--S--SS@S--------|-------%%%%----######-------------------------#######-------------------##----|------|---|---|
-------||||||||----------------------@-TT-----TT-------######----------------###-----------------|--------||-----#-------------------S----------TT-----------------------###----|------|---|---|
-------||||||||------------------------TT-----TT------#######---------------####-----------------|--------||-----#-SS-----U---------------------TT-----------------------###----|------|---|SS%|
-------||||||||----------------------k-TT-----TT-----########---------------####-----------------|--------||-----#-k------U-k---SS-k-k----------TT----------k-k---------####----|------|--rrrr||
XXXXXXXXXXXXXXXXXXXXXXXXXXXXXXXXXXXXXXXXXXXXXXXXXXXXXXXXXXXXXXX-XXXXXXXXXXXXXXXXXXXXXXXXXX---X-XX|-%%-%%%%XX---XXXXXXXX-XXX-XXXXXXXXXXXXX-XXXXXXXXXXXXXXXXXXXXXXXXXXXXXXXXXX---X|-----%%%%%%%%%%
XXXXXXXXXXXXXXXXXXXXXXXXXXXXXXXXXXXXXXXXXXXXXXXXXXXXXXXXXXXXXXXXXXXXXXXXXXXXXXXXXXXXXXXXX---XXXXX|-||--||-XX---XXXXXXXX-XXXXXXXXXXXXXXXXX-XXXXXXXXXXXXXXXXXXXXXXXXXXXXXXXXXX---X|------||||||||-
