---------------------------------------------------------------------------------------------------------------------------------------------------------------------SSSSSS---------------------
-------------------------------------------------K------------------------------------------------------------------------------------------------------------------SSSSSSS---------------------
-----------------------------------------------------------------------------------------------------------------------------------------------------------------------SS-----------------------
--------------------------------SSSS-SSSSSSSSSSS----------------------------------------------------------------#--------------------------SSSSS------------------------------------------------
----------------------------------------------------------------------------------------------------------------#-----------------------------------------------g------SS-----------------------
-----------------------------------------------S-------------------------------------------oo-------------------#--o---------ooo--------------------------------#Q-QQooSSSS-----------------o---
--------%%%%%%%%----------------SSooo-SSSSSSSSSS------------------------------------------%%%%-#----------------%%%%--------%%%%---------------------Q-Q----------------------------------------
---------||||||----------------------------------------------------------------------------||--#-----------------||----------||----------------#----------------------------------------------oo
---------||||||----------------------------------------------------------------------------||-##-----------------||----------||----------------#---------------------------------S----#---------
---------||||||-----------------oooo-o--------oo-------------------------------------------||-##----------ooo----||------oooo||o---------------#---------------------------ooS------------------
------%%%%%%%%%%----------######SSSSSSSS-----SSS-------------------------------#%%------%%-||###%-------%%%%%%%%-||-----%%%%%%S%-------------###------QQQ---SU---USoSS#S-------------S#---------
-------||||||||----------------------------------------------------------------#||------||-||###|--------||||||--||------||||-o|-------------###----------------S-------------------------------
-------||||||||--------------------------------#-------------------------------#||------||-|####|--------||||||--||------|||%%%%-----------#####----------------S-------------------------------
-------||||||||----------------------------g--##-------------oko-----g---g-----#||------||-|####|--------||||||--|rr----rr||-||------------#####---k--------k----------------------------------#
XXXXXXXXXXXXXXXXXXXXXXXXXXXXXXXXXXXXXXXXXXXXXXXXXXXXX-----XXXXXX--XXXXXXXXX---XX%%%%%--XXXXXXXXX|%%%%%%%-||||%%%%%%%%%%%%%%X-||-XXXXXXXXXXXXXXXXXXXXXXXXXXXXXXXXXXXXXXX------XXX-%%%%%%%%%X---XX
XXXXXXXXXXXXXXXXXXXXXXXXXXXXXXXXXXXXXXXXXXXXXXXXXXXXXX----XXXXXX--XXXXXXXXX---XX-|||----XXXXXXX-|-|||||--||||-||XX|||||XX|X--||-XXXXXXXXXXXXXXX-XXXXXXXXXXXXXXXXXXXXXXX------XXX--|||||||-----XX
