----------------------------------------------------------------------------------------------S-------S--------------SSSS--------------------------------------------------------------K--------
---------------------------------------------------------------------------------------------------------------------SSSSSS------------------------------------------------------------o--------
----------------------------------------------------------------------------------------------S------------------------S--------------------------------------------------------------%S--------
-----------------S---SS---SSSSSS--------------------------SSSSS---------------------------------SSSSSSSSSSSSSSSS----------------------------------------------------------------------|---------
------------------------------------------------------------------------------------------------S----S-S-S-SSS------------------------------------------------------------------------|---------
-----------------------------------------------------------------oo---------o--o----------------------S-SSSSSSS--Q-Q---S--@-----------------------------------------------------------|-------%%
--------%%%%%%%%---------------o--------------------------------%%%%-------%%---SooSSSSSSSSSSSSS----------SSSSS-------------------------------------------------------ooo-------%%----|-------||
---------||||||------------#-------------------------------------||--------||------------------------------------------o---------------------------------------------------y----||----|o------||
---------||||||-----------##-------------------------------------||--------||-----------------------------------------%----------------------------------------------------#----||----%%%-----||
---------||||||----------------o---------------------------------||------ooo|---oo-----g-------o---oooo-------oo------2--oooo--------------------------------------------#------||-----|-oo---||
------%%%%%%%%%%-------TT------S---------------------------------||-----%%%%%---SSSSS-SS-----S-S---SSS------------oo--|---S----------------------#----------------------####----%|-----|%%%%--||
-------||||||||--------TT----------------TT--------------TT------||------|||-----------S------------------------------|------------------TT----------------------------#####-#--||-----|-||--oo|
-------||||||||--------TT--#-------------TT--------------TT------||------|||---------------------------------------oo-|------------------TT------------------------#--######-#--||-----|-||-%%%%
-------||||||||-g------TT--k-k-----------TT---oo---k-----TT------||------|||--------------------g-------k---o---------|------o-------kgg-TT--------k--------kkk----#-######--#--||-rrrrr-||--||-
XXXXXXXXXXXXXXXXXXXXXXXXXXXXXXXX---XXX---XX-%%%%XXXXXXXX-XXXXXXX%%%%%-%%%%XX----XXXXXXXXXXXXXXXXXXXXXXXXXXXXXXXX---S%S|--S%--U--XXXXXXXXXXXXXXXXXXXXXXXXXXXXXXXXXXXX-XXXXXX-XXXX|%%%%%%%%%%%-||-
XXXXXXXXXXXXXXXXXXXXXXXXXXXXXXXX---XXX---X-X-||-XXXXXXXX-XXXXXXX-|||---||-XX----XXXXXXXXXXXXXXXXXXXXXXXXXXXX-XXX----|-|---|-----XXXXXXXXXXXXXXXXXXXXXXXXXXXXXXXXXXXXXXXXXX--XXXX|-|||||||||--||-
