---------------------------------------K--------------------------------------------------------------------------------------------------------------------------------------------------------
---------------------------------------o--------------------------------------------------------------S-----------------------------------------------------------------------------------------
--------------------------------------%%%-------------------------------------------------------------------------------------------------------------------------------------------------------
---------------------------------------|--------------------------------------------------------SSSSSSSSSSSSSSSSS-------------------------------SSSSSSSSSSSSSSSSSSSSSSSoooooSSSSSSSSSSSSSSSSSSSS
---------------------------------------|---------------o----------------------------------------------------------------------------------------------------------------------------------------
---------------------------------------|------o-------------------------------------------------------------------------------------------------------------------------------------------------
--------%%%%%%%%----------------K------|%%%%%%%%--------------o----------------------------------SS--SS------S--------------------------oS---------------------------------o--------------------
---------||||||-----------------o-o----|-||||||--------------------------------------------------------------------%%%%--------#---------------#------------------------------------------------
---------||||||-----------------%%%%---|-||||||---------------------------------------------------------------------||-----####---------------------------------------%%%-%%%-----------------S-
---------||||||------------------||----|-||||||-----------------------------------------------------------S---------||-----####----------------------------------------|---|--------------SS----
------%%%%%%%%%%----------######-||----|%%%%%||--ooo-----------------------------SS----TT-------SSSS----##----------||----####-----------------------------#-----------|---|------------##-#----
-------||||||||------------------||----|-|||-|oo---------------------------------------TT--------SSS--yS##----------||---#####-----------------#--TT-----###-----------|---|----------y###-#----
-------||||||||------------------||----|-|||-%%%------------------TT-------------------TT------------#####----------||--######-----------------#--TT----####-----------|---|---------#######----
-------||||||||------------------|rrr--|-|||--|-------------------TT------------g-gggg-TT-----------######----------||########----------------##--TT----####-------%%--|---|---------#######----
XXXXXXXXXXXXXXXXXXXXXXXXXXXXXXXX%%%%%%%%%%%%--|----%%%-------%%SXXXXXXXXXXXXX---XXXXXXXXXXXXXXXXXXXXXXXXXXXXXXXXXXXXXXXXXXXXX----%%%%--XXXXXXXXXXXXXXXXXXXXXXXXX---||XXX-X-X%%%XXXXXXXXXXXXX---X
XXXXXXXXXXXXXXXXXXXXXXXXXXXXXXXX-||||||||||---|-----|--------||-XXXXXXXXXXXXX---XXXXXXXXXXXXXXXXXXXXXXXXXXX-XXXXXXXXXXXXXXXXX-----||----XXXXXXXXXXXXXXXXXXXXXXXX---||XXX-X-X-|-XXXXXXXXXXX-----X
