--------------------------------------------------------------------------------------------------------------------------------------------------------------------------------
-----------------------------------------------------------------------------------------------------------K-K------------------------------------------------------------------
--------------------------------------------------------------------------------------------------------------Q-----------------------------------------------------------------
-------------------------------------------------------------S------------------------------------------------------------------ooSSSSSSSS-SSS----------------------------------
--------------------------------------------------------------------------------------------------------------------------------------------------------------------------------
-----------------------------oo----------------------------------------------------------------------------------------------------------------------------------------o--------
--------%%%%%%%%------U--------------U--o--o--@%--------------------------------------o-------SS----------------------------------------------------SQ----oS@QS-----------------
---------||||||------%%%-----------------------|---------------------------------SSSS-#----------------------------------------------------------------------------ooo----------
---------||||||-------|---------SSSSSSS-SSSS---|--------------------------------SSS--##----------------%------------------------------------------------------------------------
---------||||||-------|---------U----------K---|--ooS-------------------------------####---------------r---r------------------------------------------------------------------o-
------%%%%%%%%%%------|---------S---------SS---S---SS---------------------------#-#-###---------%%%%%%%%%%%%%%%---------------------------------oo-------SQQQQ--TT--------------
-------||||||||-------|--TT----------------S----------------TT--------------TT--#-#-####---------|||||||||||||--------------------------------------------------TT--------------
-------||||||||-------|--TT--------#--#--SS-----------------TT--------------TT--###-####-------#-|||||||||||||--------------------------------------------------TT--------------
-------||||||||-------|k-TT--------#--#-----------kk------k-TT---------k----TT--###-####-------#-|||||||||||||-----------------------------------y--------------TT--------------
XXXXXXXXXXXXXXXXXXXXXXXXXXXXXXXXX---XXXX----XX-XXXXXXXXXXXXXXXXXXXXXXXXXXXXXXXXXXXX-XXXX----XXXX%|%%%%%|||||||--XXXXXXXX--------XXXXX-----------XXXXXXXXXXXXXXXXXXXXXX---XXX----
XXXXXXXXXXXXXXXXXXXXXXXXXXXXXXXXX---XXXX----XX-XXXXXXXXXXXXXXXXXXXXXXXXXXXXXXXXXXXX-XXXX----XXXXgg-|gg-|g|||||--XXXXXXXX--------XXXXXXX--------XXXXXXXXXXXXXXXXXXXXXXX---XXX---X
