---------------------------------------------------------------------------------------K-------------------------------K------------------------------------------------------------------------
---------------------------------------------------------------------------------------o-------------------------------o------------------------------------------------------------------------
---------------------------------------------------------------------------------------%------------------------------%%%-------------------------------------------------SS--------------------
---------------------------------------------------------------------------------------|-------------SSS--------#------|----------------------------------------SSSSSSSSSSSS---------------SSSSS
---------------------------------------------------------------------------------------|------------------------K------|--------------------------------------------------S---------------------
----------------------------------------------------------------------------------o----|------oo-----------------------|-------%-----------------oo-----------------------o------oo-------------
--------%%%%%%%%-----------------------------S--------------------------oSS----S%%%%---|------%%----------------S------|--%%%%-|--%-------------%%%---------------SSSSSS------------------------
---------||||||------------------------------------------------oS----------------||----|---o--||------------------oro--|---||--|--|-----------%%-|----------------------------------------------
---------||||||--------------------------------------o---------------------------||---%%%-%%%-||----------S---TT%%%%%%-|---||--|--|-----------||-|----TT----------------------------------------
---------||||||--------------------------------o----%%%----------o---------------||----|---|--||---------##---TT-||||--|---r|--|--|-%%%%------||-|----TT----------------------------------------
------%%%%%%%%%%----------######----S---------SS-----|-----------S-S@SQSQ---S@S--||----|---|--||---------#----TT-||||--|%%%%%--|%%|--||-------||-|----##----------------------------------------
-------||||||||--------------------------------------|---------------------------||----|---|--||--TT----##----TT-||||--|-|||---||||--||-------||-|---------------------TT---------TT------------
-------||||||||--------------------------------------|---------------------------||----|---|-%%%--TT----###---TT-||||--|-|||%%%%|||--||-------||-|---------------------TT---------TT------------
-------||||||||----------------------------kk--------|---------#---r-------------||----|---|--|---TT----##----TT-||||--rrrr|-||-%%%%-||------g|g-|---------------------TT---------TT---------ooo
XXXXXXXXXXXXXXXXXXXXXXXXXXXXXXXXXXXXXXXXXXXXXXXX-%%%-|%XXXXX---XXXXXXXXXXXXXXXXX%%%%%-%|-XXX--|--XXXXXXXXXXXXXXX-%%%%%%%%%%%%||--||--|XXXXXXXXXXXXX------XXXXXXXXXXXXXXXXXXXXXXXXXXXXXXX-XXX-XXX
XXXXXXXXXXXXXXXXXXXXXXXXXXXXXXXXXXXXXXXXXXXXXXXX--|--||X-XXX---XXXXX-XXXXXXXXXXX-|||--||-XXX--|-XXXXXXXXXXXXXXXX--||||||||||-||-X||--|XXXXXXXXXXXXX------XXXXXXXXXXXXXXXXXXXXXXXXXXXXXXX-XXX-X-X
