-------------------------------------------------------K----------------------------------------------------------------------------------------------------------------------------------------
-------------------------------------------------------o----------------------------------------------------------------------------------------------------------------------------------------
------------------------------------------------------%%%---------------------------------------------------------------------------------------------------------------------------------------
-------------------------------------------------------|--------------------------------------------------------------------------------------------------------SSSSSSSSSSSS--------------------
-------------------------------------------------------|----------------------------------------------------------------------o-----------------------------------------------------------------
-------------------------------------------------------|----oo%%--o----------------------------------------------------------------------o------------------------------------------------------
--------%%%%%%%%--------------------QQQQQ-------S------|---%%%%|------------------------------------QQS--------o--SSQSSSSSSSSSS----------------------------%-----ooo----------o---o--SQSoS----@S
---------||||||---------------------------------o-o----|----||-|-------------------------------------------#-----------------------------------------------|---#-----------#--------------------
---------||||||---------------------------------%%%%---|----||-|-------------------------------------------##----------------------------------------------|--------------###SSS---------------S
---------||||||----------------------------------||----|-oooo|-|---------------------------------oo--------#-----------------------------------------------|-------------####------------------o
------%%%%%%%%%%----------######-####------------||----|%%%%%|-|-----S--TT--------------------------------##----Q---SS@QQSSSSSSS--TT-----------------------#------------#####-------------------
-------||||||||------------------###-------------||----|-|||-oo|TT------TT-------------------------------###----------------------TT----TT---TT------------#-----------#####--------------------
-------||||||||------------------###-------------||----|-|||%%%%TT------TT------------------------------####----------------------TT----TT---TT------------#---------########--S----------------
-------||||||||------------------##k-ko-----k----||r---rrrr|-||-TT---kk-TT--k---k-----------k------kggg#####-------k--------k-----TT----TT---TT---------------------#########--S----------------
XXXXXXXXXXXXXXXXXXXXXXXXXXXXXXXXXXXXXXXXXXXXXXXX-%%%%%%%%%%%-||-XXXXXXXXXXXXXXXXXXXXXXXXXXXXXXXXXXXXXXXXXXXXXXXXXXXXXXXXXXXXXXXXXXXXXXXXXXXXXXXX-%%%-X%%XXXX----XXXXXXXXXXXXXXXXXXXXXXXXXX--XXXX
XXXXXXXXXXXXXXXXXXXXXXXXXXXXXXXXXXXXXXXXXXXXXXXX--|||||||||--||-XXXXXXXXXXXXXXXXXXXXXXXXXXXXXXXXXXXXXXXXXXXXXXXXXXXXX-XXXXXXXXXXXXXXXXXXXXXXXXXX--|---XXXXXX----XXXXXXXXXXX---XXXXXXXXXXXX--XXXX
