---------------------------------------K-----------------------------------------------K--------------------------------------------------------------------------------------------------------
---------------------------------------o-----------------------------------------------o--------------------------------------------------------------------------------------------------------
--------------------------------------%%%---------------------------------------------%%%-------------------------------------------------------------------------------------------------------
---------------------------------------|-----------------------------------------------|-----------------------------------------------------------------------------------------SSSooooo------S
---------------------------------------|-----------------------------------------------|-------o---------------------------------------------------------------------------------------%--------
---------------------------------------|-----------------------------------------------|------%%---------------------------------------------------------------------------------------|--------
--------%%%%%%%%----------------%%%%%--|--%%-------------------------------------------|------||--------oS---S-------SSQQS-----o-----------------------------------------S-------------|--o-----
---------||||||------------------|||---|--||---#--------------------------------%%-----|------||-------------------------------#-------------------------------------------------------|--------
---------||||||------------------|||---|--||---#--------------------------------||-----|------||------------------------------#----------------------------------------------oo----%%%%%%%%%----
---------||||||------------------|||---|--||--##--------------------------------||-----|------||------------------------------#-----------------------------------------------------|||||||-----
------%%%%%%%%%%----------######-|||---|%%%|--##--------------------------------||-----|------||@SQQSS@SSSSSS@SS#-Q#---###---##---------##-----------2----------SS----------S@------|||||||-----
-------||||||||------------------|||---|-|-|--oo------------------------TT------||-----|------||-----------------------#-----##--------###--TTTT------------------------------------|||||||-----
-------||||||||------------------|||---|-|-|-%%%------------------TT----TT------||-----|------||---K---------------#--#-----###-------####--TTTT------------------------------------|||||||-----
-------||||||||------------------|||---|-|-|--##--gg-----------#--TT----TT------||-----|------ro---U------k--------#--#-#---####-----#####--TTTT--gggg----#----g---k--------k--k----|||||||---oo
XXXXXXXXXXXXXXXXXXXXXXXXXXXXXXXX%%%%%%-|XXXXX-X-XXXXXXXXXXXXXXXXXXXXXXXXXXXXXXXX||----%%%-%%%%%%XXXXXXXXXXXXXXXXXXXXXXXXXXX-XXXXXXXXXXXXXXXXXXXXXXXXXXXXXXXXXXXXXXXXXX----XXXXXX--XXXXXX|X|-%%%%
XXXXXXXXXXXXXXXXXXXXXXXXXXXXXXXX-||||--|XXXXX-XoXXXXXXXXXXXXXXXXXXXXXXXXXXXXXXXX||-----|---||||-XXXXXXXXXXXXXXXXXXXXXXXXXXX-XXXXXXXXXXXXXXXXXXXXXXXXXXXXXXXXXXXXXXXXXX----XXXXXX--XXXXXX|X|X-||-
