----------------------------------------------------------------------------------------------------------------------------------------------------------------
----------------------------------------------------------------------------------------------------------------------------------------------------------------
----------------------------------------------------------------------------------------------------------------------------------------------------------------
----SSSS--------------------------------------------------------------------------------------------------------------------------------------------------------
----------------------------------------------------------------------------------------------------------------------------------------------------------------
----------------------------------kk--gg---oooo--------%%%%-----------------------------------------------------------------------------------------------------
---------------------------------######-----------------||------------U-----------SQQSSSSS-------------------------------o-----------SS------S------------------
---------------------------------SSSSS------------------r|---------------------------------------------------S--------------------SSSS------SSS-----------------
----------------------%%%%-----------#------------%%%%%%%%-----------------------------------y------------------------------------SSSS-------------%%%%%%%%%----
-----------------------||-----------##-------------||||||--SSSS--------------------g--------y#----------------------------------SSSSSS--------------|||||||-----
-----%%----%%%---------||-------###-##---###-------||||||--------------So----------Q----1---####--------------------------------#-------------------|||||||-----
-----||-----|----------||-------###-##----------T--||||||----------------------------------#####---------------T------------------------------TT----|||||||-----
-----||-----|----------||--B----###-#T----------T--||||||---------------------------------######---------TT----T------------------------------TT----|||||||-----
-----||-----|----------||--b----#---###---------T--||||||---------g-----ggggg-g----------#######---------TT----T---g-g-k-------k------------k-TT----|||||||-----
%-%%%%%-%%%-|---XX-XXX-|XXXXXXX-XX--XXXXXX--XXXXXX-|||||%%------XXXXXXXXXXXXXXXXX---XXXXXXXXXXXXXXXXXXXXXXXXXXXXXXXXXXXXXXXXXXXXX---XXXXXXXXXXXXXXXXXXXXXXXXXXXX
g--|||---|--|---XX-XXX-|XXXXXXXXX---XXXXXXX-XXXXgX-|||||||------XXXXXXXXXXXXXXXX----XXXXXXXXXXXXXXXXXXXXXXXXXXXXXXXXXXXXXXXXXXXXX---XXXXXXXXXXXXXXXXXX-XXXXXXXX-
