-----------------------------------------------------------------------------------------------------------------------K------------------------------------------------------------------------
----------------------------------------------------------------------------------S-------------------------------------------------------------------------------------------------------------
------------------------------------------------------------------------------------------------------------------------------------------------------------------------------------------------
---------------------------------------------------------------------------------SSSSSSSSSSSSSSS-----------------S---------------------------------------------------------------SS-------------
------------------------------------------------------------------------------------------------------------------------------------------------------------------------------------------------
------------------------------------------------------------------------------------------------------------------------------------------------------------------------------------------------
--------%%%%%%%%-----SQS---------%-------------------QQS-------------------------------------o--------------------------------------------------------SSoo----------------SSSSSS---------SSS----
---------||||||---------------oo-|-----------------------------------------------------------------------------------------------o----------oo-------------------------------------%%%%---------
---------||||||------------------|--------------------------------------------------------------------------------------------------------------------------------------------------||----------
---------||||||------------------|-----------------------------------------------------------SSS------------------------------------------------------------------------------------||----------
------%%%%%%%%%%-S-----------#---|--------%SSooo-------USSSSSo---------------S-------------------#--------------------------------TT----TT--------------S------------S-------SSS----||tt--------
-------||||||||--------TT---##---|--------|------------------------------------------------------#--------------------------------TT----TT------------------------------------------||tt--------
-------||||||||--------TT---##---|--------|------------------------------------------------------#--------------------------------TT----TT---TT-------------------------------------||tt--------
-------||||||||------k-TT---##---|-----k--|----g------------------kk---k-----y-------------------#----------k-k----------------o--TT----TT---TT---------------------gg----k-k-------||tt-----g--
XXXXXXXXXXXXXXXXXXXXXXXXXXXXXXXXXXXXXXXXXXXXXXXXXXXXXXXXXXXXXX-XXXXXXXXXXXXXXXXXXXXXXXXXXX---X--XXXXXXXXXXXXXXXX----XXXXXXX-%%%%XXXXXXXXXXXXXXXXXXXXXXXXXXXXXXXXXXXXXXXXXXXXXXXXXXXXXXXXXXXXXXXX
XXXXXXXXXXXXXXXXXXXXXXXXXXXXXXXXXXXXXXXXXXXXXXXXXXXXXXXXXXXXXXXXXXXXXXXXXXXXXXXXXXXXXXXXXX------XXXXXXXXXXXXXXXX----XXXXXXX--||-XXXXXXXXXXXXXX--XXXXXXXXXXXXXXXXXXXXXXXXXXXXXXXXXXXXXXXXXXXXXXXX
