--------------------------------------------------------------------------------------------------------------------------------------------------------------------------------
-----------------------------------------------------------------------------------------------------------K-K------------------------------------------------------------------
--------------------------------------------------------------------------------------------------------------Q-----------------------------------------------------------------
-------------------------------------------------------------S------------------------------------------------------------------ooSSSSSSSS-SSS----------------------------------
--------------------------------------------------------------------------------------------------------------------------------------------------------------------------------
-----------------------------oo----------------------------------------------------------------------------------------------------------------------------------------o--------
--------%%%%%%%%------U--------------U--o--o--@%--------------------------------------o-------SS----------------------------------------------------SQ----oS@QS-----------------
---------||||||------%%%-----------------------|---------------------------------SSSS-#----------------------------------------------------------------------------ooo----------
---------||||||-------|---------SSSSSSS-SSSS---|--------------------------------SSS--##----------------%------------------------------------------------------------------------
---------||||||-------|---------U----------K---|--ooS-------------------------------####---------------r---r------------------------------------------------------------------o-
------%%%%%%%%%%------|---------S---------SS---S---SS---------------------------#-#-###---------%%%%%%%%%%%%%%%---------------------------------oo-------SQQQQ--TT--------------
-------||||||||-------|--TT----------------S----------------TT--------------TT--#-#-####---------|||||||||||||----T---------------------------------------------TT--------------
-------||||||||-------|--TT--------#--#--SS-----------------TT--------------TT--###-####-------#-|||||||||||||----T---------------------------------------------TT-------------T
-------||||||||-------|k-TT--------#--#-----------kk------k-TT---------k----TT--###-####-------#-|||||||||||||----T------------------------------y-------------gTT-------------T
XXXXXXXXXXXXXXXXXXXXXXXXXXXXXXXXX---XXXX----XX-XXXXXXXXXXXXXXXXXXXXXXXXXXXXXXXXXXXX-XXXX----XXXX%|%%%%%|||||||--XXXXXXXX--------XXXXX-----------XXXXXXXXXXXXXXXXXXXXXX---XXX---X
XXXXXXXXXXXXXXXXXXXXXXXXXXXXXXXXX---XXXX----XX-XXXXXXXXXXXXXXXXXXXXXXXXXXXXXXXXXXXX-XXXX----XXXXgg-|gg-|g|||||--XXXXXXXX--------XXXXXXX--------XXXXXXXXXXXXXXXXXXXXXXX---XXX---X
