---------------------------------------------------------------------------------------------------K--S-----------------------------------------------------------------------------------------
---------------------------------------------------------------------------------------------------o--------------------------------------------------------------------------------------------
--------------------------------------------------------------------------------------------------%%%%%-----------------------------------------------------------------------------------------
--------------------------------SSSSSSSS--SSSSSS---------------------------------------------------|||----------------------------------------------------------SSSSSSSSSS----------------------
-------------------------------2-------------------------------------------------------------------|||----------------------------------------------------------S-------------------------------
------------------o--------------------------------------------------------------------------------|||------------------------------------------------------------------------------------------
--------%%%%%%%%----------------%%%-------------S-SSSSSSSSSSSSSSSS-S-SSSoSSSSSSS-------------------|||---%%K------------S----------o------SSSSSS-----------------SSSSSSS-----SSS------S%SS------
---------||||||------------------|-------------#--------------------------------------------------o|||oo-||-----%%%%%%%-------------------------S#-------------------------------------|--------
---------||||||------------------|------------##-------------------------------------------------%%%|%%%%|%%%----|||||-----------------------------------------------------------------|--------
---------||||||------------------|------------##oo-----o--------ooo-------------------------------|-|-||-|-|-----|||||-----------------g------oo------------------ooo----------o-------|--------
------%%%%%%%%%%---------TT------|---------#-###SSSSSSSSSSSSS@SSSSSSQ--------SSS-------------U----|-|-||-|-|---#-|||||----------###SSSSS----SSSS-----------------SSSSS-----------------|--------
-------||||||||--TT------TT------|---------#-###--------------------------------------------------|-|-||-|-|---#-|||||----------#--------------------------------S---@K--TT------------|-------#
-------||||||||--TT------TT------|------#--#####--------------------------------------------------|-|-||-|-|---#-|||||---#-#----#------------------------K-------S------TT-------------|-------#
-------||||||||--TT----k-TT---gg%%------#--#####---k--gg--k-k------kgg-----kg--g----------k-------|-|-|r-|rr---#-|||||-###------#---------k-k------------#----g------kk-TT-------------|------##
XXXXXXXXXXXXXXXXXXXXXXXXXXXXXXXXXXX--XXXXXXXXXXXXXXXXXXXXXXXXXXXXXXXXXXXXXXXXXXXXXXXXXXXXXXXXXXX%%%%%%%%%%%%%%%--|XXXXXXXXXX-X-XXXXXXXXXXXXXXXXXXXXXXXXXXXXXXXXXXXXXXXXXXXXXXXXX--XXXXXXXXXXXXXX
XXXXXXXXXXXXXXXXXXXXXXXXXXXXXXXXX----XXXXXXXXXX-XXXXXXXXXXXXXXXXXXXXXXXXXXXXXXXXXXXXXXXXXXXXXXXX-|||||||||||||---|XXXXXXXXX--XXXXXXXXXXXXXXXXXXXXXXXXXXXXXXXXXXXXXXXXXXXXXXXXXXX--XXXXXXXXXXXXXX
