-----------------------------------------------------------------------K-------------------S----------------------------------------------------------------------------------------------------
-----------------------------------------------------------------------o------------------SS------------------------------------------------------S---------------------------------------------
----------------------------------------------------------------------%%%-----------------SS-SSo------------------------------------------------------------------------------------------------
--------------------------------SSSSSSSSSSSSSSSS-----------------------|--------SSS-------SSSSSS--------------------------------SSSSSSSSSS------SSSS-SS---S--S----------------------------------
-----------------------------------------------------------------------|--------SSS-------------------------------------------------------------------------------------------------------------
-----------------------------------------------------------------------|---------SSo------SooSSS--o---------o-----------------------------------------------------------------------------------
--------%%%%%%%%-----------#-------------------------------------------|--------SSSSSSSSSSSSSSSS-%---------%%------------------U------S----#---o----------SS---o--------------------------------
---------||||||------------#--------------------------------------%%%%%%---o-o-------------------|---------||------------------------------#-----------------------------------%----------------
---------||||||-----------###--------------------------------------||||---%%%%%------------------|---------||----------------oo-----------###----------------------------------|----------------
---------||||||--ok------####------------------o-------------------||||----|||----oooo--------oo-|-------ooo|-------------------ooo-------###----------------------------------|----------SS----
------%%%%%%%%%%---------###---------------------------------------||||--%%%||--SSSSSSSS-----SSS-|----#-%%%%%%---------------@S----------####----------------------------------|%%-------#------
-------||||||||---------####---o---------#---------------TT--------||||---|-||-------------------|-------||||---------------------------#####----------------------------------|||------##------
-------||||||||--------#####---#---------#---------------TT--------||||---|-|%%%-----------------|-------||||-------------------------#######----------------------------------|||-----####-----
-------||||||||-----g#######---#--------##-------gggggg--TT----g---||||---|-|-|--------k------#g-|-------||||------kok----k----------########--------k-k----------------k-----oo||----#####-----
XXXXXXXXXXXXXXXXXXXXXXXXXXX--XXX-XXXXXXXXX---%-XXXXXXXXXXXXXXXXX%--|||%%%-|-%%%-XXXXXXXXXXXXXXXX-%%%%%%%%%%||---XXXXXXXXXXXXXXXXXXXXXXXXXXXXXX-XXXXXXXXXXXXXXXXX-%XXXXXXXXXXX%%%||XXXXXXXXX--%%S
XXXXXXXXXXXXXXXXXXXXXXXXXXX-XXXXXXXXXXXXXX---|-XXXXXXXXXXXXXXXXX|--|||-X--|--|--XXXXXXXXXXXXXXXX--||||||||-||---XXXXXXXXXXXXXXXXXXXXXXXXXXXXX-XXXXXXXXXXXXXXXXXX-|--XXXXXXXX--|-||XXXXXXXXX--||-
