----------------------------------------------------------------------TT-----------------------------------------------K------------------------------------------------------------------------
----------------------------------------------------------------------TT-----------------------------------------------o----------------------------------SS------------------------------------
--------------------------------------------------------------------%%%%%---------------------------------------------%%%-----------------------------------------------------------------------
---------------------------------------------------------SSSSS-------|||-----------------------------------------------|-------------------------SSSSS-SSSSS------------------------------------
-------------------------o-------------------------------------------|||-----------------------------------------------|------------------------------------------------------------------------
---------------------------------------------------------------------|||--------------------ooo------------------------|----------o-------------------------------------------------------------
--------%%%%%%%%------SSoS-----o---------------o----------------%----|||--------SSSSSSSS--USSSS------------------------|---------%%------------------SS------S------------------------So--------
---------||||||-------------------------------------------------|-o--|||---o--------------------S---------------%%%----|-----%%%-||-------------------------------------------------------------
---------||||||--------------S----------------------------------%%%%-|||--%%%------------------------------------|-----|------|--||-------------------------------------------------------------
---------||||||-----------SSSU----k--------------------TT--------||--|||---|-----oo----o------oo-----------------|-----|------|--||-------------------------------------------------------------
------%%%%%%%%%%-S----------SS--####----##-#-#---------TT--##----||--|||---|----SSSSSSSSSSSSSSSS-----------------|-----|------|--||------TT--------SSSSS--------------------#----------#--------
-------||||||||-----------------####----##-###---------TT--#-----||--|||---|-ooo---------------------------------|-----|------|--||------TT-----------------------------------------------------
-------||||||||-----------------####----######---------TT--#-----||--|||---|%%%%---------------------------------|-----|----%%%%o||------TT-------------------------------#----#----------------
-------||||||||----k------------####----####-#-------####--#-----||rrrrrrro|-||--------k-------------------------|-----|-----||--||------TT---ooo-----kk------ko-------k--#----##-----k---------
XXXXXXXXXXXXXXXXXXXXXXXXXX--XXXXXXXXXXXXXXXXXXXXXXXXXXXXXXXXXXXX-%%%%%%%%%%%-||-XXXXXXXXXXXXXXXXXXXXXXXXXXXXXX%X-%%%--%%%X---||--||------XXX%%%%XXXXXXXXXXXXXXXXX%%-XXXXXXXXXXXXXXXXXXXXXXXXXXXX
XXXXXXXXXXXXXXXXXXXXXXXXXX--XXXXXXXXXXXXXXXXXXXXXXXXXXXXXXXXXXXX--|||||||||--||-XXXXXXXXXXXXXXXXXXXXXXXXX--X-X|X--|----X-X---||--||-------XX-||-XXXXXXXXXXXXXXXXX||-XXXXXXXXXXXXXXXXXXXXXXXXXXXX
