------------------------------------------------------------------------------------------------------------------------------------------------------------------------------------------------
------------------------------------------------------------------------------------------------------------------------------------------------------------------------------------------------
------------------------------------------------------------------------------------------------------------------------------------------------------------------------------------------------
--------------------------------------------------------------------------------SSSSSSSSSSSSSSSS#-----o-----------------------------------------------------------------------------------------
--------------------------------------------------------------------------------SSS-SSS--------------%%%%%----------------K---------------------------------------------------------------------
--------------------------------------------------------------------------------SSSSSSSS----SSoS------|||------%--------------------------------------------------------------------------------
--------%%%%%%%%---------------------------------SSS--SS-S---SSS----------------SSSSSSSS--SSSSSS------|||------|-----SSS--------------------------------%%%S-----So---S@oS-----------QQQ-------o
---------||||||----------------------------y---o------------------------------------------------------|o|------|----------------------oo-----------%%%%%-|--------------------------------------
---------||||||----------------------------###---------------------------------------------------%%%%%%%%-%%%--|------------------------------------|||--|--------------------------------------
---------||||||----------------------------###------------------So--------------ooooo-o-------oo--||||||---|---|-------g-------o-----------o--------|||--|-------------g-----o------------------
------%%%%%%%%%%--------------------------####--S------------SSoSSS-------------SSSSSS-------SSS--||||||---|---|----SSS#S----SSS---------%%%--------|||-%%%%%%%%------S##----S--####---------S--
-------||||||||------------------##----##-####----------------------------------------------------||||||---|---o--------------------------|---oo----|||--||||||-----------------####------------
-------||||||||------------------###---#######-------------------------------------------TT-------||||||---|-%%%--------------------------|--%%%----|||--||||||-----------------####------------
-------||||||||------------r----####---#######-----ggg---------g----------------y------k-TT-k--g--||||||---|--|-----------U--------r------|---|--ooo|||--||||||----#------------###k------------
XXXXXXXXXXXXXXXX--------%%%%%%%%XXXXXXXXXXXXXX--XXXXXXXXXXXXXXXXXX%X-XXXXXXXXXXXXXXXXXXXXXXXXXXX--||||%%%%%|--|-XXXXXXXXXXX-XXXX%%%%%%XXXXX---|-%%%%%%%-XXXX%||-XXXXXXXXXXX-XXXXXXXXXXXXXXXXXXXX
XXXXXXXXXXXXXXXX---------||||||XXXXXXXXXXXXXXXXXXXXXXXXXXXXXXXXXXXXX--XXXXXXXXXXXXXXXXXXXXXXXXXX--||||-|||-|--|-XXXXXXXXX-X-XXXXXXXX|XXXXXX---|--|||||--XXXX|||-XXXXXXXXXXX-XXXXXXXXXXXXXXXXXXXX
