------------------------------------------------------------------------------------------------------------------------------------------------------------------------------------------------
------------------------------------------------------------------------------------------------------------------------------------------------------------------------------------------------
--------------------------------------------------------------------------------------------------------------S---------------------------------------------------------------------------------
------------------------------------------------SSSSSSSSSSSSSSSS--------------------------------SSSSSSSS------SS-----------------------SSSSSSSSS---SSSSSSSSSSS----------------------------------
------------------------------------------------SSSSSSSSSSSSSSS---------------------------------SS--S-----S---S---------------------------------------------------------------------------------
------------------o-----------------------------SSSSSSSSSSSSSSSS-oo------------o----------------SSSSSSSS--SooSSS--------------------------------------------------o------------o----------------
--------%%%%%%%%---------------------SSS-------oSSSSSSSSSSSSSSSS-%%---------------o---%%%%------SSSSSSSSSSSSSSSS--o--------------So-----------------------------%%%%-------%%%----S@----oS-----o
---------||||||--------------------------------------------------||---------------%%---||-------S--------------------------o-------------------------------------||---------|-------------------
---------||||||--------------------------------------------#-----||---------------||---||------------------------------%--%%%------------------S-----------------||---------|----------------ooo
---------||||||--TT-----------------------------ooooo-----##---o-||----TT---------||---||-------S----------------------|---|-------------------oo---------#------||-------o-|-------------------
------%%%%%%%%%%-TT-----------------------------SSSSS---####---S-||--SoTT-------%-||---||-------S----------------------|---|----------SS-------S----------#-----%%|-----%%%%%%%%------------S@S-
-------||||||||--##----tt------------------------------#####-----||----TT-------|-||---||--------------------##-----o--|---|-----------------------------##-----|||------||||||-----------------
-------||||||||--##----tt-----------------------------########---||----TT---#---|-||---||--------------tt----##----%%%-|---K----------------------------###-----|||------||||||-----------------
-------||||||||--##----tt---kk---------------#---k----########--g||----TT--##---|-|%%%-||--------------tt--#####----|--|---rr-----SSS-----------------#####-----||oo-----||||||----k------------
XXXXXXXXXXXXXXXXXXXXXXXXXXXXXXXXXXXXXXXXXXXXXXXXXXXXXXXXXXXXXXXXXXXXXXXXXXXXXXXX|-|-|--XXXXX----XXXXXXXXXXXXXXXX----|-XX--%%%%%%XXXXXXXXXX--XXXXXXXXXXXXXXXXXXXX%%%%%-%%%XXX|%|--XXX----XXXXXXXX
XXXXXXXXXXXXXXXXXXXXXXXXXXXXXXXXXXXXXXXXXXXXXXXXXXXXXXXXXXXXXXXXXXXXXXXXXXXXXXXX|-|-|--XXX-X----XXXXXXXXXXXXXXXX----|-XX---||||-XXXXXXXXXX--XXXXXXXXXXXXXXXXXXXX-|||---|-XXX|||--XXX----XXXXXXXX
