---------------------------------------S---------------K-----------------------------------------------K----------------------------------------------------------------------------------------
-------------------------------------SSS---------------o-----------------------------------------------o----------------------------------------------------------------------------------------
---------------------------------------S---------------S----------------------------------------------%%%---------------------------------------------------------------------------------------
----------------------------------------------------------------SSSSSSSSSSSSSSSS-----------------------|----------------------------------------------------------------------------------------
----------------------------------------------------------------S-S----------S------------------%------|----------------------------------------------------------------------------------------
---------------------------oo-----------S-------------------------S---------SSSS----------------|------|------%%--------------------------------------------------------------------------------
--------%%%%%%%%---------------------S----------------------------SSSSSSSSSSSSSS----------------|------|------||-oo----------------------------------------------------%%%%---------------------
---------||||||---------------------------------------------------------------------------------|------|------||-----------------U--------------------------------oo-ooo||----------------------
---------||||||---------------------------------------------------------------------------------%%%%%%-|---K%-||---------------#----------------------------------------||----------------------
---------||||||----------------------------------------------------oo---------oo-----------------||||--|---o|-||---------------#----------------------------------------||-o--------------------
------%%%%%%%%%--------TT------------S%%SSSSSSS-%------------------SS---------S--------TT--------||||--|--%%|-||---------TT----#----------------------------------------||-%--------------------
-------|||||||--TT-----TT-------------||--------|-------------------------K------------TT----2---||||--|--|||-o|---------TT---##-TT-------------------tt----------------||-|--------------------
-------|||||||--TT-----TT---#---------||--------|--------------------------------------TT----#---||||--|--||%%%%---------TT---##-TT------TT-----------tt----------------||-|-------------#------
-------|||||||--TT---k-TT---#---------||--------|---------------y-------------go-gg----TT----#---||||--|--||-||------k---TT--###-TT------TT-k---------tt-----k----------||-|---r---------#------
XXXXXXXXXXXXXXXXXXXXXXXXXXXXXXXX--%%%%||------%-|---%%%---%%%%%%XXXXXXXXXXXXXXXXXXXXXXXXXXXXXXXX-|||%%%%%-||-%%%XXXXXXXXXXXXXXXXXXXXXXXXXXXXXXXXXXXXXXXXXXXXXXXX-%%%--%%|%%%%%%%XXXXXXXXXXX-XXXX
XXXXXXXXXXXXXXXXXXXXXXXXXXXXXXXX---||-||------|-|----|-----||||-XXXXXXXXXXXXXXXXXXXXXXXXXXXXXXXX-|||-|||--||--|-X-XXXXXXXXXXXXXXXXXXXXXXXXXXXXXXXXXXXXXXXXXXXXXX--|---|||-|||||-XXXXXXXXXXX-XXXX
