-----------------------------------------------------------------------------------------------------------------------------------------------------------------------K------------------------
-----------------------------------------------------------------------------------------------------------------------------------------------------------------------o------------------------
------------------------------------------------------------------------------------------------------------------------------------------------------------------------------------------------
------------------------------------------------SSS----------------------------SSSSSSSSSSSSSSSSS----------SSSSSSSSSSSS---SSSSS--------------------------------------------------SSSS-SSSSSSSSSSS
--------------------------------------------------------------------------------S---------------------------------------------------------------------------------------------------------------
------------------------------------------------------------------o---------------------------------------------------------------------------------------------o-o-----------%%----------------
--------%%%%%%%%------------------------------o-----------------%%%%-------o---------------#----%%%%----------------SSSS--SSS-SS---------------------------S----%%%-----------||----------------
---------||||||----------------------------#---------------K---%-||-----------------------##-----||----------------------------------------------------o---------|-----o------||----------------
---------||||||---------------------------##---S---------------|-||----------------------###-SSS-||---------------------------------------------------%%%-%%-----|----%%------||----------------
---------||||||---------------------------#--------------------|-||----%----------------####-----||-%%%%%o---------------------o-----------------------|--||-----|----||-ooo--||----------------
------%%%%%%%%%%----------######---------##--------------------|%%|----|--%%------------####----%||--|||-----------------------------------------------|--%%----%%%%--||%%%%--||----------------
-------||||||||-------------------------###--------------------||||----|--||----------y#####----|||--|||-----------------------------------------------|--||-----||---||-||--o||----------------
-------||||||||------------------------####------------TT------||||----|--||------#---######TT--|||--|||-------------------##------------TT------------|--||-----||---||-||-%%%|--TT----#-------
-------||||||||-----------------------#####------------TT----#-|%%%----|--||-----##--#######TT--%%%%-|||-----oro------g----##------------TT----#-------|rrr|-----||rrr|rr||--|-|k-TT----##------
XXXXXXXXXXXXXXXXXXXXXXXXXXXXXXXXXXXXXXXXXXX-XXXXXXX--XXXXXXXXXXX-|-----|%%%%%%%-XXXXXXXXXXXXXXXX-||--|||---XX%%%XXXXXXXXXXXXXXXXXXXXXXXXXXXXXXXX-%%%--%%%%%%%--X-%%%%%%%%%%%-|-|XXXXXXXXXXXXXXXX
XXXXXXXXXXXXXXXXXXXXXXXXXXXXXXXXXXXXXXXXXXX-XXXXXXX--XXXXXXXXXXX-|-----|-|||||--XXXXXXXXXXXXXXXX-||--|||---XXX|-XXXXXXXXXXXXXXXXXXXXXXXXXXXXXXXX--|----|||||--XX--|||||||||--|-|XXXXXXXXXXXXXXXX
