-----------------------------------------------------------------------------------------------------------------------------------------------------------------------K------------------------
-----------------------------------------------------------------------------------------------------------------------------------------------------------------------o------------------------
-----------------------------------------------------------------------------------------------------------------------------------------------------------------------%------------------------
----------------SSSS-SS-------------------------SSSSSSSS-SSS----------------------------------------------------SSSSSSSSSSSSSSS--------------------------SSSS--S-------|---------------SSSSSSSSS
-----------------------------------------------------------------------------------------------------%%%---------------------------------------------------------------|------------------------
-----------------------------------------------------------o--------------ooo-------------------------|--------%-------------------------------------------------------|------------------------
--------%%%%%%%%-----SSS----------------%%-----------------S--SS----------%%%----------S%S%-----------|--------|----------------------oSo-----o--oo-----------o-%------|--------SSSSSSS------So-
---------||||||-------------------------||---------------------#-----------|------------|-|-----------|o---o---|-------------------------------------------#----|------|------------------------
---------||||||----------------S--------||-----------------#####-----------|------------|-|-----------%%%-%%%--|--------------o--------------SS-----------##--S-|------|------------------------
---------||||||-----------#-------------||oo-----o---------#####-----------|------------|-|------------|---|---o--------------t----------SSSSSS----------##----o|------|-oooo---o-ooo----------o
------%%%%%%%%%%---------##-------------|%%%-----------########----------%%%%-----------%%%%%%---------|---%--S%---------#----TT--##----##-S-S----------###-----%------|%%%%%%--SSSSS----------S
-------||||||||----S-----##-------------|-|------------#######------------||---o---------||||-oo-------|---|---|---------#----TT--##----#--S-----------####-----|------|-||||-----------###-----
-------||||||||---------###-------------|-|-%%%%------#########-----------||---#---------||||%%%-------|---|-%%%-------###----TT#####------S-K--------#####--U--|------|-||||----------####-----
-------||||||||-------#####--------r----|-|--||------##########-----------||---o---rr----||||-|--------|rrr|--|------#####----TT#####-k----S-k-------######--#--|--r---|-||||---------####------
XXXXXXXXXXXXXXXXXXXXXXXXXXX--XXX%%%%%%%%%%%%-||-XXXXXXXXXXXXXXX-%%%%%X%%%%X|---X%%%%%%%%%%%%|-|--%%%%-%%%%%%%-|-XXXXXXXXXXXXXXXXXXXXXXXXXX--XXXXXXXXXXXXXX---XXX|%%%%%%%%|%%%%%%XXXXXXXXXX---XXX
XXXXXXXXXXXXXXXXXXXXXXXXXXX--XXX-||||||||||--||-XXXXXXXXXXXXXXX--|||---||-X|-----||||||||||-|-|---||---|||||--|-XXXXXXXXXXXXXXXXXXXXXXXXXX--XXXXXXXXXXXXXX---XXX|-||||||-|-||||-XXXXXXXXXX---XXX
