---------------------------------------------------------------------K-S---------------------------------------------------------------------------------------------------------------K--------
---------------------------------------------------------------------o-o---------------------------------------------------------------------------------------------------------------o--------
--------------------------------------------------------------------%%%----------------------------------------------------------------------------------------------------------------%%-------
---------------------------------------------------------------------|----------SSSSSSS------------------------------------------------------------------------------------------------||-------
--------------------------------------------------o------------------|-----------------------------------------------------------------------------------------------------------------||-------
---------------------------------------------------------------------|--------oo-------------------------------------------------------------------------------------------------------||-----%-
--------%%%%%%%%--------------------------------%%---------K----%----|-----K-%%%------------------------------------------------ooo---SSSS---SS----------------------------------------||-----|-
---------||||||---------------------------------||--------------|----|-o---o--|------------#-------------------------------------------------------------------------------------------||-----|-
---------||||||--------------------------------#||--------------|----|%%%-%%%-|------------#-------------------------------------------------------------------------------------------||-----|-
---------||||||------------------o------------##||--------------|----|-|---|--|-----------##-------------------------------------------k-----------------------------------------------||oooo-|-
------%%%%%%%%%%----------######---------TT---##||--------%%%---|----|-|---|--|----------###-----TT------------------------------------SSS---SS------------------------TT--------------|%%%%%-|-
-------||||||||--------------------------TT-####||---------|----|----|-|---|--|---------####-----TT-----TT----TT---------------------------------TT--------------##----TT--------------|-|||-oo-
-------||||||||--------------------------TT-###-||---------|----|----|-|---|-%%%------######-----TT-----TT----TT---------------------------------TT--------------##----TT--------------|-|||%%%%
-------||||||||-------------------gggg---TT-####||---------|----|----|-rr--|--|------#######-----TT-----TT----TT---------------------------------TT--------------##----TT---kk-----rr--|-|||-||-
XXXXXXXXXXXXXXXXXXXXXXXXXXXXXXXXXXXXXXXXXXXXXXXX||%%%%%%%%%%%%%-%%%%%%%%%%XX--|-XXXXXXXXXXXXX--XXXXXXXXXXXXXXXXXXXXXXXXXXXXXXXXX-XXXXXXXXXXXXXXXXXXXXXXXXXXXXXXXXXXXXXXXXXXXXXXX-%%%%%%%%%%%-%%%
XXXXXXXXXXXXXXXXXXXXXXXXXXXXXXXXXXXXXXXXXXXXXXX-||-|||||||||||---||||||||-XX--|-XXXXXXXXXXXXX-XXXXXXXXXXXXXXXXXXXXXXXXXXXXXXXXXX-XXXXXXXXXX-XXXXXXXXXXXXXXXXXXXXXXXXXXXXXXXXXXXX--|||||||||---|-
