----------------------------------------------S-------------------------------------------------------------------------------------------------------------------------------------------------
----------------------------------------------S-------------------------------------------------------------------------------------------------------------------------------------------------
----------------------------------------------S-------------------------------------------------------------------------------------------------------------------------------------------------
--------------------------------SSSS---------------------------S--------oo------------------------------------------------------SSSS------SS----------------------------------------------------
----------------------------------S----------------------------------%%%%%%---------------------------------------------------------------------------------------------------------------------
--------------------------------SSS---------oo------------------------||||---------------------------------------------------------------------------------------ooo------------Q---------------
--------%%%%%%%%----------------S-SS-SS---SSSSSS----------------------||||--------------------------------------%----------------o---------#----------------------------------------QQQQ--------
---------||||||----------------------------------------------%%%-or---ro||ooor----------------------------------|--------------------------------oo--------o------------------------------------
---------||||||-----------------------------------------------|-%%%%%%%%%%%%%%%---------------------------------|-------------------------#-----------------------------------------------------
---------||||||-----------------o--o----------oo--------------|--|||||||||||||-------------o--------------------|---------r--------------##-------------------------------o---------------------
------%%%%%%%%%%----------######S--SS--------SSS%----------#--|--|||||||||||||---K----##------------------------|--------%%%%-----------##---------------------------------------------------U--
-------||||||||---------------------------------|----------#--|--|||||||||||||---U----------------TT------------|---------||---o--------##--------TT-----#--------------------------------------
-------||||||||---------------------------------|-------##-#--|--||||||||||||%%%-#----------------TT------------|---------||---------#####--------TT----##--------o-----------------------------
-------||||||||-----------------y-----------k---|-------##----|--|||||||||r||-|--##---------k-----TT---------ooo|---------||--------######--------TT---###------------------------gk------k-k---
XXXXXXXXXXXXXXXXXXXXXXXXXXXXXXXXXXXXXXXXXXXXXXXX|-----XXXX--%%%%-|||||%%%%%%|%%%XXXXXXXXXXXXXXXX--XXXXXXXXX--%%%|%%%%%%%%%%%%%%%XXXXXXXXXXX-XXXX-XXXXXXXXX---%%%ooXXXXXX-X---%%-XXXXXXXXXXXXXXXX
XXXXXXXXXXXXXXXXXXXXXXXXXXXXXXXXXXXXXXXXXXXXXXXX|-----XXXX---||--|||||-||||-|-|-XXXXXXXXXXXXXXXX--XXXXXXXXX---|-|-|||||||||||||-XXXXXXXXXXXXXXXX-XXXXXXXXX----|---XXXXXX-----||-XXXXXXXXXXXXXXXX
