-------------------------------------------------------------------------------------------------------K----------------------------------------------------------------------------------------
-------------------------------------------------------------------------------------------------------o----------------------------------------------------------------------------------------
------------------------------------------------------------------------------------------------------%%%---------------------------------------------------------------------------------------
-------------------------------------------------------------------------------------------------------|--------------------------------------------------------SS--------------SSSS------------
-----------------------------------------------------------------------------------------------K-------|-------o--------------------------------------------------------------------------------
-------------------------------------------------------------------------oo----------------------------|------%%--------------------------------------------------------------------------------
--------%%%%%%%%----------------Soo-------------------------------------------------------------%%S----|------||-o----------------%--------------------------------------------------------S----
---------||||||-----------------------------------------------------------ko-ooo----------------||o-o-oo------||-----------o------|-------------------------------------------------------------
---------||||||---------------------------------------------------------------------oo----------|%%%%%%%%-----||----------%%------|----TT-------------------------------------------------------
---------||||||---------------------------------------------------------##----------------------|-||||||--oooooo----------||------|----TT----------------SSSS-------------SS-SS-----------------
------%%%%%%%%%%----------######SSS---------------SSSSS--TT------------###----------##----------%%||||||-%%%%%%%----------||-S----|----##----S--------------------------------------------------
-------||||||||---------------------------------SSSS-----TT------------###---#-----------TT-----||||||||--|||||-----------||------|-----------------------------#---------------------tt--------
-------||||||||------------------------------------------TT-------TT--####---#-----------TT-----||||||||--|||%%%----------||------|-----------------------------#------###---U--------tt--------
-------||||||||--------------------------------------kk--TT---##--TT--###----k-----------TT-----|||||||r--r||-|-----------||------|--------k-------k-----g---gg##-#---##---k-k--------tt-----kg#
XXXXXXXXXXXXXXXXXXXXXXXXXXXXXXXXXXXXXXXXXX--XXXXXXXXXXXXXXXXXXXXXXXXXXXXXX-XXXXXXXXXXXXXXXXXXXXX|%%%%%%%%%%%|-|-------%%%-||----XX%%--XXXXXXXXXXXXXXXXXXXXXXXXXXXXXXXXXXXXXXXXXXXXXXXXXXXXXXXXXX
XXXXXXXXXXXXXXXXXXXXXXXXXXXXXXXXXXXXXXXXXX--XXXXXXXXXXXXXXXXXXXXXXXXXXXXXX-XXXXXXXXXXXXXXXXXXXXX|-|||||||||-|-|--------|--||----XXX|---XXXXXXXXXXXXXXXXXXXXXXXXXXXXXXXXXXXXXXXXXXXXXXXXXXXXXXXXX
