--------------------------------------------------------------------------------------------------------------------------------------------------------------------------------
--------------------------------------------------------------------------------------------------------------------------------------------------------------------------------
--------------------------------------------------------------------------------------------------------------------------------tt----------------------------------------------
----------------SSSSSSSSSSSSSSSS---------------------------------------------------SSSSSSSSS------------------------------------tt----------------------------------------------
-----------------SSSSSS---S---S-------------------------------------------------------------------------------------------------tt----------------------------------------------
-------------------SSSSS--S---S-------------------------------------------------------------------------------------------------##----------------------------------------------
--------%%%%%%%%-----------K-S--------------------------------------------------------------oS--------------------Q----------------------------o--------------------------------
---------||||||---KS--oo------------------------------------------------ooo-----------------S-----------------------------------------------------------r-----------------o-----
---------||||||---SS--S-----------%%%----------------------------------------------------------------------------------%%------------------------%%--%%%%%%%--------------------
---------||||||---SS---------SrS---|-------------------------------------------------------------------------------r---||------------------------||---|||||---2-----------------
------%%%%%%%%%%S---SS------%%%%---|----------------------------------------------------------------------------%%%%%--|%%------QQQ--tt----tt---%%%%--|||||---------------------
-------||||||||--------------||----|---TT---------------------------------------TT--------------TT---------------|||---|||-----------tt----tt----||---|||||---------------------
-------||||||||-----------%--||----|---TT--tt-----------------------------------TT--------------TT----tt---------|||---|||-----------tt----tt----||---|||||--#---------TT-------
-------||||||||-----------|--||----|---TT--tt--------y--------------------------TT--------------TT----tt------g--|||---|||-------g---tt----tt-g--||---|||||------------TT-------
XXXXXXXXXXXXXXXX%-%%%%%%%%%%-||-XXXXXX-XXXXXXXXXXXXXXXXXXXXXXXXXXXXXXX--XXXXXXXXXX--------X----XXXXXXXXXXXXX--X--|||---|XXXX----XXXXXXXXXXXXXXXX%%%%%-|||||-----XXXXXXXXXXXXXXXX
XXXXXXXXXXXXXXXXg--||||||||--||-XXXXXX-XXXXXXXXXXXXXXXXXXXXXXXXXXXXXXX-XXXXXXXXXXX--------X----XXXXXXXXXXXXX--X--|||---|XXXX----XXXXXXXXXXXXXXXXg||g--|||||-----XXXXXXXXXXXXXXXX
