----------------------------------------------------------S----------------------------------------------------------------------------K--------------------------------------------------------
---------------------------------------------------------SS----------------------------------------------------------------------------o--------------------------------------------------------
----------------------------------------------------------S---------------------------------------------------------------------------%%--------------------------------------------------------
------------------------------------------------SSSS---SSSSSSSSS----------------------SS------------------------#---------------------||------------------------SSSSSSSSS--SSSSS----------------
-------------------------------------------------------------SSS----------------------------------------------------------------------||-------S------------------------------------------------
-------------------------------------------------------------SSS----------------------------------------------------------------------||------%%o-oo--------------------------------------------
--------%%%%%%%%---------------------------------------------S----------------o-------------------------------------------------------||------||-----------------------------------------------o
---------||||||--------------------------------------------------------------------------------------------------or----orrro----------||---o--||------------------------------------------------
---------||||||----------------------------------------------------------------S--------------------------------%%%%%%%%%%%%%---------||---K%-||----------------------------%-------------#-----
---------||||||-------------------------------------gg---------o---------------o---------------------------------|||||||||||----------||---o|-||----------------------------|------------##S----
------%%%%%%%%%%----------######-------------------S##S------------------------------------------SS--------------|||||||||||----%-----||--%%%-||--TT------------------------|-----------###-----
-------||||||||---------------------------------TT-------TT----------------------TT------------------------------|||||||||||---#|-----||---|--oo--TT------------o-----------|---------y####-----
-------||||||||---------------------------------TT-------TT----------------------TT------------------------------|||||||||||---#|-----||---|-%%%--TT------------%-----------|---------#####--#--
-------||||||||------------------------------g--TT-------TT----------------------TT-------------------k----------||||||||rr|---#|-----||---|--|---TT--------k---|-----------|ggg----#######--#--
XXXXXXXXXXXXXXXXXXXXXXXXXXXXXXXXXXXXXXXXXXXXXXXXXX--XXXXXXXXXXXXXXXXXXXXXXXXXXXXXXXXXXXXXXXXXXXXXXXXXXXXXXXXXXXX-||||X%%%%%%----|---%%%%%--|-%%%XXXXXXXXXXXXXXXX|XX-XXXXXXXXXXXXXXXXXXXXXXXXXXXX
XXXXXXXXXXXXXXXXXXXXXXXXXXXXXXXXXXXXXXXXXXXXXXXXXXXXXXXXXXXXXXXXXXXXXXXXXXXXXXXXXXXXXXXXXXXXXXXXXXXXXXXXXXXXXXXX-||||--X|X|X----|----|||---|--|-XXXXXXXXXXXXXXXXXXX-XXXXXXXXXXXXXXXXXXXXXXX-XXXX
