------------------------------------------------------------------------------------------------------------------------------------------------------------------------------------------------
------------------------------------------------------------------------------------------------------------------------------------------------------------------------------------------------
-------------------------------------------------------------------------------------------------#----------------------------------------------------------------------------------------------
-------------------------------------------------------------------------------------------------#--------------------------------------------------------------SSSSSSSSSSSSSSSS----------------
------------------------------------------------------------------------------------------------------------------------------------------------------------------------------------------------
--------------------------------------------------------ooo-------------------------------------------------------------------------------------------------------------------------------------
--------%%%%%%%%---------------------------------------------------SQQSSQS------------------------o-----o------o---------------------------------------------S------------------------SS--------
---------||||||---------------------------------------------------------------------------------------------------------------------------------------------------------------------------------
---------||||||---------------------------------------------------------------------------------------------------------------------------------------------------------------------------------
---------||||||---------------------------------------------------------------------------------oo----------#----TT--------------------------------------------------------------------U--------
------%%%%%%%%%%----##------------------------#----------TT----------S@QSSSSS@S-----------------------------##---TT----TT---#----TTSSSS------Q-----SSo---------------#------------------SS------
-------||||||||---------------------------#---##---------TT------------------------------#----------------###----TT----TT---#----TT-------------------------------------------------------------
-------||||||||---------------------------#---##---------TT-----------------------------##---------------#####---TT----TT---#----TT--------------------------------------U----------------------
-------||||||||-------k----kkkk-----------#---##---------TT-------ok--------------------##---------k-k--######---TT----TT--##----TT-------k-k-------------U-----g-#---k--#----g-----------------
XXXXXXXXXXXXXXXXXXXXXXXXXXXXXXXX-%%--X-XXXXXXXXXXXXXXXXXXXXXXXXXXXXXXXXXXXXXXXXXXXXXXXXXXXX-XXXXXXXXXXXXXXXXXXXXXXXXXXXXXXXXXXXXXXXXXXXXXXXXXXXXXXXXXXXXXXX-XXXXXXXXXXXXXXXXXXXXXXXXXXXXXXX----X
XXXXXXXXXXXXXXXXXXXXXXXXXXXXXXXX-||--X-XXXXXXXXXXXXXXXXXXXXXXXXXXXXXXXXXXXXXXXXXXXXXXXXXXXX-XXXXXXXXXXXXXXXXXXXXXXXXXXXXXXXXXXXXXXXXXXXXXXXXXXXXXXXXXXXXXXXXXXXXXXXXXXXXXXXXXXXXXXXXXXXXXXX--XXX
