---------------------------------------------------------------------------------------------------------------------------------------K-----------------------------SSSSS----------------------
-------------------------------------------------------------------------------------------------K-------------------------------------o----------------------------SSSSSSS---------------------
--------------------------------------------------------------------------------------------------------------------------------------%%-------------------------------S------------------------
--------------------------------SSSSSSSS--------SSSSSSSSSSSSSSSS----------------SSSSSSSSSSS-------------------------------------------||---------------------------------------S----------------
------------------------------------------------SS---SS-------------------------------------------------------------------------------||------------------------g------SS-----------------------
------------------------------------------------SS-------------S----------------------------------------------------------------------||------------------------#Q-oQo-SSo----------------------
--------%%%%%%%%-%%%------------oooo---SS-----oo--------oo---SSS------------------oo----oo---o----------------------------------------||--------SSSSSSSS-----SS---------------------------------
---------||||||---|--------------%%%------------------------------------------------------------So--------#yo-------------------------||---r---------------------------------------------------#
---------||||||---|---------------|--------#--S-------SSSSSS-SSS-----------------------------SSS---------o#---------------------%%%%%%%%%%%%%--------------------------------------------------#
---------||||||---|--%------------|--------#-------o-oo-----oSoS----------------------------------TT-----##----@-----------------|||||||||||----o-oo------------------------SS----------------##
------%%%%%%%%%%--|--|------------|------###----SSSS--S-----SSSS----------------S--------------S--TT----TT-----T-----------------|||||||||||----SSSSSS---S-------U----US----------------------##
-------||||||||---|--|------------|------###---------------------------------------------#--------TT----TT-----T-----------------|||||||||||------------##-------S-----------------------TT---##
-------||||||||---|--|------------|-tt-#####-#-#----------------------------------------####------TT--####---TT-----------#------|||||||||||-----------###-------------------------------TT---##
-------||||||||---|--|-k-----kkg--|-tt######-###-----------g------gy--------k-------########------TT--####---TT----k-------------|o|||||||||--r------gg###------S------------------gg----TT---##
XXXXXXXXXXXXXXXXX-|-XXXXXXXXXXXXXXXXXXXXXXXXXXXXX----XXXXXXXXXXXXXXXXXXXXXXXXXXXXXXXXXXXXXXXXXXX-XXXXXXXXXX-XXXX--XXXXXXXXXXXXX--%%%||%%%|||%%%%XXXXXXXXXXX-XXXXXXXXX-K--------XXXXXXXXXXXXXXXXX
XXXXXXXXXXXXXXXXX-|-XXXXXXXXXXXXXXXXXXXXXXXXXXXX-----XXXXXXXXXXXXXXXXXXXXXXXXXXXXXXXXXXXXXXXXXXXXXXXXXXXXXX-XXXX--XXXXXXXXXXXXXX--|-||-|-|||-||-XXXXXXXXXXX-XXXXXXXXX-X------X-XXXXXXXXXXXXXXXXX
