-------------------------------------------------------K------------------------------k----------------K---------------------------------------------K-S----------------------------------------
-------------------------------------------------------------------------------------------------------o-----------------------------------------------o----------------------------------------
-------------------------------------------------------------------------------------------------------%--------------------------------------------%%%%%---------------------------------------
--------------------------------------------------------------------------------SSSSSSSS---------------|---------------------------------------------|||----------------------------------------
-------------------------------------------------------------------------------------------------------|---------------------------------------------|||----------------------------------------
-------------------------------------------------------------------------------------------------------|---------------------------------------------|||----------------------------------------
--------%%%%%%%%--------------------QQQQQS-----o------%%%%%%%%-------oSS-------------------------------|--------S----SS------------------------------|||--%%%----------%%%--%%%-------SSS-------
---------||||||----------------------------------------||||||------------------------------------------|---o-------------------------------------%%%-|||---|------------|----|--------oo---o----
---------||||||----------------------------------------||||||---------------------------------S----%%%%%%-%%%-------------------------------------|--|||---|------------|----|------------------
---------||||||----------------------------------------||||||---------------------------------------||||---|--------------------------------------|--|||---|------------|----|------------------
------%%%%%%%%%%----------######-##---------SQS--------%%%%%%%%%------------------------------------||||---|-------S-------------------------o--%%|--|||---|------------|----|------------------
-------||||||||------------------##---------------------|||||||-------------------------------------||||---|-----------TT---TT---------TT---##--|||--|||---|------------|----|----------#-------
-------||||||||-----------------------------------------|||||||-------------------------------------||||---|-----------TT---TT---------TT---##--|||--|||---|------------|----|---------##-------
-------||||||||-------------------kkgg------------------|||||||------##-----k-----k----k----kk------|||rrrrr-r-------k-TT---TT--g-g--k-TT-------|||--|||---|---o--------|----|--------##--------
XXXXXXXXXXXXXXXXXXXXXXXXXXXXXXXXXXXXXXXXXXXXXXXX-%%%%%%%%XX||||-XXXXXXXXXXXXXXXXXXXXXXXXXXXXXXXX-%%%%%%%%%%%%%%%XXXXXXXXXXXXXXXXXXXXXXXXXXXXXXXX|||--|||--%%%%%%%%%%-X--XX---%--XXXXXXXXXXXXXXXX
XXXXXXXXXXXXXXXXXXXXXXXXXXXXXXXXXXXXXXXXXXXXXXXX--||||||-XX||||-XXXXXXXXXXXXXXXXXXXXXXXXXXXXXXXX--|||||||||||||-XXXXXXXXXXXXXXXXXXXXXXXXXXXXXXXX|||--|||---||||||||-----XX---|--XXXXXXXXXXXXXXXX
