------------------------------------------------------------------------------------------------------------------------------------------------------------------------------------------------
------------------------------------------------------------------------------------------------------------------------------------------------------------------------------------------------
------------------------------------------------------------------------------------------------------------------------------------------------------------------------------------------------
--------------------------------SSSSSSSS----SSSS------------------------------------------------------------------------------------------------SSSSSSSSSSSS-------------------o----------------
------------------------------------------------------------------------------------------------------------------------------------------------------------------------------------------------
--------------------------------------------------------------------------------------------------o---------------------------------------------------------------------------------------------
--------%%%%%%%%------------------------------------------------------S%S-----------SSS----------%%-----------------------SS---------2------------o---------------------------------------------
---------||||||---------------------------------S----------------------o-------------------------||---------------------------------------------------------------------------------------------
---------||||||--------------------------------------------------------|-----SS------------------||---------------------------------------------------------------------------------------------
---------||||||--------------------------------------------------------|--SSSSSS-----------------||-----------------------------------------------------------------------S---------------------
------%%%%%%%%%%----------######---------------------------------------|---------------------SSo-||----tt----------------%%%SoKo-------------------SSo----------%------------------------%%%----
-------||||||||--------------------------#-----------------------------|-------------------------||----tt-----------------|--------------------@---------TT-----|--------#----------------|-----
-------||||||||-------------------TT---###---K-------------------------|---K---------------------||----tt-----------------|------------------------------TT-----|-------##----------------|--K--
-------||||||||-------------------TT--####---#-------------------------|---S---------gk--------g-||----tt----g-g--g-gg----|-----------gy--#----#-----kkk-TT---k-|-------##----------------|-----
XXXXXXXXXXXXXXXXXXXXXXXXXXXXXXXXXXXXX-XXXXXXXXXXXXXXXXXXXXXXXXXX--XX--XX---S%S--XXXXXXXXXXXXXXXXXXXXXXXXXXXXXXXXXXXXXXXXXXXXXXXXXXXXXXXXXXXXXXXXXXXXXXXXXXXXXXXX|------XXX%%%%%%X%%%-XXXX-|-----
XXXXXXXXXXXXXXXXXXXXXXXXXXXXXXXXXXXXXXXXXXXX-XXXXXXXXXXXXXXXXXXX--XX--XX----|--XXXXXXXXXXXXXXXXXXXXXXXXXXXXXXXXXXXXXXXXXXXXXXXX-XXXXXXXXXXXXXXXXXXXXXXXXXXXXXXXX|------X---||||-XXXX-XXXX-|-----
