---------------------------------------------------------------------------------------K--------------------------------------------------------------------------------------------------------
---------------------------------------------------------------------------------------o--------------------------------------------------------------------------------------------------------
--------------------------------------------------------------------------------------%%%------------------------------------------------------------S%-----------------------------------------
--------------------------------SSSSSSSSSSSSSSSS---------------------------------------|--------------------------------------------------------SSS---|---------SSS-----------------------------
---------------------------------------------------------------------------------------|--------------------------------------------------------------|-----------------------------------------
--------------------------------------------------------------oo-----------------------|------%%------------------------------------------------------|-----------------------------------------
--------%%%%%%%%SSS@--SS---------%%%------------%%%%------%%%%%%SSS@---------SSS%------|------||--------------------------------------------------r-r-|-%%--------------------------------------
---------||||||-------------------|--------------||--------||||-----------------|------|------||---------------------------------o--------#------%%%%%%%||--%%%%--------------------------------
---------||||||---------------o---|--------------||--------||||-----------------|------|------||------------------------------------------##------|||||-||---||-S-------------------------------
---------||||||-------------------|--------------||----oooo||||------------o----|------|-oooo-||---------------#-------------------------###--TT--|||||-||---||---------------------------------
------%%%%%%%%%%-------------US---|--------------||---%%%%%%%%%%SSQQ-----%%%SSSS|------|%%%%%-||----------------------------------------###---TT--|||||-||---||----------------#%%--------------
-------||||||||-------------------|--------------||----||||||||-----------|-----|------|-|||-oo|---------------#-------K---------------####---TT--|||||-||---||----------------#||--------------
-------||||||||-------------------|--------------||----||||||||-----------|-----|------|-|||%%%%-------------###----------------------#####---TT%%|||||-||-K-||---------TT----##||--------------
-------||||||||-----------k-k---%%%-----------gg-|or---||||||||-----------|-----|--rrr-rr|||-||---------------##---k--------k------k-######---TT|||||||-||-o-||-#-------TT----##||-------------r
XXXXXXXXXXXXXXXXXXXXXXXXXXXXXXXXXXXXXXXXXXXXXXXX%%%%%%%%%XXXXX|X--XXXXXXXXX--XXX|%%%%%%%%%%%-||----XXXXXXXXXXXX-XXXXXXXXXXXXXXXX-XXXXXXXXXX--XXX||X|||XXXX%%-||-X-XXXXXXXXXXX-XX|%%%%--XXXX--%%%
XXXXXXXXXXXXXXXXXXXXXXXXXXXXXXXXXXXXXXXXXXXXXXXX-|||||||-XXXXX|X--XXXXXXXXX--XXX|-|||||||||--||----XXXXXXXXXX-X-XXXXXXXXXXXXXXXXXXXXXXXXXXX--XXX||X|||XXXXX|-||oX-XXXXXXXXXXX-XX|-||---XXXX--X|-
