---------------------------------------------------------------------------------------------------------------------------------------K--------------------------------------------------------
---------------------------------------------------------------------------------------------------------------------------------------o-------------------------S--------S---------------------
--------------------------------------------------------------------------------------------------------------------------------------%%%-------------------------------S-S---S-----------------
------------------------------------------------------------------------------------------------SSSSSSSSSSS----------------------------|-------------------------SSSSSSSSSSSSSSS----------------
---------------------------------------------------------------------------------------------------------------------------------------|--------------------------------SS---SSS----------------
-----------------ooo------------------------------oo-------------------------------------------------------------o-o---ooo-------------|------%%--o---------------------oo---g------------------
--------%%%%%%%%-----------------------%%-----------------------S-SSS-SSoS---SSS---------------o----oS--o----SSS-----------------------|------||---------------------SS-----SS------------------
---------||||||-----------------%%%%%%%||-----------------------S--------------------------y-------------------------------------------|------||----------------------------SS---------o--------
---------||||||------------------|||||-||-----------------------S--------------------------##-S----------------------------------------|------||----------------------------SS--------%%%-------
---------||||||------------------|||||-||-----------------------So-----o-------------------#-------gggg--------o-----------------------|-oooo-||----------------------------SSoo-------|--------
------%%%%%%%%%%--TT----TT-------|||||-||--#-------------TT-----SSS--SSSQS--SSSS--------######--TT###SS------------o-------------------|%%%%%-||-##-------------S----SS----------------|-----%--
-------||||||||---TT----TT---TT--|||||-||--#-------------TT----------------------------#######--TT-----K-------------------------------|-|||-oo|-##----#--------SSSSSS-----------------|-----|--
-------||||||||---TT----TT---TT--|||||-||--#-------------TT--------------------------#########--TT-----------------K-------------------|-|||%%%%-##----#-----K--SS------------SS-------|-----|--
-------||||||||---TT--k-TT---TT--|%%%%-||--#---#---------TT--------U--------k--------#########--TT-----k--k-k--------------------------|-|||-||-###----#-----#--SS---Sk-##--ooSS-------|-----|--
XXXXXXXXXXXXXXXXXXXXXXXXXXXXXXXX-|-||XXXXXXXXX-XXXXXXX---XXX----XXXXXXXXXXXXXXXXXXXXXXXXXXXXXXX-XXXXXXXXXXXXXXXXXXXXXXXXXXX-XXXX----%%%%%|||-||-XXXXXXXXXXXXXXXXXXXXXXXXXX-----X-----X%XXXXXXXXX
XXXXXXXXXXXXXXXXXXXXXXXXXXXXXXXX-|-||XXXXXXXX--XXXXXXX---XXX----XXXXXXXXXXXXXXXXXXXXXXXXXXXXXXX-XXXXXXXXXXXXXXXXXXXXXXXXXXX-XXXX-----|||-|||-||-XXXXXXXXXXXXXXXXXXXXXXXXXX-----X------|XXXXXXXXX
