--------------------SSSSSSS---------------------------------------------------------------------------------------------------------------------------------------------------------------------
-------------------SSSSSSSSS--------------------------------------------------------------------------------------------------------------------------------------------------------------------
------------------------S-----------------------------------------------------------------------------------------------------------------------------------------------------------------------
-----------------------SSSSS--SSSS----------------------------------------------------------------------------------------------------------------------------------------------------SSSSSSSSSS
-----------------------SSS-----S-------------------------------------------------------------------------------------------------------------------------------------------------------SS-------
----------------So-Q---SSSS----------------------oo--------ooooo-------------------------------------------------oo-----------oo-----------o-ooo----------------------------------S----S------SS
--------%%%%%%%%------------SS---%%--------------%%--------%%%------------------------SSSS----S-----------------%%%%-----------------------%%%-------------------------%%--------SSSSSSS-----SSS
---------||||||-S-----------SS---||--------------||---------|-------------------------oo-------------------------||-------------------------|--o------------------%%%--o|--o-------------------#
---------||||||-------------SS---||--------%-----||---------|----------------------------------------------------||-------------------------|----------------------|---||--%----------------####
---------||||||-------------SS---||--------|-----||-------o-|--ooo--ggg----------------------------------------o-||------ooo----------------|-----o----------------|---||--|----ooooo------#####
------%%%%%%%%%%SSSSSSSS-SS----S-||--------|-----||--2-%%%%%%%%%TTSS###--------------------------TT-----##-------||-----%%%%--------------%%|----------------------|---||--|----SSSSSS-----#####
-------||||||||-SSSSSS---SS---SS-||--------|-----||-----|||||||-TT-------------------------------TT---k###-------||------||---------------|||----------------------|---||--|---------@---#######
-------||||||||-SSSSSSS--SS---SS-||--------|-----||-----|||||||-TT-------------------------------TT---####-------||------||---------------|||%%%-------------------|---||--|------------########
-------||||||||-SSSSSSSS-SooooSS-||----g---|----g||-----#||||||-TT---k----k-k--------------------TT---####-------||------||---------------|||-|----------#-----o---|-g-||--|--------ggk-########
XXXXXXXXXXXXXXXXXXXXXXXX-USX---XXX|--XXXXXXXX--XXX|--XXXX|XXX||-XXXXXXXXXXXXXXXXXXXXXXXXXX---%%-XXXXXXXXXXXXXXXXX||---XXXXX--%%%%%%%---%%%XXX-|--XXXXXXXXXXX-%%%---XXXXXXX-|----XXXXXXXXXXXXXXXX
XXXXXXXXXXXXXXXXXXXXXXXX-X-o-X-XXX|--XXXXXXXX--XXX|--XXXX|XXX||-XXXXXXXXXXXXXXXXX-XXXXXXXX---||-XXXXXXXXXXXXXXXX-||----XX-X---|||||-----|XXX--|--XXXXXXXXXXX--|----XXXXXXX-|----XXXXXXXXXXXXXXXX
