---------------------------------------------------------------------------------------K---------------------------------------------------------------K----------------------------------------
---------------------------------------------------------------------------------------o---------------------------------------------------------------o----------------------------------------
--------------------------------------------------------------------------------------%%---------------------------------------------------------------%----------------------------------------
--------------------------------------------------------------------------------------||---------------------------------------------------------------|------------------------SSSSSSSSSSSSSSSS
--------------------------------------------------------------------------------------||---------------------------------------------------------------|------------------------SS---S-S--------
----------------------------------------------------------------------------oooo--o---||----------oo-----------o---------------------------------------|------------------------SS---SSS------SS
--------%%%%%%%%----------------------SSSS-------oSUQSSSSS---SSS-%%-------------%%%%--||--------%%%%%-----%%%%%%-----------------------QQ--------------|-----------------------------SSSSSSSSSSS
---------||||||--o---------#-------------------------------------||--------------||---||---------|||-------||||-S--------------------------------------|----------------------------------------
---------||||||-----------##-------------------------------------||--------------||---||---------|||-------||||----------------------------------------|-----------------------------------y----
---------||||||----------###---------------------------g-----o-o-||------------o-||---||---------|||-------||||------------------------g----SS---------|-----------------------------------#----
------%%%%%%%%%%--------####--------------#-------Q-S-SQQ----USS-||--2-----%-----||---||---------|||-----%%%%%%%-------TT---------#---##----Q----------|----------------------------------##----
-------||||||||--------#####-------------##----------------------||--------|-----||---||---------|||------|||||---TT---TT--------##--------------------|-------#-------------------------###----
-------||||||||-------######------------###--###-----------------||----TT--|-----||---||---------|||------|||||---TT--#TT----TT-###--------------------|-----%%%------------------------####---#
-------||||||||------#######----------#####--###---k------------k||----TT--|----%||---||-----ooo-|||------|||||---TT--#TT----TT-###--------k-g-g-------|------|#--g-------------g------#####--##
XXXXXXXXXXXXXXXXXXXXXXXXXXXXXXXXXXXXXXXXXXXXXXXXXXXXXXXXXXXXXXXXXXXXXXXXXXXXXX--|||---%%%%--%%%%%%%%%%%%%%%X|||-XXXXXXXXXXXXXXXXXXX---XXXXXXXXXX%%%%%%%%%%-X--|XXXXXXXXXXXXXXXXXXXXXXXXXXXXXXXXX
XXXXXXXXXXXXXXXXXXXXXXXXXXXXXXXXXXXXXXXXXXXXXXXXXXXXXXXXXXXXXXXXXXXXXXXXXXXXX---|||----||----|||||||||||||-X|||-XXXXXXXXXXXXXXXXXXXX---XXXXXXXXX-||||||||--X-X|oXXXXXXXXXXXXXXXXXXXXXXXXXXXXXXXX
