---------------------------------------------------------------------------------------------------------------------------------------------------------------------------------------K--------
---------------------------------------------------------------------------------------------------------------------------------------------------------------------------------------o--------
--------------------------------------------------------------------------------------------------------------------------------------------------------------------------------------%%%-------
-----------------------------------------------------SSS------------------------SSSS----------------------------SSSSSSSSSSSSSS---------------------------------------------------------|--------
----------------------------------------------------------------------------------------------------------------S----------------------------------------------------------------------|--------
----------------------------------ooo-%%%----------------------------------------------------------------------------------------o-------ooo-------------------------------------------|--------
--------%%%%%%%%----------------%%%%%%-|---------------------------------------------------------o-------------------------------%%--------%-------------------------------------------|---%%---
---------||||||------------------||||--|----------------------------------##-----------------------------------------------------||--------|---o--------------------------------o------|---||--#
---------||||||------------------|||o--|------------------#---TT---------###-----------------------------#-----------------------||--------|------------------------------------%%-----|---||---
---------||||||------------------||%%%%|------------------#---TT---------##-------------------------------------oo---------------||--------|------------------------------------||-----|---o|---
------%%%%%%%%%%----------######-||-||-|%%%%%------------##---TT---------#------TT----------------------g-------SS---------------||--------|------------------------------------||-----|%%%%|---
-------||||||||------------------||-||-|-|||------TT----###---TT--------##------TT-----TT----TT--------###--#--------------------||--------|--------------K---------------#-----||-----|-||-|ooo
-------||||||||------------------oo-||-|-|||-%%%--TT---####---#T------####------TT-----TT----TT-------####-##--------------------||--------|------------------------tt---##----#||-----|-||-%%%%
-------||||||||-----------------%%%-||-|-|||--|---TT---####----T------####------TT-----TT----TT------#####-##--------k-----kg----||--------|------kggg--------kg----tt---##----#||-----|-||--||-
XXXXXXXXXXXXXXXXXXXXXXXXXXXXXXXX-%%%||%%%XXX--|--XXXXXXXXXX-XXXXXXXXXXXXXXXXXXXXXXXXXXXXXXXXXXXXXXXXXXXXXXXXXXXXXXXXXXXXXXXXXXXXX||-----g%XX----XXXXXXXXXXXXXXXXXXXXXXXXXXXXXXXX%%%%%%%%%%%%-||-
XXXXXXXXXXXXXXXXXXXXXXXXXXXXXXXX--|-||-XXXXX--|-XXXXXXXXXXX-XXXXXXXXXXXXXXXXXXXXXXXXXXXXXXXXXXXXXXXXXXXXXXXXXXXXXXXXXXXXXXXXXXXXX||----XXXXX----XXXXXXXXXXXXXXXXXXXXXXXXXXXXXXXX-||||||||||--||-
