------------------------------------------------------------------------------------------------------------------------------------------------------------------------------------------------
------------------------------------------------------------------------------------------------------------------------------------------------------------------------------------------------
------------------------------------------------------------------------------------------------------------------------------------------------------------------------------------------------
------------------------------------------------------------------------------------------------SS------------------------------------------------------------------------------SSSSSSSSSSSSSSSS
--------------------------------------------------------------------------------------------------------------------------------------------------------------------------------SS--------------
----------------------------------------------------------------------------------------------------------------------------------------------------------o---o-----------------SS----S--------S
--------%%%%%%%%---------------------QSS---------------------------------------------------------------ooo-----o-----------------------------------------------------------------------------SSS
---------||||||------------------------------------------------#-----------------------------------------------------------------#-----------------------------o-----------#--oo----------------
---------||||||-----------------------------------------------#----------------------------------------------------------------------------#-----------------------------######-----------------
---------||||||----------------------------------------------#----------------------------oo-----------------------------------------------##----------------------------#####------------------
------%%%%%%%%%%----------###########--------#-------------###---------------------------###------#------------------S-----------###------###--------------------------TT#####------------#-----
-------||||||||------------------------K-----#--TT-------#-###--------------------------###----o#-#----------------------TT------###-----####------------------o-------TT#####-----------##-----
-------||||||||------------------------------#--TT------######--------------------TT---####-----###----------------------TT--##--TT-----#####-------------------------#########----------##-----
-------||||||||-----------------------gy----##--TT------######--------------------TT--#####-----#-#--k-----#---#g--------TT####--TT----#####k------------------------##########----------##-----
XXXXXXXXXXXXXXXXXXXXXXXXXXXXXXXXXXXXXXXXXXXXXXXXXXXXXXXXXXXXXXX---XXXXXXXXX-XXXX-XXXXXXXXXX----XXXXXXXXXXXXXXXXXXXXXXXXXXXXXXXXXXXXXXXXXXXXXXXXXXXX%---XXXXX----XXXXXXXXXXXXXXX-XXXXXXXXXXXXXXXX
XXXXXXXXXXXXXXXXXXXXXXXXXXXXXXXXXXXXXXXXXXXXXXXXXXXXXXXXXXXXXXX---XXXXXXXXX-XXXXXXXXXXXXXXX----XXXXXXXXXXXXXXXXXXXXXXXXXXXXXXXXXXXXXXXXXXXXXXXXXXX-|---XXXXX----XXXXXXXXXXXXXXXXXXXXXXXXXXXXXXXX
