------------------------------------------------------------------------------------------------------------------------------------------------------------------------------------------------
------------------------------------------------------------------------------------------------------------------S-----------------------------------------------------------------------------
------------------------------------------------------------------------------------------------------------------------------------------------------------------------------------------------
----------------------------------------------------------------------------------------------------------------SSSSSSSSSSSSSSSS-----------------------------------------------S----------------
----------------------------------------------------------------------------------------------------------------S----SS-------------------------------------------------------------------------
------------------------------------------------------------------------------------------------------------------------------------------------------------------------------------------------
--------%%%%%%%%----------------------------------------------------------------------QQQS-----oSSSSSSSS-----------o----------------------------%%-------------------------o-----------S--------
---------||||||--------------------------------------------------------------------------------#------------------------------------------------||----------------------------------------------
---------||||||------%%%----------------------------------------------------------------------##------------------------------------------------||----------------------------------------------
---------||||||-------|----------------------------------------------------------o------------##----------------ooooo---------------o----------o||-------------------%%%------------------------
------%%%%%%%%%%------|---%%-----------------------------%%%--------------#-----#-------S----###@SSSSSSSSSSSSS--S--SS---------------------------||---------%%%So------|-------------------------
-------||||||||-------|---||------------TT----------------|---------------#-----------------####---------------------------------------TT-------||----------|---------|----------------##-------
-------||||||||-------|---||------------TT----------------|--------------##-----------------####---------------------------------------TT-------||----------|---------|---------------###-------
-------||||||||-------|---||-------g-g--TT---#------------|----o---------##----------kgg---#####----gg--------------------#------g-----TT---k---||----------|---%-----|--------------####-------
XXXXXXXXXXXXXXXX--XXXXXXXX||----XXXXXXXXXXXXXXXX--%%%%----|--%%%XXXXXXXXXXXXXXXXXXXXXXXXXXXXXXXXXXXXXXXXXXXXXXXXXXXXXXXXXXXXXXXXXXXXXXXXXXXXXXXXXXXXXXXXXXXXXXXX|-----|X%X%X%X%XXXXXXXXXXXXXXXXX
XXXXXXXXXXXXXXXX--XXXXXXXX||----XXXXXXXXXXXXXXXX---||-----|---|-XXXXXXXXXXXXXXXXXXXXXXXXXXXXXXXXXXXXXXXXXXXXXXXXXXXXXXXXXXXXXXXXXXXXXXXXXXXXXXXXX-XXXXXXXXXXXXXX|-----|X|XXX|XXXXXXXXXXXXXXXXXXX
