-----------------------------------------------------------------------------------------------------------------------------------K-SS---------------------------------------------------------
---------------------------------------------------------------------------------------------------k-SS--SS-------------------------rrS---------------------------------------S-----------------
-----------------------------------------------------------------------------------------------------------------------------------%%%%-------------------------S-------------So----------------
----------------------------------------------------------------------------------------------------------------SSSSSSSSSSSSSSSS----||----------SSSS--o------SSSSSSSSSSSSSS---SS----------------
-------------------------------------------------------------------------------------------------------SS-------SS--%S%%-%----------||---------------%%%--------SSSSSSSS------S-----------------
-----------------------------------------------o-oooo--------------------------------------------------SS-@-----SS--|-||-|-----S----||----------------|---------SSSSSSSS---ooSSS----------------
--------%%%%%%%%----------------S--SSSSSSSSSSSSS------------------------------------------------------------------oo|-||oooo---S----||-----So---------|---------SSSSSSSS--SSSSSS----------------
---------||||||----------------------------------o---------------------------------------------o--------------------|-||-|-------%%%||-o---o----------|---------S-------------------------------
---------||||||------------------------------------------------------------%%SS-------------------------------------|SSS%%--------|-||%%%-%%----------|-----------------------S-----------------
---------||||||------------------------------------------------------------||---------------------------------------|---||-----S--|-||-|--||----------|---------oooooooo------oo----------------
------%%%%%%%%%%----------######S---SSSSS----USo--TT-----TT----------------||--------@-----------USo-S----------S---|---||--------|-||-|--||----------|-------SSSSSSSSSSSS---SSS----------------
-------||||||||------------------------------#----TT-----TT----------------||---TT-------TT---------------------o---|---||--------|-||-|--||---#------|-----------------------------------------
-------||||||||------------------------------##---TT-----TT----#-----------||---TT-------TT---------------------%---|---||--------|-||-|--||---#------|---------------------------------------TT
-------||||||||---------------------ggg-----####--TT-----TT----#-----------k|---TT---k---TT----#----------------|---|---||-g------|-||-|--||---#------|----#----k-----kk----kSko-----g--------TT
XXXXXXXXXXXXXXXXXXXXXXXXXXXXXXXXXXXXXXXXXXXXXXXX-XXXXXXXXXXX-XXX--XXXXXXXXXXXXXXXXXXXXXXXXX---XXXXXXXXXXX----XXX|---|XXXXXXXXXXX--|-||%%%%%%%X-X------|XXXXXXXXXXXXXXXXXXXXXXXXXXXXXXXXXXXXXXXXX
XXXXXXXXXXXXXXXXXXXXXXXXXXXXXXXXXXXXXXXXXXXXXXXXXXXXXXXXXXXX-X----XXXXXXXXXXXXXXXXXXXXXXXXXXXXXXXXXXXXXXX----XXX|---|--XXXXXXXXX--X-||XX|XXX-X-X------|XXXXXXXXXXXXXXXXXXXXXXXXXXXXXXXXXXXXXXXXX
