---------------------------------------------------------------------------------------K--------------------------------------------------------------------------------------------------------
---------------------------------------------------------------------------------------o--------------------------------------------------------------------------------------------------------
---------------------------------------------------------------------------------------%%-------------------------------------------------------------------------------------------------------
---------------------------------------------------------------------------------------||-----------------------------------------------------------------------SSSSSSSS------SS-SSSSSSSSSSSSSSS
---------------------------------------------------------------------------------------||-------------------------------------------------------------------------------------------------------
---------------------------------------------------------------------------------------||-----%%---------------------------------------------------------oo-------------------------------------
--------%%%%%%%%--------------------------%%%------------------------QQSSS---SS-S------||-----||---------------------------------------------------------------------------------------o-------o
---------||||||----------------------------|------------------------------------o------||--o--||-------------------------------------------------U---------------o---------y--------------------
---------||||||----------------------------|-###--------------------------------%%%%%%%%%-%%%-||---------------------------------------------------------------------------###S-----------------
---------||||||----------------------------|####---------------------------------|||||||--oo--||----%%%-------------------------------------------------------------------##--------------------
------%%%%%%%%%%----------######-----------#####----SSS----------S----SQSSSS-----|||||||-%%%%-||-----|-----------------------------------#-------TT----------------------####------SS----TT-----
-------||||||||---------------------------######TT------------K---------------o--|||||||--||--||-----|---------------------------------###-------TT-----TT----TT--------######-----------TT-----
-------||||||||---------------------------######TT-------------------------------|||||||--||--||--o--|----------------------------TT---###-------TT-----TT----TT-------#######---#-------TT-----
-------||||||||--------------------------#######TT---kkk--k-kk-----r-------------|||||||r-r|--ro-%%%-|---------o-----k---------g--TT--####-------TT---k-TT--k-TT--#---########---#---kkg-TT-----
XXXXXXXXXXXXXXXXXXXXXXXXXXXXXXXX-%%%-XXXXXXXXXXXXXXXXXXXXXXXXXXXX-%%%-XXXX---XXX-%%%%|%%%%%%%%%%--|--|XX-XXX%%%%XXXXXXXXXXXXXXXXXXXXXXXXXX------XXXXXXXXXXXXXXXXXXXXXXXXXXXXXX-XXXXXXXXXXXXXXXXX
XXXXXXXXXXXXXXXXXXXXXXXXXXXXXXXX--|--XXXXXXXX-XoXXXXXXXXXXXXXXXXX-X|--XXXX---XXX--||-|-||||||||---|--X-X-XXX-||-XXXXXXXXXXXXXXXXXXXXXXXXXX------XXXXXXXXXXXXXXXXXXXXXXXXXXXXXXXXXXXXXXXXXXXXXXXX
