---------------------------------------------------------------------------------------------------------------------------------------------------------%%%--------------------
----------------------------------------------------------------------------------------------------------------------------------------------------------|---------------------
----------------------------------------------------------------------------------------------------------------------------------------------------------|---------------------
------------------------------------------------------------------------------------------------------------------SSSSSSSSSSSSSS--------------------------|---------------------
-----------------------------------------------------------------------------------g----------------------o-----------------------------------------------|---------------------
--------------------------------------------------------------------------------%-------------------------------------------------------------------------|---------------------
--------%%%%%%%%---------------------------------------------------------------o|---------------------------------------------------------------o---------|-------###-----------
---------||||||---------oooo---------r--U---------SSS--------------------ooo----|------------------------------------------S------------------------------|---------------------
---------||||||------------------%%%%%%%%---------------------------------------|-------------------------------------------------------------------------|---------------------
---------||||||----------S--------||||||----------------------------------------|-------S---------oo------oR-------------SSSS-----------------------------|---------------------
------%%%%%%%%%%--S---------------||||||--%---------#----#-------Q--------------|-------S---------------------#-----------SS------------------------------|-Q------------##-----
-------||||||||--------TT---TTT---||||||--|---------#---------TT----------------|----------------------------##-------------------------------------------|--------------#-----#
-------||||||||--------TT---TTT---||||||--%%%%%%#---#-#-------TT----tt----------|----------B----------------###-------------------------------------------|-----#--------##----#
-------||||||||---k----TT-k-TTT---||||||---||||-#---###-------TT----tt----------K----------b---------------####---kk-------k--------------------------g--k|--ggg#---#y---##----#
XXXXXXXXXXXXXXXXXXXXXXXXXXXXXXXX--|||%%%%%%%%%|-XXXXXXXX-XXXXXXXXXXXXXXXXXXXXXXXX----XX-XXXXXXX-XXXXXXXXXXXXXXXXXXXXXXXXXXXXXXXXXXXXXXX----X----XXXXXXXXXXXXXXXXXXXXXXXXXXXXXXXX
XXXXXXXXXXXXXXXXXXXXXXXXXXXXXXXX--|||-||||||g-|-XXX-XXXX-XXXXXXXXXXXXXXXXXXXXXXXX----XX-XXXXXXX-XXXXXXXXXXXXXXXXXXXXXXXXXXXXXXXXXXXXXX-----X----XXXXXXXXXXXXXXXXXXXXXXXXXXXXXXXX
