------------------------------------------------------------------------------------------------------------------------------------------------------------------------------------------------
------------------------------------------------------------------------------------------------------------------------------------------------------------------------------------------------
------------------------------------------------------------------------------------------------------------------------------------------------------------------------------------------------
--------------------------------SSS----------------------------SSSSSSSSSSSSSSSSS-----------------SS-----------------------------------------------------------------------------#---------------
----------------------------------------------------------------S---------------------------------------------------------------------------------------------------------------#---------------
-------------------------------------------------------------------------------S----------------------------------------------------------------o-o----------ooo--------------------------------
--------%%%%%%%%-----------------------------------------------------------ooo-S-o-----------o-o-----SS--------S--------o---------------------------------------------S%S-----------------------
---------||||||-------------------------------------------------------------------%-------------S----------------------------------------------------------------------|------------------------
---------||||||-----------------#---------------------------------------SSSSS-----|----------S-------------------------------------------------------------------------|------------------------
---------||||||-------------------------------------------SSSSS-------------------|----------------------------o--------------------------o----o-----------------------|------------------ooo---
------%%%%%%%%%%----------######--------------------------------------------------|-----------------------------------------So------------%------------TT%%------------|----------------%%%%%---
-------||||||||-------------------------------TT----------------------------------|-tt-----------------TT-----------------------S---------|------------TT||------------|-----------------|||-ooo
-------||||||||-------------------------------TT-----------S----------------------|-tt-----------------TT---------------------------------|------------TT||------------|-----------------|||%%%%
-------||||||||-----------------g-------------TT-------------------------g-g------|-tt-----------------TT---k------k-k------k-------------U-------gg---TT||----------k-|-----------------|||-||-
XXXXXXXXXXXXXXXXXXXXXXXXXXXXXXXXXXXXXXXXXXXXXXXXXXXX------SS----XXXXXXXXXXXXXXXX--XXXXXXXX-----XXXXXXXXXXXXXXXXXXXXXXXXXXXXXXXXXXXXXXXXXX-X-----XXXXXXXXXXXXX----XXXXXXXXX--%%-X%%%%%%%%-|||-||-
XXXXXXXXXXXXXXXXXXXXXXXXXXXXXXXXXXXXXXXXXXXXXXXXXXXX-----------XXXXXXXXXXXXXXXXX--XXXXXXXX---XXXXXXXXXXXXXXXXXXXXXXXXXXXXXXXXXXXXXXX-XXX--X----XXXXXXXXXXXXXX-----XXXXXXXX--||-X-||||||--|||-||-
