-----------------------------------------------------SS-SSS------------------------------------------------------------K-------------------------------S----------------------------------------
-------------------------------------------------K-KSSSSSSS---------------S--------------------------------------------o-------------------------------o----------------------------------------
----------------------------------------------------------------------------------------------------------------------%%%-----------------------------%%----------------------------------------
---------------------------------------------------------------S----------SSSSSS---------------------------------------|------------------------------||--------##------------------------------
--------------------------------------------------------S-S--SSS-------------------------------------------------------|------------------------------||----------------------------------------
--------------------------------------------------------SSS--------------------S-------------------------------o-------|----------o-------------------||----------------------------------------
--------%%%%%%%%-----SSSSS----S-----------------------------SS-----ooSSo-----SSS----------------%%%------------S-------|------------------------------||----------------------------------------
---------||||||---------------------------------S-----------SS-----------------------------------|---------------------o--orr------------------o------|o----------------------------------------
---------||||||---------------------------------------------SS-----------------------------------|-----%%%%%----------%%%%%%%%-----------------#------|%%-%%----------------#---------------#---
---------||||||---------------------------------------------So----gggggo------oS-----------------|------|||------------||||||------------------#------|||-||---------------##--------------##---
------%%%%%%%%%%--------S-----S-----------------SSSSSSS---------###SSSSSS----SSS-----------------|------|||--%%%%------||||||-------------%-----------|||-||--------------###-------------###---
-------||||||||---------------------------------SSSSSS-SSSS---S-TT-------------------------------|------|||---||-------||||||-------------|----oo-----|||-||--------------###------------####---
-------||||||||---------------------------------SSSSSS---TT---S#TT-------------------------------|------|TT---||-------||||||-------------|-----%-----|||-||-------------####-----------####----
-------||||||||-------------------g-------------SSSSSSSS-TToooS#TT---------------------------oo--|-----k|TT---||--o----||||rrrr-----------|-----|-----|||-||----#----k--#####-##--------####---#
XXXXXXXXXXXXXXXXXXXXXXXXXXXXXXXXXXXXXX-----XX---XXXXXXXXXXXX-XXXXXXXXXXXXXXXXXXX---------%%%%%%%XXXXXXXXXXXXXXXX-%%%--%%%%%%%%%-XX%%XXXXX-X-----|%%%--XX%XXXXX--XXXXXXXXXXXXXXXXXXXXXXXXXXXXX--X
XXXXXXXXXXXXXXXXXXXXXXXXXXXXXXXXXXXXXX-----XX---XXXXXXXXXXXX-XXXXXXXXXXXXXXXXXXX----------|||||-XXXXXXXXXXXXXXXX--|----|||||||--XXX|XXXXX-X-----|-|----XXXXXXXo-XXXXXXXXXXXXXXXXXXXXXXXXXXXXX--X
