-------------------------------------------------------------------------------------------------------K----------------------------------------------------------------------------------------
-------------------------------------------------------------------------------------------------------o----------------------------------------------------------------------------------------
-------------------------------------------------------------------------------------------------------%----------------------------------------------------------------------------------------
--------------------------------------------------------------------------------S----------------------|--------SSSSSSSSSSSSSSSSSSSSSSSSSSSSSSSS------------------------------------------------
-------------------------------------------------------------------------------------------------------|---------S------------------------------------------------------------------------------
-----------------------------------------------------------------------------------------%%-----o------|---ooooo--------------------------------------------------------------------------------
--------%%%%%%%%--------------------------------%%SS-------o---------------------%%%-----||-----S------|--%%%%%%-SSSSSSo------SS-------------------------------o--------------------------------
---------||||||---------------##----------------||--------------------------------|------||----%--o----|---||||------------#-----------------------%%%%o-------#-------------------------------#
---------||||||--------------##-----------------||--------------------------------|------||----|%%%%---|---||||-----------##--------------#---SS----||-----------------------------------------#
---------||||||------gg------##-----gg----------||---------------o----------#-----|%%%%%%||----|-||----|-ooooo|---oo------##---oo-------------------||--------#--------------------------------#
------%%%%%%%%%%########----###-TTSS##----------S|-------SS%S%S------------##---%-|-||||-||----|-||----|%%%%|||--##SS-----#-------------##----------||--------##------------------------%%%%----
-------||||||||-###--#-#---####-TT-------TT------|---------|-|-----------TT##---|-|-||||-||----|-||----|-||-|oo--------####-----------y###----------||--------##--------TT---------------||-----
-------||||||||-###----#---####-TT-------TT------|---------|-|-----------TT##---|-|-||||-||----|-||----|-||-%%%%-#-----###------------####---TT-----||-------###--------TT---TT----------||-----
-------||||||||-##-----#---####-TT---k-k-TT------|---------|-|----gg-g--#####---%%%%|||k-||----g-|rrr--rr||--||--#----######k--------#####---TT-----||-------###--------TT---TT----------||----#
XXXXXXXXXXXXXXXXXXX--XXXXXXXXXXXXXXXXXXXXXXXXXXX-%%%%%%----XXXXXXXXXXXXXXXXXXXX--||-|XXXXXXXXXXX%%%%%%%%%%%%-||-XXXXXXXXXXXXXXXXXXXXXXXXXXXXXXXXX-XXXXXXXXXXXXXXXXXXXXXXXXXXXXXXXX%%XXXXXXXXXXXX
XXXXXXXXXXXXXXXXXXX--XXXXXXXXXXXXXXXXXXXXXXXXXXX--||||-----XXXX-XXXXXXXXXXXXXXXX-||-|XXXXXXXXXXX-||||||||||--||-XXXXXXXXXXXXXXXXXXXXXXXXXXXXXXXXX-XXX-XXXXXXXXXXXXXXXXXXXXXXXXXXXXXXXXXXXXXXXXXX
