-----------------------------------------------------------------------------------------------------------------------------------------------------------------------S------------------------
------------------------------------------------------------------------------------------------------------------------------------------------------------------------------------------------
-----------------------------------------------------------------------------------------------------------------------------------------------------------------------S------------------------
----------------------------------------------------------------SSSSSSSS------------------------------------------------------------------------SSS-----------------------------SSSSSSSSSS------
------------------------------------------------------------------------------------------------------------------------------------------------------------------------------------------------
-------------------------------#------------------------------oo----------------------------------o--------------ooo-----------------------------------------------@----------------------------
--------%%%%%%%%--------------------SSSS-----S----------------------------------------Q--------o----------------%%%%----------------------------------------------------------------------------
---------||||||-----------------------------------------------oo-------------------------------------------------||--------------------------------------------------------ooo------------------
---------||||||-----------------------------------------------------------------------------------------------TT-||-----------------------------------------------------------------------------
---------||||||--------------------------------------------------------TT-------------------------------------TT-||----TT-------------------------------------------------SS--------------------
------%%%%%%%%%%----------------QSQQ---SSS-----------------------------TT--------2---------------#-----TT-----##-||--SoTT----#-----------------------2------------------------------------------
-------||||||||--------------------------------o-----------###--TT-----TT--------2---------------#-----TT--------||----TT---##-----------------------------------------#----------------#-------
-------||||||||-----------------------------------------##-##---TT-----TT---TT---#---------------#-----TT--------||----TT---##-----------------------------------------##---------------#-------
-------||||||||-------------------gggg---------k--g----#####----TT---k-TT---TT-------gg--------###-----TT--kk----||----TT---##----gg-------kk---k------k----kkkg-------##---------------#-----##
XXXXXXXXXXXXXXXXX%%%%XXXXXXX----XXXXXXXXXXXXXXXXXXXXXXXXXXXXXX--XXXXXXXXXXXXXXXXXXXXXXXXXXXXXXXXXXXXXXXXXXXXXXXXXXXXXXXXXXXXXXX-XXXXXXXXXXXXXXXXXXXXXXXXXXXXXXXXXXXXXXXXX----XXXXXXXXXXXXXXXXXXX
XXXXXXXXXXXXXXXXX-||-XXXXXXX----XXXXXXXXXXXXXXXXXXXXXXXXXXXXXXX-XXXXXXXXXXXXXXXXXXXXXXXXXXXXXXXXXXXXXXXXXXXXXXXXXXXXXXXXXXXXXXX-XXXXXXXXXXXXXXXXXXXXXXXXXXXXXXXXXXXXXXXXX----XXXXXXXXXXXXXXXXXXX
