-----------------------------------S-SSSSSS-----------------------------------------------------------------------------------------------------------------------------------------------------
-----------------------------------SSSSSSSS------------------------------------------------------------------------------------------SS---------------------------------------------------------
---------------------------------------SS-------------------------------------------------------------------------------------------------------------------------------------------------------
------------------------------------------------SSSSSSSS-------S---------------SSSSSSSSS------------------------SSS---------------------------------------------SSS-----------------------------
--------------------------------------SSS---SSS-------------------------------------------------------------------------------------------------------------------------------------------------
--------------------------------SS---SSSS-@--g-----------------------------------------------------------------------------------ooo-----------------------------------------------------------#
--------%%%%%%%%-----------------S-----S-----S--------o---------------------------------%---------oS@SSSS------o--rrr--SS---------------------------------------------o-S-----------------------
---------||||||---------------------------------%%%%%%%-------------------------%%%%%%%%|-----------------------%%%%%%------------------------------------------SS%%%%%%-----------------------o
---------||||||----------------------------------|||||---------------------------||||||-|----S-------------#-----||||-----------------------S----------------------||||----%%%S%----------------
---------||||||------------------------------S---|||||---SSS-SS------------------||||||-|------------------#-----||||---------------------g------------------------||||-----|--|----------------
------%%%%%%%%%%----------######-SSoSSSSSSS--S--%|||||-----#----------------#----||||||-|------------------------||||------#--------------S------------------------||||-----|--|----------#-----
-------||||||||---------------------------------||||||---#-#----------------#---o|||oo|-|------------------##----|||tt---#-#------------------------------------o--|ooo-----|--|---------##-----
-------||||||||---------------------S-K---------||||||--##-#-------------#------%%|%%%|-|----#-----------####----|||tt---###------------------------------------%%-%%||----#|--|--TT-----##-----
-------||||||||---------------------------------||||||--##-#----%%%%-----##-----|||-|-|-|--#-#-------kgg###-k----|||tt---###---#--------------------------------||-|||g----#|--|--TT---####----o
XXXXXXXXXXXXXXXXXXXXXXXXXXXXXXXX--XXX-K-SS-----X|||||XXXXXXX-X%XXX|-XXXXXXXXXXXX|||-|XXXXXXX-X--XXXXXXXXXXXXXXXX-|XXXXXXXXXX---X-XXX-------XXX--XXX-----XXXXXXXXXXX|XXXXXXXXXXXXXXXXXXXXXXXXX-XX
XXXXXXXXXXXXXXXXXXXXXXXXXXXXXXXX-XXXX-Q-------XX||X||XXXXXXX-X|XXX|-XXXXXXXXXXXX|||-|XXXXXXX-X--XXXXXXXXXXXXXXXXX|XXXXXXXXXX---X-XXX-------XXXX-XXX-----XXXXXXXXXXX|XXXXXXXXXXXXXXXXXXXXXXXX--XX
