---------------------------------------------------------------------------------------K-------------S---S------------------------------------------------------------S----------------K--------
-------------------------SS------------------------------------------------------------o-----------------SS----------------------------------------------------------------------------o--------
--------------------------------------------------------------------------------------%%%----------------------------------------------------------------------------------------------%%-------
--------------------------------------S------------------------------------------------|-----------------------------------------------------------------------------------------------||-------
-----------------------S---------------------------------------------------------------|-----------------------------------------------------------------------------------------------||-------
----------------------SSS----g---------------------------------------------------------|---oo-o-Q--@---S-------------------------------------------------------------------------------||-------
--------%%%%%%%%-----SSS-----S---------------------------------------------------%%----|--%%%%----------------------------------------QQ---#--oo---------------------------------------%%%------
---------||||||------------------------------------------------------------------||----|---||--o----------------------------oo------------##--#---------------------------------o--%----|----%%%
---------||||||------------------------------------------------------------------||----|---||--------------------------------------------###------------------------------------%%-|----|-----|-
---------||||||----------------S-----------####----------------------------------||----|-oooo----------g-------------------------o-------##-------------------------------------||-|----|-----|-
------%%%%%%%%%%---oSSSS-----------------######----------TT---------------------%%|----|%%%%%----SSoSSS#S-------------------------------###----------------------------------S--||-|----|-----|-
-------||||||||--------------------------#######---------TT---------------------|||----|-|||-oo----------------------------------------####-------TT----------------------------||-|----|----ooo
-------||||||||-------------------------########--TT----###--------------------#|||----|-|||%%%%-----SS-------------------------------#####-#-----TT----------------------------||-|----|-%%%%%%
-------||||||||-----------------------##########--TT----###--------------k----##|||----|-|||-||-----------U--------------------------######-#-----TT-----k---ooo-----------k----||-|----|--||||-
XXXXXXXXXXXXXXXXXXXXXXX-X---XXXXXXXXXXXXXXXXXXXXXXXXXXXXXXXXXX--XXXXXXXXXXXXXXXX|%%%%-%%%%||-||-XXXXXXXXXXX-XXXX--X---XX-----%%%XXXXXXXXXXXXXXXX--XXXXXXXXXXXX%%X-XXXXXXXXXXXX--||-|----|--||||-
XXXXXXXXXXXXXXXXXXXXXXXXX---XXXXXXXXXXXXXXXXXXXXXXXXXXXXXXXXX---XXXXXXXXXXXXXXXX|-||---||-||-||-XXXXXXXXXXX-XXXX------XX------|-XXXXXXXXXXXXXXXX--XXXXXXXXXX-X|XX-XXXXXXXXXXXX-X||-|---X|--||||-
