----------------------------------------------------------S-------------------------------------------------------------------------------------------------------------------------------------
-------------------------------------------------K--------S-------------------------------------------------------------------------------------------------------------------------------------
------------------------------------------------------------------------------------------------------------------------------------------------------------------------------------------------
--------------------------------------------------------S-----------------------SSSSSSSSSSSSSS--SSSS--------------------------------------------------------------------------------------------
-----------------------------------------------------S-----------------------------------------------------------------%%%-----o----------------------------------------------------------------
-------------------------------------------------------------g----------------------------------------------------------|------%----------------------------------o-----oooo-----oo-------------
--------%%%%%%%%------------------------------------SS-------S---------------------------------o-------%%%SSS---%-------|-oo---|----------------------------------------------------------------
---------||||||--#--%----------S-----------------------------S------------------------------------------|-------|-o--r-o|-rrr--|-#------------##-------------S----------------------------------
---------||||||-----|------##--------------------------------S------------------------------------------|-------|%%%%%%%%%%%%%-|------------#---------------------------------------------------
---------||||||-----|------##-----------------------g----------o-o--------------------------------------|-------|-|||||||||||--|-----------##-------g-------------------------------------------
------%%%%%%%%%%----|-----###----------------------SSSS---------------------S@-------S------------------|-------|-|||||||||||--|-----2-----##-------S-----------TT---S##------------------------
-------||||||||--##-|-----###-------------------SSSSSS-S------------------------------------------------|-------|-|||||||||||--|----------###------------TT-----TT------------K-----------------
-------||||||||-###-|---#####----------------------SS--S--------------------------------TT--------------|-------|-|||||||||||--|TT------TT###------------TT-----TT------------------------------
-------||||||||-###-|--######------------------oSSSSSSkS--U-k-k----ggggg--------k-------TT--------------|-------|-||||||||rr|-r|TT------TT###--#---------TT-----TT---k------k--g----------------
XXXXXXXXXXXXXXXXXXXXXXXXXXXXXX-XXXXXXXXX-XXXXXXXXXXXXXXXXXXXXXXXXXXXXXXXXXXXXXXXXXXXXXXXXXXXXXXX-XXXXXXXXXXXXXXX|-||||%%%%%%%%%%XXX-XXXXXXXXX--XXXXXXXXXXXX-XXXXXX--XXXXXXXXXXXXXX%%---------%%%
XXXXXXXXXXXXXXXXXXXXXXXXXXXXXX-XXXXXXXXX-XXXXXXXXXXXXXXXXXXXXXXXXXXXXXXXXXXXXXXXXXXXXXXXXXXXXXXX--XXXXXXXXXXXXXX|-||||-||||||||-XXX-XXXXXXXXX--XXXXXXXXXXXX-XXXXXXXXXXXXXXXXXXXXX-X|----------|-
