-------------------------------------------------------------------------------------------------------------------------------------------------------K----------------------------------------
------------------------------------------------------------------------------------------------------S-------S----------------------------------------o----------------------------------------
----------------------------------------------------------------------------------------------------------S--SSS---------------------------------------%----------------------------------------
----------------SSSSSSSSSSSSSSSS----------------------------------------------------------------SSS--SSSSSSSSSSS---------------------------------------|-------o--------------------------------
------------------------------------------------------------------------------------------------S-S-SSSSSSS--------------------o-----------------------|-------S--------------------------------
------------------------------------------------------------------------------------------------SSSSSSSSSSSoSoSS---------------------------------------|-------%--o-----------------------------
--------%%%%%%%%------------------------------------------------------SSSS----S-----------------SSSSSSSSSSSSSSSS---------------------------------------|-------|-----------------USQ---QQ-----Q-
---------||||||----------------------------------------------------o%%%o-------------------------------------------------------------------------------|-------|--------------------------------
---------||||||------------------------------------------------------|---------------------------------------------------------------------------------|-------|--------------------------------
---------||||||----------------------------------oo------------------|--------------------------oooooooo-----ooo----g-------------------------------%%%%%--oo--|----------------------gg--------
------%%%%%%%%%%-TT----------------------------------2---TT----------|--------------------------SSSSSSSSSSSSSSSS----##S--------------------------%---|||--%%%--|-----2----------#########-------
-------||||||||--TT-----TT----TT-------------#-----------TT----------|-------------------TT----------------------TT---K--------------------------|---|||---|---|---------TT-------###-##--------
-------||||||||--TT-----TT----TT-------------#-#---------TT----------|-------------------TT---------------------TT-------TT----------------------|---|||---|---|---------TT------######---------
-------||||||||--TT---k-TT----TT-------k-----###-----k---TT----#-----|----------%%%------TT----------ggg------g-TT-------TT---k---g------------#-|---|||---|---|##-----k-TT------####-k---k-----
XXXXXXXXXXXXXXXXXXXXXXXXXXXXXXXXXXX-XXXXXXXXXXXXXXXXXXXXXXXXXXXX--XXXXXXXX---SS%XX-XXXXXXXXXXXXXXXXXXXXXXXXXXXXXXXXXXXXXXXXXXXXXXXXXXXXXXXXXXXXX-|--%%%%---|%%%%XXXXXXXXXXXXXXXXXXX@XXX-XXX-XXXX
XXXXXXXXXXXXXXXXXXXXXXXXXXXXXXXXXXX-XXXXXXXXXXXXXXXXXXXXXXXXXXXX--XXXXXXXX-----|X--XXXXXXXXXXXXXXXXXXXXXXXXXXXXXXXXXXXXXXXXXXXXXXXXXXXXXXXXXX----|---||----|-||-XXXXXXXXXXXXXXXXXXXXXXXXXXX-XXXX
