------------------------------------------------------------------------------------------------------------------------------------------------------------------------------------------------
------------------------------------------------------------------------------------------------------------------------------------------------------------------------------------------------
------------------------------------------------------------------------------------------------------------------------------------------------------------------------------------------------
------------------------------------------------------------------------------------------------SSSSSSSS----------------------------------------------------------------------------------------
------------------------------------------------------------------------------------------------S-----------------------------------------------------------------------------------------------
----------------------------------------------------------------------------------------------------------------------------------------------------------------ooooo-----------------------o---
--------%%%%%%%%------------------rr--%%%%--------------------------------------------------------------------So-----------#-----o---------#--o---------%%%%%-----------------------------------
---------||||||-----------------%%%%%%-||--o-----------------------------------o------------------------------------------##--------------##----%%%%%%%%-|||--%%--------------------------------
---------||||||------------------||||--||---------------------------------------------------------------------------------###------------###-----||||||--|||--||--------------------------------
---------||||||------------------||||--||---------o------------------------------------------------o--------------o------####-----------####-----||||||--|||--||--------------------------------
------%%%%%%%%%%----------######-||||--||-------SSS-----------------SSS---#------------------------SS-------------SS----#####----------#####-----||||||--|||-#||-----------------S-----K-SSSS---
-------||||||||-----------------o||||o-||-----------------------TT--------#--------------------------------------------####-#----------#####-----||||||--||#--||--TT-----TT------------U--------
-------||||||||-----------------%%|||--||--------------------#--TT-------TT--------------TT------TT-------------------#######--------#######-----||||||--||#--||--TT-----TT---TT----------------
-------||||||||-----------------|||||--||--------------------#--TT-------TT##-#----k-----TT------TT----k----kkk------########-------########-----||||||--||---||--TT-----TT-k-TT----g-------k---
XXXXXXXXXXXXXXXXXXXXXXXXXXXXXXXX|||||-%%%%-X-%--XXXXXXXXXXXXXXXXXXXXXXXXXXXXXXXXXXXXXXXXXXX-XXXXXXXXXXXXXXXXXXXXXXXXXXXXXXXXXXXXXXXXXXXXXXX-XXXX-|||||XXXXX---||XXXXXXXXXXXXXXXXXXXXXXXXXXXXXXXX
XXXXXXXXXXXXXXXXXXXXXXXXXXXXXXXX|||||--||X-X-X-XXXXXXXXXXXXXXXXXXXXXXXXXXXXXXXXXXXXXXXXXXXX-XXXXXXXXXXXXXXXXXXXXXXXXXXXXXXX-XXXXXXXXXXXXXXX-XXXX-|||||XXXXXX--||XXXXXXXXXXXXXXXXXXXXXXXXXXXXXXXX
