-------------------------------------K-K---------------------------------------------------------------------------------------------K--S-------------------------------------------------------
-------------------------------------o-o---------------------------------------------------------------------------------------------o-or-------------------------------------------------------
------------------------------------%%%%%%------------------------------------------------------------------------------------------%%%%%%------------------------------------------------------
-------------------------------------||||--------------------------------SSSSSSS----------------SSSSSSS------------------------------||||-------------------------------------------------------
-------------------------------------||||--------------------------------------------------------------------------------------------||||-------------------------------------------------------
-------------------------------------||||--------------------------------------------------------------------------------------------||||-----------------@-------------------------------------
--------%%%%%%%%---------------------||||-------------SSSS---SSS-------------o-o--SSSSSS---------------------------------------------||||------------SSS-----S----------------------------------
---------||||||----------------------||||----%%%---------------------------------------------------------------------------------oo--||||--o----------------------------------------------------
---------||||||----------------------||||-----##--------------------------------------------------------------------------------%%%%%%|||-%%%--------------------------TT-----------------------
---------||||||----------------------||||---#-##----------------------------------------------oo-------------------------------o-||||-|||--|-------------ooo-----------TT-----------%-----------
------%%%%%%%%%%----------######-----||||-----##--------SS---U-------------------SSS---##------S----------------------SSSS----SS-||||-|||--|-----QQo--SSS%%%-----------##-----------|-----------
-------||||||||----------------------||||----ooo---------------------------------------##----------------#-----------------------||||-|||--|--------------|------------------TT-----|----TT----#
-------||||||||----------------------||||---%%%%-------------------------TT----------####----------------##----------------------||||-|||--|-%%%----------|------------------TT-----|----TT----#
-------||||||||----------------------||||----||----gg--------------------TT----------####----------------##----------------------||||-||rr-|--|-----------|----o---k---------TT-----|----TT---##
XXXXXXXXXXXXXXXXXXXXXXXXXXXXXXXX-----|%%%----||-XXXXXXXXXXXXXXXXXXXXXXXXXXXXXXXXXXXXXXXXXXXXXXXXXXXXXXXXXXXXXXXXXXX--XXXXXXXXXXX-||||-%%%%%|-%%%-XXXXXXXX-|-----XXXXXXXXXXXXXXXX----|--XXXXXXXXX
XXXXXXXXXXXXXXXXXXXXXXXXXXXXXXXX-----|-|-----||-XXXXXXXXXXXXXXXXXXXXXXXXXXXXXXXXXXXXXXXXXXXXXXXXXXXXXXXXXXXXXXXXXXX--XXXXXXXXXXX-||||--|||-|--|--XXXXXXXX-|-----XXXXXXXXXXXXXXXX----|--XXXXXXXXX
