--------------------------------------------------------------------------------------------------------------------------------------------------------------------------------
--------------------------------------------------------------------------------------------------------------------------------------------------------------------------------
--------------------------------------------------------------------------------------------------------------------------------------------------------------------------------
----------------SSSS--S---SSSSSS-------------SSS--------------------------------oo----------SSSS--------------------------------------------------------------------------------
--------------------------------------------------------------------------------------------------------------------------------------------------------------------------------
-------------------------------------------------------------------------------------------------------------------g------------------------------------------------------------
--------%%%%%%%%-----------------------------------------------o--------------------------------SS-----------------QQQQ@QQQ-----SSSo--------------------------------------------
---------||||||----------------------------------------------------------------y------------------------------------------------------------------------------------------------
---------||||||-%%%%%%-------------------------------------------------------------------------------#--------------------------------------------------------------------------
---------||||||--o|||-------------------------------ttt---------------------------------SSSSSSoo----##--------------------------------------------------------------------------
------%%%%%%%%%%-||||---------%%-----------------Q--tt-----tt----------------##--------------%%%---###---TT-------QQQQ-S@QQQQ------##----##-##------------------QQQ--tt----tt---
-------||||||||--||||---------||--------------------tt-----tt---------------###---------------|---###----TT-----------------------###----##--------------------------tt----tt---
-------||||||||--||||---------||-------TT-----------tt-----tt--------------####---------------|--##-#----TT----------------------####-B--##--------------------------tt----tt---
-------||||||||--||||---------||--k----TT-----------tt-----tt----gg-----y-#####---go----------|-###-###--TT----ggg----k-K-------#####-b--##---------------------gg---tt----tt-g-
XXXXXXXXXXXXXXXX-|||%%--------||XXXXXXXXXXXXXXXXXXXXXXXXXXXXXXXXXXXXXXXXXXXXXXXX-XXX----XX----|-XXXXXXXXXXXXXXXXXXXXXXXXXXXXXXXXXXXXXXXXXXX-XXXXX------XX--XXXXXXXXXXXXXXXXXXXXX
XXXXXXXXXXXXXXXX-|||||--------||XXXXXXXXXXXXXXXXXXXXXXXXXXXXXXXXXXXXXXXXXXXXXXXX-XXX----XX----X-XXXXXXXXXXXXXXXXXXXXXXXXXXXXXXXXXXXXXXXXXXXXXXXXX------XX--XXXXXXXXXXXXXXXXXXXXX
