--------------------------------------S---S------------K----------------------------------------------------------------------------------------------------------------------------------------
-----------------------------------K-SSS-SS------------o---------------------------------------------------------K--------S---------------------------------------------------------------------
------------------------------------------------------%%%---------------------------------------------------------------------------------------------------------------------------------------
-----------------------------------------SS------------|--------------------------------------------------------------SS--SS----SSSSSSSS------SS----------------SSSS-SSSSS----------------------
---------------------------------------SSSS--SS--------|----------------------------------------------------------S---S-----------------------------------------------S-------------------------
---------------------------------------SSSS------------|-----------------------o----------------------------------S-----------------------------------------------------------------------------
--------%%%%%%%%---------------------SS-----SS---------|---------------S-------S----QQQQQ-----------------------SSSo---------SSS------------------------------o-SSSoo--------SSS----------------
---------||||||-----------------------------SS----%%%%%%-----%%%---------------------------------o-------------------------------------------------%%------y-o%%--------------------------------
---------||||||-----------------------------SS-S---||||-------|---------------------------------------------------------------------------%%%------||----#####||--------------------------------
---------||||||---------------------g-------SooS---||||-------|--o---------------gg-------------------------------oogo---------------------|-------||----###--||ooooo---------oo----------------
------%%%%%%%%%%----------######SSSSSSS--SS--------||||-------|--------------#---#####-#S----#--------------TTTTSSSSSSS------SSSS----------|-------||---####-#||SSSSSSS------SSS---------##-----
-------||||||||-----------------SSSSSS---SS--------||||-------|------------###---###--------##----------TT--TTTT----------------o---o------|-------||--#####-#||-------------------------##-----
-------||||||||-----------------SSSSSS-------------||||-----%%%%-----------###---#----------##----------TT--TTTT----------------%--%%%-----K-------||#########||-----------------------####-----
-------||||||||-----------------SSSSSSSS--oooooo---||||------||---ggg------##----#-k-k-----###--k-------TT--TTTT----------------|---|------|-------||#########||----gg-----g----------#####----o
XXXXXXXXXXXXXXXXXXXXXXXXXXXXXXXXXXXXXXX--XS---XX---|||%X%----||-XXXXXXXXXXXXXX--XXXXXXXXXXXXXXXXXXXXXXXXXXXXXXXXXXXXXXXXXXXXXXXX|-XXXXXXXXXXXXXXXXXXXXXXXXX-XXXXXXXXXXXXXXXXXXXX--XXXXXXXXX-----
XXXXXXXXXXXXXXXXXXXXXXXXXXXXXXXXXXXXXXX-------XX---||||X|----||-XXXXXXXXXXXXXX--XXXXXXXXXXXXXXXXXXXXXXXXXXXXXXXXXXXXXXXXXXXXXXXX|-XXXXXXXXXXXXXXXXXXXXXXX@---XXXXXXXXXXXXXXXXXXX--XXXXXXXXX-----
