-----------------------------------------S-------------KS--------------------------------------------------------------K-----------------------------------------------K------------------------
---------------------------------K-K-----SS----------------------------------------------------------------------------o-----------------------------------------------o------------------------
------------------------------------------------------%%%%------------------------------------------------------------%%----------------------------------------------%%%-----------------------
-------------------------------------------------------||------o----------------------------S-------------------------||-----------------------------------------------|------------------------
-------------------------------------------------------||-------------------------------------------------------------||-%---------------------------------------------|------------------------
-------------------------------------------------------||---------------------oo--------------------------------------||-|-------ooo---SS------------------------------|------------------------
--------%%%%%%%%---------------------------------------||--------------------------------------oSSSS------------------||-|--------------------------------------%------|------------------------
---------||||||----------------------------------------||--o-----------------------------------------------------rrrr-|o-|-o--------------------S--------------o|------o------------------------
---------||||||---------------------------#------------||-%%%---------------------------------------------------%%%%%%%%%|%%%-----------------------------------|%%%-%%%%-----------------------
---------||||||---------------------------SS-----------||--|---------------------------------#-----------------o-|||||||-|-|------------------------------------|-|---||------------------------
------%%%%%%%%%%----------------SSSSSSSSS------S%%%%---||--|-------------%%%%%%%--------#----#--SSQ--------------|||||||-|-|---------------------TT-------------|-|---||-%%%--------------------
-------||||||||---------TT------SSSSSSSSS------S-||----||--|--------------|||||---------#--###----------------K--|||||||-|-|----S----------------TT-------------|-|---||--|--o------------------
-------||||||||---------TT--------SSSSSS##-----S-||----||--|%%%%----------|||||%-------TT--###-------------------|||||||-|-|----S-TT-------------TT-------------|-|---||--|-%%%%---------TT---TT
-------||||||||------kg-TT---k---SSSSSSS##-------||----||--|-||-----------||||||#------TT--###----ggggk-----k----|||||||rrr|--roS-TT-------------TT-------------|-|---||rrrr-||----------TT---TT
XXXXXXXXXXXXXXXXXXXXXXXXXXXXXXXXXXXXXXXSLXX-XXXX-%%%%-%%%%%%-||-X%%%-XXXXXX|||||XXXXXXXXXXXXXXXXXXXXXXXXXXXXXXXX-|||||%%%%%%%%%%XXXXXXXXXXXXXXXXXXXXXXXXXXXXXXXX|%%%-%%%%%%%%%|-XXXXXXXXXXXXXXXX
XXXXXXXXXXXXXXXXXXXXXXXXXXXXXXXXXXXXXXXXXXX-XXXX--||---||||--||-XXXX-XXXX-X|||||XXXXXXXXXXXXXXXXXXXXXXXXXXXXXXXX-|||||-||||||||-XXXXXXXXXXXXXXXXXXXXXXXXXXXXXXXX|-|---|||||||-|-XXXXXXXXXXXXXXXX
