-----------------------------------------------------SS-S-S------------K-----------------------------------------------------------------------------------------------K------------------------
-----------------------------------------------------SSSSSS------------o---------------S-------------------------------------------------------------------------------o------------------------
----------------------------------------------------------------------%%%---------------------------------------------------------------------------------------------%%%-----------------------
-----------------------------------------------------------------------|------------------------SSSSSSSSS-----------------------SSSSSSSSSSSSSSSS-----------------------|------------------------
-----------------------------------------------------------------------|-----------------------------------------------------------------------------------------------|-------o----------------
-----------------------------------------------------------------------|-----o%%-o-----ooo----------------------ooooo-------------------------------------------------%%%-----%%---------ooo----
--------%%%%%%%%---------------------QQoo------o------SSSSSSS---S------|----%%||-----------------o----------------------------------------------------------------rrr--|------||----------------
---------||||||----------------------------------------o---oo-----o----|----||||----------------------------#---------------------------------------------------%%%%%%%o---o-%%%----------------
---------||||||------------------------------S------------------%%%%---|----||||--------------------------###---------------------------------S------------------|||||%%%-%%%-|-----------------
---------||||||------------------o---------S-S---------k-----SS--||----|-oooo|||----------o---------------###------------oooo------------------o----------o------|||||-|---|--|-----------------
------%%%%%%%%%%----------######-------------S--------SQQ--------||----|%%%%%|||----------S-------------#####--------------------#-S##---------------------------|||||-|---|--|------2----------
-------||||||||--------------------------------------------------||----|-|||-oo|----------------------y######-----TT-------------#------------------------------o|||||-|---|--|--------------TT-
-------||||||||--------------------------------------------------||----|-|||%%%%--ooo----------------########--#--TT-------------##---------------TT------------%%||||-|---K%%%-#------------TT-
-------||||||||--------------------k-k---------g-----------S-----||rr--rrr||-||------------o--------#########-##--TT-------------##-----#-gk----k-TT------------||||||-|---|-|--#----kk-k----TT-
XXXXXXXXXXXXXXXXXXXXXXXXXXXXXXXXXXXXXXXXXXXXXXXX--XX---------SoX-%%%%%%%%%%%-||-----%%%----%%%%%XXXXXXXXXXXXXXXX-XXXXXXX-X------XXXXXXXXXXXXXXXXXXXXXXXX----XX--||||||%%%%%%%|--XXXXXXXXXXXXXXXX
XXXXXXXXXXXXXXXXXXXXXXXXXXXXXXXXXXXXXXXXXXXXXXXX--XX---------XXX--|||||||||--||------|------|||-XXXXXXXXXXXXXXXXXXXXXXXX--------XXXXXXXXXXXXXXXXXXXXXXXX---XXX--||||||-|||||-|--XXXXXXXXXXXXXXXX
