--------------------------------------------------------------------------------------------------------------------------------------------------------------------------------
--------------------------------------------------------------------------------------------------------------------------------------------------------------------------------
-----------------------------------------------------------------------------------------------U--------------------------------------------------------------------------------
------------------------------------------------SSSSSSSSSSSSSSSS------------------------------------------------SSSSSSSSSSSSSSSS-------------SSS------------------SSSSSSSSSSSSSS
--------------------------------------------------SSSSS-------K-----------------------------------------------------------------------------------------------------------------
---------------------------------------------------SSS--------SS--------------------------------------------------------------------------------------ooo-----------------------
--------%%%%%%%%----------------------------------------oooS---------------------------------------QQQQQ-------@---------------S----------------SS--------------------oo----So--
---------||||||------------------------------------------SS-------------------------------------------------------------------------------------SSSSS---------------------------
---------||||||-------#----------------------------------SSS---------------------%%%%-%%------------------------S------------------------------o-----#--------------------------
---------||||||-----###----------------SSSSS--------------------------------------||--||------------------------------#----------------------SrS----##--------------------------
------%%%%%%%%%%---##-###-----------------------SS--------SSSS-S-------#---------%%%--%%%%%%%%%---Q-----QQQQQQQQ---#--#---SSSS-S%%---%%%-----%%%T##-##---TT-----SSS-------SSSS--
-------||||||||---#-#-###----------------------------------------------#----------|----|||||||--------------------##-##---------||----|-------|-TT#-##---TT---------------------
-------||||||||--##-#-###----------------------------------------------#----------|----|||%%%%%%------------------T#-##---------||----|-------|-#-#-##---TT----T----------------
-------||||||||-##--#-###-----------------k--------------y-------------#----------|----|||-||||-g---------y--gg---T#-##---------||----|-------|-#---###--TT----T-------k--------
XXXXXXXXXXXXXXXXXXXXXXXXXXXXXXXXXXX-XXXXXXXXXXXXXXXXXXXXXX--XXXXXXXXXXXXXXXXXXXX--|--%%%%%%%%%%-XXXXXXXXXXXXXXXXXXXXXXXXXXXXXXXX%|%%%%%%%%%%%-|-XXXXXXXXXXXXXXXXXXX-XXXXXXXXXXXX
XXXXXXXXXXXXXXXXXXXXXXXXXXXXXXXXXXX-XXXXXXXXXXXXXXXXXXXXXX--XXXXXXXXXXXXXXXXXXXX--|---||g|g|||--XXXXXXXXXXXXXXXXXXXXXXXXXXXXXXXXg|-|||||||||g-|-XXXXXXXXXXXXXXXXXXXXXXXXXXXXXXXX
