-----------------------------------------------------------------------K---------------------------------------------K-----------------K-K------------------------------------------------------
-----------------------------------------------------------------------o---------------------------------------------oooo--------------o--------------------------------------------------------
-----------------------------------------------------------------------S--------------------------------------------%%%%%%------------%%%%------------------------------------------------------
---------------------------------------------------------------------------------SSSSSSS-------------SSSSSSSSS--%----||||--------------||---------------------------------------SSSSSSSSSSSSSS--
----------------------------------------------------------------------------------------------------------------|----||||------o-------||--------------------------------U----------------------
----------------------------------------------------------------------------------------------------------------|----||||-----%%-------||-------------------------------------------------------
--------%%%%%%%%----------------------------------------------------------------oooSSSSS-----So--Soo---------SSo%%---||||-----||-------||----------------------#---UQSSSSS---S@S-------------o--
---------||||||--------------------------------------------------------o---o------------------------------------||---||||--o--||-ro----||-----%%------------------------------------------------
---------||||||-----------------%%%%-------------S---o----------------%%%-%%%----------------SSS--------------S-||---||||-%%%-||%%%%---||-----||-------------##-------------------------------TT
---------||||||------------------||------------------------------------|---|----S------------oooo---------------||---||||--|--||-||----||-----||------------###------------o------------------TT
------%%%%%%%%%%----------######-||----------------SS#S----------------|---|----S-------#----SSSS------------S--||---||||--|--||-||----||-----||###--------####-QQQ--SSSSSSSSSS---------------#-
-------||||||||------------------||------------------------------------|---|-----------##----------------TT-----||---||||--|--o|-||----||-----||###----TT--###---------------------------##-----
-------||||||||------------------||-----------%%-----------------------|---K-----------------------------TT-----||---||||--|%%%%-||----||---%%%####----TT--###--------------------------###-----
-------||||||||------------------||-----------||-----------------------|---o--------###-k----------kgg---TT-----||---||||--|-||--||----||----|---------TT#####--------------------------##--k---
XXXXXXXXXXXXXXXXXXXXXXXXXXXXXXXX-|XXXXXX-XXX--||XXXXXXXXXXXXXXXX-------|--%%%%%%XXXXXXXXXXXXXXXXXXXXXXXXXXXXXXXX||---|%%%--|-||--||---%X%XX--|--XXXXXXXXXXXXXXXXXXXXXXXXXX--XXXXXXXXXXXXXXXXXXXX
XXXXXXXXXXXXXXXXXXXXXXXXXXXXXXXX-|XXXX-X-XXX--||XXXXXXXXXXXXXXXX-------|---||||-XXXXXXXXXXXXXXXXXXXXXXXXXXXXXXXX||---|-|---|-||--||---|X|X---|--XXXXXXXXXXXXXXXXXXXXXXXXXX--XXXXXXXXXXXXXXXXXXXX
