-----------------------------------------------------------------------KS------------------------------K---------------------------------------------------------------K------------------------
-----------------------------------------------------------------------oo------------------------------o---------------------------------------------------------------o------------------------
----------------------------------------------------------------------%%%%-----------------------------%--------------------------------------------------------------%%%-----------------------
-----------------------------------------------------------------------||------------------------------|------------------------#---------------SSSSSSSSSSSSSSSS-------|--------S---------------
-----------------------------------------------------------------------||------o-----------------------|---------------------------------------------------------------|------------------------
--------------------------------------------------o-------------o------||-----%%-----------------------|-------%-------------------------------------------------------|------%%----------------
--------%%%%%%%%--o---SSoo---S@---------------------------------S------||-----||-----------------------|---S%--|------SSS-------------SSSo-----o-S----S---SS-SSo%%-----|----%%||----------------
---------||||||-------------------------------------------------o------o|--o--||-----------------------|---o|--|---S%%K------------------------#----------------||-----o----||||----------------
---------||||||----------------------------#--------------------%%-----||-%%%-||-----------------------|--%%%--|----||--------S--------------##-----------##----||----%%----||||----------------
---------||||||---------------------------###---------g---------||-----||--|--||--o--------------------|---|---|----||---------------------#####o---------##----||----||-oooo|||----------------
------%%%%%%%%%%-------------------------####-------S##---------||-----||--|--||-----2-----------------|---|---|----tt----------#--------#-####-----------####-#||----||%%%%%|||----------------
-------||||||||-------------------------#####---TT--------------||-----||--|--o|-------TT--------------|---|---|----tt----------#--------#######------k-######--||----||-|||-ooo----------------
-------||||||||------------------------######---TT--------------||-----||--|%%%%TT-----TT--------------|---|---|----tt----------#--------#######------########--||----||-|||%%%%----------------
-------||||||||------k------------g---#######---TT---k----y-----||-----||-rr-||-TT-----TT----ggg-------|--rr---|----tt----------#------#########-----#########--||-rrrrrrrr|-||-----------------
XXXXXXXXXXXXXXXXXXXXXXXXXXXXXXXXXXXXXXXXXXXXXXXXXXXXXXXXXXXXXXXX||---%%%%%%%%%%-XXXXXXXXXXXXXXXX-%%%%-%%%%%%%%-|XXXXXXXXXXXXXXXXXXXXXXXXXXXXXXXXXXXXXXXXXXXXXXX-|%%%%%%%%%%%-||-XXXXXXXXXXXXXXXX
XXXXXXXXXXXXXXXXXXXXXXXXXXXXXXXXXXXXXXXXXXXXXXXXXXXXXXXXXXXXXXXX||----||||||||--XXXXXXXXXXXXXXXX--||---||||||--|XXXXXXXXXXXXXXXXXXXXXXXXXXXXXXXXXXXXXXXXXXX-XXX-|-|||||||||--||-XXXXXXXXXXXXXXXX
