---------------------------------------K---------------K----------------------------------S-----------------------------------------------------------------------------------------------------
---------------------------------------o---------------o----------------------------------S---S-------------------------------------------------------------------------------------------------
--------------------------------------%%---------------%---------------------------------SSS--S-----------------#-------------------------------------------------------------------------------
--------------------------------------||---------------|------------------------SSSSSSSSSSSSSSSS------SSSSSSS---##------------------------------------------------------------------------------
--------------------------------------||---------------|------------------------SSSSSSSSSSS---S-----------------#-------------------------------------------------------------------------------
--------------------------------------||---------------|------------------------SSSSSSSS----ooSS--------------oo--------------------------------------------------------------------------------
--------%%%%%%%%----------------%%----||---------------|------------------------SSSSSSSS----SSSSSSSo-SSS----SSSS--------------------------------------------------------------------------------
---------||||||-----------------||----||---------------orrrro----------------------------------------------------#---------#--##-------------------------------#---------------#-----------y---S
---------||||||-----------------||----||-----------%%%%%%%%%%----------------------------------------------------#---------#####---------------------------#####-----------####----------#-##---
---------||||||-----------------||----||-oo---------||||||||----------%%----------ooo----------o------g-------------------####-----------------------------####------------###----------##-#----
------%%%%%%%%%%----------######||----||%%%%%-------||||||||----------||----------#SS-----------S--SSSS------------------#####-----------TT---------------####----------#######--------###-###--
-------||||||||-----------------||----||-|||--------||||||||----------||--------TT-----TT-------------------------------######-----------TT--------------####----------########--------###-###--
-------||||||||-----------------||----||-|||--------||||||||------o---||--------TT-----TT------------------------------#######-----------TT-------------#####--#------#########-------####-###--
-------||||||||-----------------||----||-|||--------||||rrrr-----%%---||--------TT-----TT---k-------------------#-----########----#------TT---k--------######--#-----#########--y----#####-###--
XXXXXXXXXXXXXXXXXXXXXXXXXXXXXXXX|%%%%%%%%|||%%%%----||%%%%%%%%--XX|---|XXXXXXXXXXXXXXXXXXXXXXXXXXXXXXXXXXXXXXXXXXXXXXXXXXXXXX--XXXX-XXXXXXXXXXXXXXXXXXXXXXXXX---XXXXXXXXXXXXXXX-XXXXXXXXXX-XXX--
XXXXXXXXXXXXXXXXXXXXXXXXXXXXXXXX|-||||||-|||-||-----||-||||X|---XX|---|XXXXXXXXXXXXXXXXXXXXXXXXXXXXXXXXXXXXXXXXXXXXXXXXXXXXXX-XXXXX-XXXXXXXXXXXXXXXXXXXXXXXXX---XXXXXXXXXXXXXXXXXXXXXXXXXXXXXX--
