------------------------------------------------------------------------------------------------------------------------------------------------------------------------------------------------
------------------------------------------------------------------------------------------------------------------------------------------------------------------------------------------------
------------------------------------------------------------------------------------------------------------------------------------------------------------------------------------------------
--------------------------------SSSSSSSSSSSSSSSS------So--------SSSSSSSSSSSSSSSS----------------SSSSSSSSSSSSSSSS-------------------------------------------------------SSSS---------------------
------------------------------------------------------S-----------------------------------------------------------------------------------------------------------------------------------------
-----------------------------------------------------------------------------------------o-------------------------------------oo-oo------------------------------------------------------------
--------%%%%%%%%----------------------------------oo----ooo----o-----------#----------------------------o-----------QS@S-----------------------------------------ooo---SoS---ooo---------------o
---------||||||------------------------------------------------------------#-------------------#S-----------------------------------------------------------------------------------------------
---------||||||-----------------------------------------SSSS-SS-----------##--SS--------------##-----------------------------------------------------------------------------SSS--------------o-
---------||||||-----------------o---------------ooo-------------o--------###-----------------###-----------------------------------------------------------------------------SSS----------------
------%%%%%%%%%%----------#####------------#----SS----------------------####----------------####-----------------S----S@SS---oS---------------------------------S-------------S-------------SSS-
-------||||||||----------------------------#--------------------------y#####---------------#####-TT----@-------------------------------TT---------TT----TT--------------------------------------
-------||||||||------------------------#---###------------------------####-#-------------#-#####-TT------------------------------------TT---------TT----TT--------------------------------------
-------||||||||-----------------k------#---###-----------------g-----#######---g---------#-#####-TT---------gg----g---------------gg---TT---k-----TT----TT-----------k-------------gg-----------
XXXXXXXXXXXXXXXXXXXXXXXXXXXXXXXXXXXXXXXXXXXXXXXXXXXXXXXXXXXXXXXXXXXXXXXXXXXXXXXXXXXXXXXXXXXXXXXXXXXXXXXXXXXXXXXXXXXXXXXXXXXXXXXXXXXXXXXXXXXXXXXXXXXXXXXXXXXX-XXXXXXXXXXXXX--XXXXXXXXXXXXXXX-XXXX
XXXXXXXXXXXXXXXXXXXXXXXXXXXXXXXXXXXXXXXXXXXXXXXXXXXXXXXXXXXXXXXXXXXXXXXXXXXXXXXXXXXXXXXXXXXXXXXXXXXXXXXXXXXXXXXXXXXXXXXXXXXXXXXXXXXXXXXXXXXXXXXXXXXXXXXXXXXX-XXXXXXXXXXXXX--XXXXXXXXXXXXXXX-XXXX
