-----------------------------------------------------------------------------------------------------S---------------------------------------------------------------------------------K--------
--------------------------------------------------------------S--------------------------------------S---------------------------------------------------------------------------------o--------
-------------------------------------------------------------SSS----------------------------------------------------------------------------------------------------------------------%%%-------
------------------------------------------------SSSSSSSSSSSSSSSS--SSSSSSSSSSSSSS--SSSSSS--SSS---#---------------------------------------------------------------SSSSSSSS---------------|--------
------------------------------------------------SSSSSSSSSS-----------------------------------------------------------------------------------------------------------------------------|--------
------------------------------------------------SSSSSSSSS---oooS-----------------------------------------------------------------------------------------------------------------------|--------
--------%%%%%%%%-----------------------SSS---S--SSSSSSSSSSSSSSSS-----S-------S---Sooooooo-----o------------------------SSS---------------------------------------------------o--%%%----%%%------
---------||||||--------------------------------------------------------------S--------------------o----o---o---#-----------------o-----------ooo------oo-------------------------|-----o|-------
---------||||||-----------------------------------------------S--------------SS---------------SS%%%%%%%%%-%%%------------------------------##------------------------------------|----%%%-%%%---
---------||||||------------------------k--------oooooo--------oo----g----------o----------SSSSSS-|||||||---|---------------------ko--------##------------------------------------|-----|---|----
------%%%%%%%%%%----------######-----SS@S-------SSSSSS--------SS--SSS----S-----S#-#----###---SSS-|||||||---|----SSS--SSQ%S%SSS----t-----TT-##-----oo--U-----------#----#---------|-----|---|----
-------||||||||------------------------------#----------###-----SSSSSSK-###-----#-###-###--------|||||||---|---o--------|-|-------TT----TT-##--------------------##---##------K--|-----|---|----
-------||||||||------------------------------#---------####-------SSS--####-----########---------|||||||---|------------|-|-------TT----TT-##--------------------##-------------%%-----|---|----
-------||||||||------------------------------##------g#####-----SSSSS-####----SS#######-k--------||r||||rrrr-------r----|-|-------TT----TT-##-------------U-----###-##kk---kkkk-||-----|---|----
XXXXXXXXXXXXXXXXXXXXXXXXXXXXXXXX-------------XXXXXXXXXXSXXXXXXXXXXXXXXXXXX---XXXXXXXXXXXXXXXXXXX-%%%%|%%%%%%%----%%%%%%%|XX--XXXXXXXXXXXXXXXX---XXXXXXX-X----XXXXXXXXXXXXXXXXXXX||-----|-X-X%%%%
XXXXXXXXXXXXXXXXXXXXXXXXXXXXXXXX--X---------XXXXXXXXXXXXXXXXXXXXXXXXXXXXXX--XXXXXXXXXXXXXX-XXXXX--||-|-|||||------|||||-|------XXXXXXXXXXXXXXXX-XXXXXXX-X----XXXXXXXXXXXXXXXXXXX||-----|-X-X-||-
