------------------------------------------------------S----------------K--------------------------------------------------------------------------------------------------S------------K--------
------------------------------------------------------S----------------o-------------------------------------------------------------------------------------------------SSS-----------o--------
----------------------------------------------------------------------%S%-----------------------------------------------------------------------------------------------S-----S-------%%--------
------------------------------------------------------SSSSSSS---------|-|---------------------------------------------------------------------------------------SSSSS--SSSSSSSSS------||--------
----------------------------------------------------------------------|-|-----------------------------------------------------------------------------------------------S----SSS------||--------
----------------------------------------------------------------------|-|---oooo-oo-----------------------------------------------------------------------------SS---ooSSo---SSS------||-------%
--------%%%%%%%%---------------------------------oo---SSo----oo-------|-|---%%--%%%--------------------------------S@SQSSS---SSS-------------------------------------SSS----SS--%-----||--%%%--|
---------||||||-------------------------------------------------------|-|---|ooo-|---------------o-------------#------------------------------------------------S-----------SS--|-----||---|---|
---------||||||-------------------------------------------------------|-|---||---|-----------------------------#------------------------------------------------------------SS--|-----||---|---|
---------||||||-------------------o-----------------------SSSSSS------|-|ooo||---|-----------o-o--o-----------##------------------------------------------------------------Sooo|-----||-oooo--|
------%%%%%%%%%%----------######--S-------------S-------##------------|-%%%%||---|-----TT---------------------##QSQQ-SSSSSSSSSSS---------------------2----------SS--SSSSSSS----S%-----||%%%%%--|
-------||||||||---------------------------------------y###------------|--||-|ooo-|-----TT----------------TT---##----------------------------------TT-2--TT------SSTTSSSSSSS-----|-----||-|||---|
-------||||||||--------------------------------------#####------------|--||-%%%%-|-----TT----------------TT---##----------------------------------TT----TT------SSTTSSS-TT------|-----||-|||---|
-------||||||||-----------------------#------------#######--------rrrrrrr||--||--|gggk-TT--gy------ggg---TT--###---g------------------------------TT----TT--------TTSSS-TT---oSo|--rr-||-|||---|
XXXXXXXXXXXXXXXXXXXXXXXXXXXXXXXXXXXXXXXXXXXXXXXXXXXXXXXX@X--XXXX%%%%%%%%%%%%-||-XXXXXXXXXXXXXXXXXXXXXXXXXXXXXXXXXXXXXXXXXXX--XXXXoXXXXXXXXXXXX-XXXXXXXXXXXXXXXXXXXXXXXXXXXXXXXXX%%%%%%%%%%%%-%%%
XXXXXXXXXXXXXXXXXXXXXXXXXXXXXXXXXXXXXXXXXXXXXXXXXXXXXXXXXX--XXXX-||||||||||--||-XXXXXXXXXXXXXXXXXXXXXXXXXXXXXXXXXXXXXXXXXXX--XXX--XXXXXXXXXX---XXXXXXXXXXXXXXXXXXXXXXXXXXXXXXXXX-||||||||||---|-
