-----------------------------------------------------------------------------------K-------------------K---------------S----------------------------------S-------------------------------------
-----------------------------------------------------------------------------------o-ooo---------------o---------------S-------------------------SS-------S---S---------------------------------
-----------------------------------------------------------------------------------%%%%%%--------------%---------------S------------------------S-----SS-SSS-SSS--------------------------------
------------------------------------------------------------------------------------||||---------------|----------------------------------------SSSSSSSSSSSSSSSS----------SSSSSS----------------
--------------------------------------------------------------------------K---------||||---------------|----------------------------------------SSS-SSSSSSSSSSSS--------------------------------
------------------------------------------------------------------------------------||||---------------|----------------------------------------SSSS-SSSSSSSSSSS--------------------------------
--------%%%%%%%%SS-SSSS-------------QQQQ--------------------------------------------||||---------------|----------------------------------------SSSSSSSSoSSSSSSS-SS--------------%%%------------
---------||||||------------------------------------------------------------------ooro||o---o-----------|---oo%%%--------------------------------S---------------------------------|-------------
---------||||||-----------------------------------------------------------------%%%%%%%%%-%%%----------|------|-------------------------------------------------------------------|-------------
---------||||||------------------------------------------------------------------|||||||---|-----------|--o---|----------ooo-----------------------oggo-------oo--------TT--------|-------------
------%%%%%%%%%%----S----TT--US-##-----S-----SS----------------------------------|||||||---|-----------|-%%%--|-%%------%%%%%-------------------TT-SSSSS------SS--------TT--------|-------------
-------||||||||----------TT-------------------------------------S----------------|||||||---|--o--------|--|--oo-||-------|||-o------------------TT-----TT---------------TT--------|------TT-----
-------||||||||----------TT-------------------------------U----------------------|||||||---|%%%%-------|--|-%%%%||-------|||%%%%----------------TT-----TT---------------#T--------|------TT-----
-------||||||||----gggy--TT--------k--gg------------------------k----------------||rrr|rrrrr-||--------|--|--||-||-------|||-||-----------------TT-----TT---k--------kk--T------%-|----k-TT-----
XXXXXXXXXXXXXXXXXXXXXXXXXXXXXXXXXXXXXXXXXXXXXXXX-XXXXXXXXXXXXXXXXXXXXXXXXXXXXXXX-%%%%%%%%%%%%%%%--%----|--|--||-||---%%%%%%%-%%%XXXXXXXXXX---X-XXXXXXXXXXXXXXXXX-XXXXXXXXXXX-XXXXXX-XXXXXXXXXXXX
XXXXXXXXXXXXXXXXXXXXXXXXXXXXXXXXXXXXXXXXXXXXXXXXXXXXXXXXXXXXXXXXXXXXXXXXXXXXXXXX--|||||||||||||---|----|--|--||-||----|||||---|-XXXXXXXXXX-----XXXXXXXXXXXXXXXXXXXXXXXXXXXXX-XXXXXX-XXXXXXXXXXXX
