-----------------------------------------------------------------------K----------S---S---------------S----------------k------------------------------------------------------------------------
-----------------------------------------------------------------------o----------S------------------SS----------------S------------------------------------------------------------------------
----------------------------------------------------------------------%%%--------------------SSS------------------------------------------------------------------------------------------------
-----------------------------------------------------------------------|--------SSSSSSSSSSSSSSSSSSSSSSSSSSSSSSSS----------------SSSSSSSS--SSSSSS------------------------------------------------
-----------------------------------------------------------------------|--------SS--SSSS--------SS---SSSSSSS-SSS--------------------------------------------------------------------------------
-----------------ooo----oo-----o---------------------------------------|-------%SS-SSSSS----oSSS-----SSSSSSSSSSS------------oooo---------------S------------------------------------------------
--------%%%%%%%%------------------------------------------------%------|--%%%%-|SSSSSSSSo--SSSSS-SSSSSSSSS--SSS-%---------%%%%%-S--------------S-----------------------%%------------QQQ-------o
---------||||||-------------------------------------------------|------|---||--|--------------------------------|----------|||---------------------------------------%oo|----------------------#
---------||||||----------------------------#--------------------|------|---||--|--------------------------------|----------|||----------------------o----------------|-||--------------------##-
---------||||||----------------------------#-------------------o|------|---||--|ooooo--------ooo----ooo--------S|--------oooo|--S------------------------------------|-||--------------------###
------%%%%%%%%%%-----2---------------------#-----S--------%----S|------|%%%%%--|SSSSSS-------SSSSSSSSSSS--------|-----%%%%%%%|--S------------------------------------|-||-------########----###-
-------||||||||---------TT---------------##---------------|-----|------|-|||-oo|-------K--------S---------------|------|||||-|--S-------------------------------o----|tt|-------#--#--------####
-------||||||||---------TT----TT-------####---------------|-----|------|-|||%%%%--------------------------------|------|||||-|---------TT----#--TT--------------%----|tt|-------#-----------###-
-------||||||||---k-----TT----TT------#####-------ggg-----|-----|--rr--|-|||-||-------k----kk-----------------ko|--r---|||||-|---------TT----#--TT-----k----kkk-|----|tt|--g-g-g#--k------#-####
XXXXXXXXXXXXXXXXXXXXXXXXXXXXXXXXXXXXXXXXXXX-----XXXXXXXXXXX-----|%%%%%%%%%%%-||-XXXXXXXXXXXXXXXXXXXXXXXXXXXXXXXX%%%%%%%%%|||-%%-XXXXXXXXXXXXXXXXXXXXXXXXXXXXXXXXXXXXXXXXXXXXXXXXXXXXXXXXXXXXXXXX
XXXXXXXXXXXXXXXXXXXXXXXXXXXXXXXX--XXXXXXXXX-----XXXXXXXXXXX-----|-|||||||||--||-XXXXXXXXXXXXXXXXXXXXXXXXXXXXXXXX-|||||||-|||-||-XXXXXXXXXXXXXXXXXXXXXXXXXXXXXXXXXXXXXXXXXXXXXXXXXXXXXXXXXXXXXXXX
