-------------------------------------------------------------------------------------------------------K----------------------------------------------------------------------------------------
-------------------------------------------------------------------------------------------------------o----------------------------------------------------------------------------------------
------------------------------------------------------------------------------------------------------%%----------------------------------------------------------------------------------------
--------------------------------SSSSSSSSSSSSSSSS--------------------------------SSSSSSSS-----SSS------||--------------------------------------------------------SSS---SSoSSSSSSS----------------
--------------------------------S------SS-------------------------------------------------------------||----------------------------------------------------------------------------------------
---------------------------------------S-------S-------------------------------------------oo---------||-----r----------------------------------------------------------------------------------
--------%%%%%%%%-----------------SSSSSSS--SS-SSS--------------------QQQQQS---------------SSSSS--%-----||---%%%%-----------------SSooS-SS------o------------------%%-------oooo-------SSS--------
---------||||||---------------------------------------------------------------------------------|-o---||----||---------------------------------------------------||-----------------------------
---------||||||-----------------------------------------------------------------#---#-----------%%%%--||----||--------------------------------oo-----------------||---%%%%-----S----------------
---------||||||-----------------ooooo------##--#-----------------------g--------#---#------------||---||-oooo|------------------o--------------------------------||----||-----------------------
------%%%%%%%%%%----------######SSSSSS----####-------------------##--S@QQ---S@S-T----------------||---||%%%%%|-------------------------------SS------------------||----||-----------------------
-------||||||||--------------------------####--------------------##-------------T------------##--||---||-|||-oo--------------------------------------------------||----||-----------------------
-------||||||||-------------------------######----o------##------#--------------T------------##--||---||-|||%%%%-------------------------------------------------||----||K----------------------
-------||||||||-----------------------g########--%%%-----##------#-k------k-k---T------k----###--|rrr-|r-|||-||--------------ooo----gg----k----------------------||----||gg---------ggg-----kkk-
XXXXXXXXXXXXXXXXXXXXXXXXXXXXXXXXXXXXXXXXXXXXXXXX--XXXXXXXXXX%%--XXXXXXXXXXXXXXXXXXXXXXXXXXXXXXXX%%%%%%%%%%%%-||----XS%S------%%%XXXXXXXXXXXXXXXX%%%%%%%%%%X---%-XXXXXXXXXXXXXXXXXXXXXXXXXXXXXXXX
XXXXXXXXXXXXXXXXXXXXXXXXXXXXXXXXXXXXXXXXXXXXXXXX---XXXXXXXXX||--XXXXXXXXXXXXXXXXXXXXXXXXXXXXXXXX-||||||||||--||---XX-|--------|-XXXXXXXXXXXXXXXX-||||||||-----|-X---XXXXXXXXXXXXXXXXXXXXXXXXXXXX
