-----------------------------------------------------------------------SSS----------------------------------------------------------------------------------------------------------------------
---------------------------------------------------------------------SSSSSS------K--------------------------------------------------------------------------------------------------------------
-----------------------------------------------------------------------S------------------------------------------------------------------------------------------------------------------------
-------------------------------------------------------------------------------------------------------------------------------------------------------------------------------------------SSSSS
------------------------------------------------------------------------------------------------------------------------------------------------------------------------------------------------
--------------------------------------------------------------------------------------------------------------------------------------------------------------------------oo--------------------
--------%%%%%%%%--------------------SSSS------------QQQSSSSSSSSS------SS--------SSSS----------------QQ----------S---SSSS----------o----------o--------------------------------------------------
---------||||||---------------------------------------------------------------------------------------------------------------------------------------------------------------------------------
---------||||||------------------------------------------------------------------------------------------------------------------------------SSS------------------------------------------------
---------||||||---------------------------------------------------------------------o----------------------------g-----g------oo-----------ooo-----------ooo-----------------------------------S
------%%%%%%%%%%----------######----SSSSSSSSS@So-------SSSSSS@S-SSSS-SSS--------------------------------%%%%%SS-SSSSSS-S--------S-----------SSSSQoQo-----%%%---------2----------------S---------
-------||||||||--------------------------------------------------------------------------TT--------------|||-----------K-----#----------------------------|-----TT-----TT-----------------------
-------||||||||--------------------------------------------------------------------------TT--------------|||-----------------#-------------------------##-|-----TT-----TT-----#-----------------
-------||||||||------------------------------------kgg---------g-------------------------TT--------r-----|||-------k-kkk----##------------------------###-|-----TT-----TT-----##----------------
XXXXXXXXXXXXXXXXXXXXXXXXXXXXXXXXXXXXXXXXXXXXXXXX-XXXXXXXXXXXXXXXXXXXXXXXXXXXXXXXXXXXXXXXXXXXXXXX-%%%%%XXXXXXXXXXXXXXXXXXXXXXXXXXXXXXXXXXXXXXXXXXXXXXXXXXXX|-----XXXXXXXXXXXXXXXXXXXXXXX--X-XXXX-
XXXXXXXXXXXXXXXXXXXXXXXXXXXXXXXXXXXXXXXXXXXXXXXX-XXXXXXXXXXXXXXXXXXXXXXXXXXXXXXXXXXXXXXXXXXXXXXX--|||--XXXXXXXXXXXXXXXXXXXXXXXXXXXXXXXXXXXXXXXXXXXXXXXXXXX|-----XXXXXXXXXXXXXXXXXXXXXXX--X-XXXXX
