---------------------------------------K-------------------------------------------------------------------------------K------------------------------------------------------------------------
-------------------------------------o-o-------------------------------------------------------------------------------o------------------------------------------------------------------------
-------------------------------------%%%%-----------------------------------------------------------------------------%%%-----------------------------------------------------------------------
--------------------------------------||------------SSSSSSSS----------------------------------------------------SS-----|------------------------------------------------------------------------
--------------------------------------||-------------------------------------------------------------------------------|------------------------------------------------------------------------
--------------------------------------||---oooo-------------------------------SS--o------------------------------------|---------------------------------ooo------------------------------------
--------%%%%%%%%----------------------||--%%%%%%-S---SSSSSSSSSSS--------------SS----------------------------2-------o--|---------------------------------------------------------o-----SS-------
---------||||||------------------oo---||---||||o-----------------------------------------------------------------%%%%%%%---oro-------------------------------ooo------oo------------------------
---------||||||-----------------%%%%--||---||||----------------------------------------TT-------------------------|||||---%%%%%-----------------------------------------------------------------
---------||||||------------------||---||---r|||-o-------------------------ooo----------TT-------------------------|||||----|||------------------------------------------------------------------
------%%%%%%%%%%----------######-||---||%%%%%||-------------------------%%%%%----------TT------------S------------|||||----|||-----------------------2---------------------S--------------------
-------||||||||------------------||---||-|||-oo--------K-----------------|||-ooo-------##-----------------------o-|||||----|||--------------------TT----TT--------------------------------------
-------||||||||------------------||---||-|||%%%%-------------------------|||%%%%-##-----------------------------%%|||||----K||--------------------TT----TT----TT--------------------tt----------
-------||||||||------------------|rrrrrrrrr|-||------k-k-----g----rrr----|||-||--##---------k---k------------o--|||||||----|||-------------k----k-TT----TT----TT---rr---------------tt----------
XXXXXXXXXXXXXXXXXXXXXXXXXXXXXXXX%%%%%%%%%%%%%||-XXXXXXXXXXXXXXXX%%%%%%%%XX||-||-XXXXXXXXXXXXXXXXXXX-------XX---X||||||XXXX%%%%%-XXXXXXXXXXXXXXXXXXXXXXXXXXXXXXXX--%%%%%%%%%-----XXXXXXXXXXXXXXXX
XXXXXXXXXXXXXXXXXXXXXXXXXXXXXXXX-|||||||||||-||-XXXXXXXXXXXXXXXX-||||||XXX||-||-XXXXXXXXXXXXXXXXXXX-------XX---X||||||-XXX-|||--XXXX-XXXXXXXXXXXXXXXXXXXXXXXXXXX---|||||||------XXXXXXXXXXXXXXXX
