-------------------------------------------------------------------------------------------------------K----------------------------------------------------------------------------------------
-------------------------------------------------------------------------------------------------------o-----------------------------SS---S-----------------------------------------------------
------------------------------------------------------------------------------------------------------%%%---------------------------------------------------------------------------------------
----------------------------------------------------------------SSSSSSSSSSSSSSSS-----------------------|------------------------------------------------------------------------SSSSSSSSSSSSSSSS
-----------------------------------------------------------------------S-----SS------------------------|------------------------------------------------------------------------SS---S-----S---S
-------------------------------------------o--------------------S----------o-SSS-----------------------|-------------------------------------------------------------------------S---S-----oSSSS
--------%%%%%%%%--------------------------------------------S---SSSSSSSSS-SSSSSS----------------%------|--%%%%%--oQ-QSQS@SSSSSSS-SoS-SSSo---US-----------------------------------S---SSSSSSSSSSS
---------||||||--------------------------------o------------S-----------------------------------|------|---|||------------------------------S-----o---oo----------------------------------------
---------||||||---------------------------------------TT----------------------------------------|------|---|||-----------------------------------%%--------------------------o------------------
---------||||||-----------------------------##-o------TT---------o-oo--------##o----------------|------|-o-|||---------g---------------g-----o-o-||--------o------------------------------------
------%%%%%%%%%%----------######-------TT--####-------##--------SSSSS--TT---####-------TT-------|------|%%%%%|--Q-QQSSSSS---S@S----SSSS#Q-----S--||--------------------------U------------------
-------||||||||------------------------TT--####-----------------TT-----TT---###--------TT----#--|------|-|||-|----------------------S------------||-----------------------K-----------tt--------
-------||||||||------------------------TT--####-----------K-----TT----TT---####--------TT----#--|------|-|||-%%%-------------#----------K--------||-----------------------------------tt--------
-------||||||||-----------------k----k-TT--####-----------------TT----TT---####-------###----#--|-orr--|-|||--|----kgg--------k------------------||---------------kk-k-y------k-------tt-----k--
XXXXXXXXXXXXXXXXXXXXXXXXXXXXXXXXXXXXXXXXX--XXXXX-XXXXXX---XXXX-XXXXXXXXXXXXXXXXXXXXXXXXXXXXXXXXX%%%%%%%%%|||--|-XXXXXXXXXXXXXXXXXXXXXXXXXXXXXXXX-||-%%%%%%%-----XXXXXXXXXXXXXXXXXXXXXXXXXXXXXXXX
XXXXXXXXXXXXXXXXXXXXXXXXXXXXXXXXXXXXXXXXXXXXXXXX-XXXXXX---XXXXXXXXXXXXXXXXXXXXXXXXXXXXXXXXXXXXXX-|||||||-|||--|-XXXXXXXXXXXXXXXXXXXXXXXXXXXXXXXX-||--|||||------XXXXXXXXXXXXXXXXXXXXXXXXXXXXXXXX
