----------------------S--------------------------------------------------------------------------------------------------------------------------------K----------------------------------------
----------------------S------------------------------------------------------------------------------------------------o-------------------------------o---------------o------------------------
------------------------------------------------------------------------------------------------------------------------------------------------------%%----------------------------------------
----------------SSSSSSSSSSSSSSSSSSSSSSSSSSSSSSSS--------------------------------SSSSSSSSSSSSSSSS--------------SS----------------SSSSSSSSSS--SSSS------||------------------------------SSSSSSS---
----------------SS-SSSSSSS-SSSSS---------------------------------------------------------------------%%%----------------------------------------------||----------------------------------------
----------------SSS-SSSSSSSSSSSS----------------------------------------------------------------------|-----------------------------------------------||----------------------%%----------------
--------%%%%%%%%SSSSSSSSSSSSSSSS-------------------------------------------%%------------------o%%%%--|--ooo---------------------------%%%------%-----||---%%-----------------||oooo----o-------
---------||||||------------------------------------------------o-----------||--------------------||---|---------------------------------|-------|-----||---||-----------------||----------------
---------||||||---------------S--------------------------------------------||--------------#####S||--S%%%%%%%---------------------------|-------|-----||---||-----------------||----------------
---------||||||-o-------------So-----oo------------------------------------||--------------#####S||----|||||---------%%-----------------|-------|-----||-oooo------------ooo--||----------------
------%%%%%%%%%%S--SS---###---SS--TT--S-------------------------------%%%%%%S-------------######%%|----|||||---------||-----------------|-------|-----||%%%%%%----------%%%%--||----------------
-------||||||||-S-----y####-------TT----TT-----------------------------||||--------------#######|||----|||||---------||--------oo-------|-------|-----||-||||------------||--oo|----------------
-------||||||||-------####--------TT----TT--------------TT-------------||||-------------#######-|||----|||||---#-----||--------#%%------|-------|-----||-||||------------||-%%%%---##-----------
-------||||||||------######-----k-TT--k-TT--------g-----TT-------------||||-----k----y-########-%||----|||||---#-----||--------#||------|-------|--rr-||-||||------rr----||--||----##-----------
XXXXXXXXXXXXXXXXXXXXXXXSXXXXXXXXXXXXXXXXXXXXXXXXXXXXXXXXXXXXXXXX-%%%%%%%%%%-----XXXXXXXXXXXXXXX-|%%%--%%%%%X-%%X-%%%-|%%%%%XXXXX||--XXXXXXXXXXXX|%%%%%%%%%%%%%%%-%%%%%%%%%%%-||-XXXXXXXXXXXXXXXX
XXXXXXXXXXXXXXXXXXXXXXXXXXX--XXXXXXXXXXXXXXXXXXXXXXXXXXXXXXXXXXX--||||||||------XXXXXXXXXXXXXXX-|-|----|||-X-||---|--|-|||-X-XXX||---XXXXXXXXXXX|-|||||||||||||---|||||||||--||-XXXXXXXXXXX-XXXX
