------------------------------------------------------------------------------------------------------------------------------------------------------------------------------------------------
------------------------------------------------------------------------------------------------------------------------------------------------------------------------------------------------
------------------------------------------------------------------------------------------------------------------------------------------------------------------------------------------------
--------------------------SSSS----------------------------------------------------------------------------------SSSSSSSS------------------------SSSSSSSSSS---S----------------------------------
------------------------------------------------------------------------------------------------------------------------------------------------------------------------------------------------
----------------------------------------------------------------------------------o------------o------------------------------------------------------------------------------------------------
--------%%%%%%%%--------o--------------SSSS-------------------------------------------------------------------------------------------------------------S----------------------o%%%-------------
---------||||||------------------------------------------------#---------------------------o------------------------------#oo--------------------------------------------------#-|-----o--------
---------||||||-----------------S------------------------------#---------------------------------------------------------##--------------------------------------------------###-|----%%--------
---------||||||---------S-------------------o----------k-------#-------------------------ooo-----------------------------#----------------#---------------------------------####-|----||--------
------%%%%%%%%%%---------------------------S-----------#%-----##-------------------------%%%-----------------------------#---------------##-------------------------------##-###-|----||--------
-------||||||||-----------------------------------------|-----##------------------TT------|----------------------------###---------------##------------------------------#######-|----||--------
-------||||||||---#-------------------------------------|-----%%o--------TT-------TT------|---------------------------####--------------###------------------------------#######-|----||-----%%%
-------||||||||---#---------k---------------------------|-----##---------TT-------TT------|--------------------------#####------------g####----------g-----------------#########-|----||------|-
XXXXXXXXXXXXXXXXXXXXXXXXXXXXXXXX-%%%%%%----%%%%%%%%%%%%%|-----X--%%----X-XXXXXXX-XXX-XXX%XX-----%%%%-X%%%%XX-X--XXXXXXXXXX---XXX-XXXXXXXXXXXX-XXXXXXXXXXXXXXXXXXXXXXXXXXXXX-XXXXX%X%XXXX%%%XXXXX
XXXXXXXXXXXXXXXXXXXXXXXXXXXXXXXX--||||------|||||||||||-|-----X--||----X-XXXX-XX-XXX-XXXX-------X||----X|XXX---XXXXXXXXXXX---XXX-XXXXXXXXXXXX-XXXXXXXXXXXXXXXXXXXXXXXXXXXXXXXXXXX|X|--XXXXXX-XXX
