----------------------------------------------------------------------------------------------------------------------------------------------S------------------------K------------------------
-----------------------------------------------------------------------------------------------------------------------------------------------------------------------o------------------------
----------------------------------------------------------------------------------------------------------------------------------------------S------------------------%------------------------
--------------------------------SSSSSS---------------------------------------------------------------------------------------------------------------------------------|------------------------
-----------------------------------------------------------------------------------------------------------------------------------------------------------------------|------------------------
------------------------------------------------------------o----------------------------------------------------------------------------------------------------------|------o-----------------
--------%%%%%%%%------------------rrr---%-----------QQQQQ--------------SSS-----------oo--------o------SSSS-------ooo------------SSoSSSSSSSSSSSSS%%%--------------------|----%%%-----------------
---------||||||-----------------%%%%%%%%|------%-----------------------o-------------------#----------oo-----------------------------------------|---------------------|-----|------------------
---------||||||------------------||||||-|-%%---|-------------------------------------------#---S-------------------------------------------------|--------------%%%%---|-----|------------------
---------||||||------------------||||||-|-||---|-------g---------------k---------#--------##-----S-----------S--------------------------------oo-|---------------||----|-----|------------#-----
------%%%%%%%%%%----------######-||||||-|-||---|##Q#--SQQS---S---oo---S#SS-------##------####---------------SS------------------S---SSSS-----SSS-|---------------||----|%%%%%|-----------##-----
-------||||||||-----------------o||||||-|-|#---|---------------------------------##-----#####----------------------------------#-----------------|---------------||----|-|||-|-----------#------
-------||||||||-----------------%%|||#|-|###---|--------------------------------####---######----------------------------#-#--##-----------------|---------------||----|-|||%%%%-------###------
-------||||||||-----------------|||||#|-|-##---|---k--------------gr------------####--######k----------------------------###-###-----kk----------|-----k---------||----|-|||-||--------###-----o
XXXXXXXXXXXXXXXXXXXXXXXXXXXXXXXX|||||XXXXXXX---|XXXXXXXXXXXXXXXXXXXX%S----------XXXXXXXXXXXXXXXXXXXX--XXXX--XXXX--XXXXXXXXXXXXXXXXXXXXXXXXXXXXXXXXXXXXXXXXXXXX%X-%%%XXX%%%%|-%%%--XXXXXXX-------
XXXXXXXXXXXXXXXXXXXXXXXXXXXXXXXXX|X||XXXXXXX---XXXXXXXXXXXX-XXXXXXXX|-----------XXXXXXXXXXXXXXXXXXXX--XXXX--XXXX--XXXXXXXXXXXXXXXXXXXXXXXXXXXXXXXXXXXXXXXXXXXXXX--|--X-X||-|--|---XXXXXXX-------
