---------------------------------------K-----------------------------------K---------------------------K----------------------------------------------------------------------------------------
---------------------------------------o-----------------------------------o---------------------------o------------------S---S-----------------------------------------------------------------
--------------------------------------%%%---------------------------------%%%---------------------------------------------S--SSS----------------------------------------------------------------
----------------SSSSSSSSSSSSSSSS-------|-----------------------------------|---------SSSSSSSSSSS--------------------------SSSSSSSSSS------------------------------------------------------------
---------------------------------------|-----------------------------------|------S--SS---------------------------------------------------------------------------------------------------------
---------------------------------------|------%%---------------------------|----------------------------------oo-SSS-------oooSS---------o------------------------------------------------------
--------%%%%%%%%-----------------------|------||----------------------o%%%%%%%----------------------------------SSSSSSSSSSSSSSSS----------------------------------------------------------------
---------||||||-----------------%%%%---|---o-%%%---------------#--%%%%%%|||||----------------------------------o-------------------------------------------------o----------oooo-----------ooooo
---------||||||------------------||----|--%%%-|---------------##---||||-|||||-------------------------------------------------------------------------------------------------------------------
---------||||||------------------||----|---|--|---------#-----##---||||-|||||---o---ooo--------S-----------------oooooooo----ooo----------------------------------------------------------------
------%%%%%%%%%%--------TT-------||----|---|--|--------###---###---||||-|%%%%%S-S-----S-----------------%%%%----SSSSSSSSSSSSSSSS-----------------------TT---------------------------------------
-------||||||||---TT----TT---TT--||----|---|--|--------##---####---||||-|-|||----------------------------||--o--------------------TT----TT----TT-------TT---------TT----------------------------
-------||||||||---TT----TT---TT--||----|---|--|-------####-#####---||||-|-|||----------------------------||-%%%%------------------TT----TT----TT-------TT---------TT----TT----------------------
-------||||||||---TT----TT---TT--||----|---|--|o-----####--#####-oo||||-|-|||------g---------ooo---------||--||------gg-----------TT----TT----TT-----#-TT---k-----TT----TT-----o----------------
XXXXXXXXXXXXXXXXXXXXXXXXXXXXXXXX-||----|--%%%%%%XXXXXXXXXX-XXXXX%%%%|||XXXXX%%--XXXXXXXXXX-XXXXX-%%%%%XXX||--||-XXXXXXXXXXXXXXXX--XXXXXXXX----XXXXXXXXXXXXXXXXXX-XXXXXXXXXXX-%%%-oXX--XXXXX%%%--
XXXXXXXXXXXXXXXXXXXXXXXXXXXXXXXX-||----|---||||-XXXXXXXXXXXXXXX--||-|||XXXXX||--XXXXXXXXXX-XXXXX--|||--X-||--||-XXXXXXXXXXXXXXXX--XXXXXXXX------XXXXXXXXXXXXXXXXXXXXXXXXXXXX--|-------XXXXX-|--X
