----------------------------------------------------------S-------------------------------------------------------------------------------------------------------------------------------------
------------------------------------------------------------------------------------------------------------------------------------------------------------------------------------------------
-------------------------------------------------------------------------------------------------------------SSo--------------------------------------------------------------------------------
----------------------------------------------------------------SSSSSSSSSSSSSSSSSSSSSSSSSSSSSSSSSSSSSSSSSSSSSSSS--------------------------------------------------------------------------------
-----------------------------------------------o---------%------S---------------SS-----S-----S--S-S-------SS-------------%----------------------------------------------------------------------
---------------------------------------------------------|-----S----------------SS-----S-o-o-SSS--S--------oooSS---------|----oS-----------------------------o-o--------------------------------
--------%%%%%%%%--------------------------------%--------|o----------------o-o-----------SSSoSSSSSSSSSSSSSSSSSSS%--------|----%%------------------------------------------------%SS@------------
---------||||||---------------------------------|------o-|or----------------------------------------------------|----rrr-|-r--||------------------------------------------------|---------------
---------||||||---------------------------------|-%%%%%%%%%%%---K---------SSSSS---------------------------------|%%%%%%%%%%%%-||------------------------------------------------|---------------
---------||||||---------------------------------|--|||||||||--------------SS-SS-------------------oo----------oo|-|||||||||o--||----------oo------------------------------oo----|---------------
------%%%%%%%%%%----------######----------------|--|||||||||----%-------------------------------SSSSSS-------SSS|-|||||||%%%%%S%---------------------2--------------------%%----SSQ--------SS@S-
-------||||||||---------------------------------|--|||||||||----|-----------------------TT----TT----------------|-|||||||-|||--|---------------o-------TT-----------------||--------------------
-------||||||||-----------------TT--------------|--|||||||||----|-----------------------TT----TT----------------|-|||||||-|||--|-----------------------TT-----------------||--------------------
-------||||||||-----------------TT---kkg--------|--r||||||rr----|-----------------------TT----TT-------k--------|-o||||||-|||--|---------------o--g----TT------g----------||------ggg-----k-k---
XXXXXXXXXXXXXXXXXXXXXXXXXXXXXXXXXXXXXXXXXXXXXXXX|%%%%%%%%%%%%%%%|---XXXXXXXXX%-XXXXXXXXXXXXXXXXXXXXXXXXXXXXXXXXX|%%%||%%%-|||%%%XXXXXXXXXX------XXXXXXXXXXXXXXXX-oXXXXXX-%%|----XXXXXXXXXXXXXXXX
XXXXXXXXXXXXXXXXXXXXXXXXXXXXXXXXXXXXXXXXXXXXXXXX|-|||||||||||||-|--XXXXXXXXXXX-XXXXXXXXXXXXXXXXXXXXXXXXXXXXXXXXX|-|-||-|--|||-|-XXXXXXXXXX------XXXXXXXXXXXXXXXX--XXXXX--|||----XXXXXXXXXXXXXXXX
