------------------------------------------------------------------------------------------------------------------------------------------------------------------------------------------------
--------------------------------------------------------------------------------------oo--------------------------------------------------------------------------------------------------------
-------------------------------------------------------------------------------------%%%%-------------------------------------------------------------------------------------------------------
--------------------------------SSSSSSSSSSS---------------------SSSSSSSSSSSSSSSS------||--------SSSSSSSSSSSSSSSS--------------------------------SSSSSSSSSSSSSSSS--------------------------------
--------------------------------------------------------------------------------------||-------------SS-----------------------------------K-----SS--SSSS----------------------------------------
--------------------------------------------------------------oo-----------------r----||-----oo%---------------S---------------------------------S----SS---SoSSS--------------------------------
--------%%%%%%%%-----------------------o-------o-------------%%%----------------%%%%--||---%%%%|------------------------------------------------SS----SS---SSSSS---SQQQ-------------------------
---------||||||----------------------------#------------------|------------------|o---|o----||-|SS-----------------------------#----------------------------------------------------------------
---------||||||---------------------------##------------------|------------------%%%--%%%---||-|SSSSS-------------------------##----------------------------------------------------------------
---------||||||---------------------------##---------------o--|-------------------|----|-oo-||-|S----------------------------###----------------S--------------o--------------------------------
------%%%%%%%%%%----------######---------###------------%%%%%%%%-------###-#------|----|%%%%||-|--SS##S-----------######----####-----SSS-S------S--------------SQ--------S--S@SS----------------
-------||||||||-------------------#-----####-------------||||||o------####-#------|----|-||-|oo|----------------------------####----------------------y#-----TT---------------------------------
-------||||||||------------------###---#####-------------||||||%--#---####--------|----|-||-%%%%---------------------------#####----------------------###----TT---------------------------------
-------||||||||-----------------###---######------o------|||||||-#########--------|---rrrrr--||------------gg-g-#----------#####----------------k----####----TT----ggg----kkk------------------#
XXXXXXXXXXXXXXXXXXXXXXXXXXXXXXXXXXXXXXXXXXXXXXXX-%%%XXXXXXXX||||XXXXXXXXXXXXXXXX-%%%%%%%%%%%-||-XXXXXXXXXXXXXXXXXXX----XXXXXXXXXXXXXXXXXX-XX---XXXXXXXXXXXXXXXXXXXXXXXXXXXXXXXXXXXXXXXXXXXXX-XXX
XXXXXXXXXXXXXXXXXXXXXXXXXXXXXXXXXXXXXXXXXXXXXXXX--|-XXXXXXXX||||XXXXXXXXXXXXXXXX--|||||||||--||-XXXXXXXXXXXXXXXXXXX---XXXXXXXXXXXXXXXXXXX-XX--XXXXXXXXXXXXXXXXXXXXXXXXXXXXXXXXXXXXXXXXXXXXXX-XXX
