------------------------------------------------------------------------------------------------------------------------------------------------------------------------------------------------
------------------------------------------------------------------------------------------------------------------------------------------------------------------------------------------------
------------------------------------------------------------------------------------------------------------------------------------------------------------------------------------------------
------------------------------------------------------------------------------------------------------------------------------------------------------------------------------------------------
------------------------------------------------------------------------------------------------------------------------------------------------------------------------------------------------
--------------------------------------------oo-----------------------------o----------------ooo---------------------------------------------------------------oo--------------------------------
--------%%%%%%%%--------------------------------------------------------------------------------------------------------------------QQQQQ------o--------------SS--------------------------------
---------||||||------------------------------ooo-------------------------------#-----------------------------------------------------------------oo---------------------------------------------
---------||||||---------------------------------------------------------------##------#--------------o------------------------------------------------------------------------------------------
---------||||||--------------------------------------------------------------###------#------------------------------------------gg-g-----------------------------------------------------------
------%%%%%%%%%%----------######----------%---------------------TT-----TT---####---------%%%S------------TT----------------------#####-S-----------------------o-------------------------TT-----
-------||||||||---------------------------|---------------------TT-----TT---###-----------|----o--TT-----TT--------------#-----------K-S-----#-------------------------------------------TT-----
-------||||||||---------------------------|-------#----TT-------TT-----TT--####-----------|-------TT-----TT-------------##------------------##---------------------------#---------------TT-----
-------||||||||-------------------------g-|------##----TT----k--TT-----TT--####-----------|----kk-TT--k--TT------------###-----------k-k----##----ggg-----#----o---------#---------gggy--TT---ko
XXXXXXXXXXXXXXXXXXXXXXXXXXXXXXXX%%%%-XXXXXXXXX--XXXXXXXXXXXXXXXXXXXXXXXXXXXXXXX-XXXXXXXXX-X--XXXXXXXXXXXXXXXXXXX--XXXXXXXXXXXXXXXXXXXXXXXXXXXXXXXXXXXXXXXXXXXXXXXXXXXXXXXXX--X-XXXXXXXXXXXXXXXXX
XXXXXXXXXXXXXXXXXXXXXXXXXXXXXXXXXXX--XXXXXXX----XXXXXXXXXXXXXXXXXXXXXXXXXXXXXXX-XXXXXXXXX-X--XXXXXXXXXXXXXXXXXXX--XXXXXXXXXXXXXXXXXXXXXXXXXXXXXXXXXXXXXXXXXXXXXXXXXXXXXXXXX--X-XXXXXXXXXXXXXXXXX
