------------------------------------------------------------------------------------------------------------------------------------------------------------------------------------------------
-------------------------------------------------------------------------------------------------S--------S---S---------------------------------------------------------------------------------
------------------------------------------------------------------------------------------------------S--SSS-SSS--------------------------------------------------------------------------------
--------------------------------SSSSSSSSSSSSSSS-------------------------------------------------SSSSSSSSSSSSSSSSSSSSSSSS------------------------------------------------------------------------
-------------------------------------S----------------------------------------------------------SSS-SSSSSSSSSSSS--------------------------------------------------------------------------------
------------------------------------------------------------------------------------------------SSSSSSSSSSSSSSSS------------------o-------o-o-----------------------------------------------o---
--------%%%%%%%%------------------------S-------------------------------------------------------SSSSSSSSSSSSSSSS-------------------------------------QQQ----------------------------------%%%---
---------||||||------------------------------------------------#-----------------------------%%%---------------------------------------------------------------------------##--------------|----
---------||||||----------------------------S%%S----------------#---------------------#--------|---------------------------------------------------------------------------####-------------|----
---------||||||-----------------------------||----------------##---------ooo--------##--------|-oooooooo-----ooo-o----------#---------------------------------------------####-------------|----
------%%%%%%%%%%----------######------------||----------------##-------#%%%%------------------|-SSSSSSSSSSSSSSSS------------#--------S@#-SSSSSS--SQo--S@-----------------#####--------%%%%%%%%--
-------||||||||---------------------tt-----#||---------------###---------||--ooo--------------|-------KSSSS----------------##-------------------------------------------#####----------||||||--o
-------||||||||---------------------tt---###||---------------###---------||--%%----------TT---|##------S-TT---------------###------------------------------------------######----------||||||---
-------||||||||---------------------tt---###||-----gg--------###---r-----||--||----------TT---###---ggkS-TT---So-----ggg--###-----------------------------k-------g---#######--#-------||||||---
XXXXXXXXXXXXXXXXXXXXXXXXXXXXXXXX---XXXXXXXXX||-XXXXXXXXXXXXXXXXX-%%%%%%%%%%--||----XXXXXXXXXXXXXXXXXXXXXXXXXXXXXXXXXXXXXXXXXXXXXXX%%%%----X----XXXXXXXXXXXXXXXXXXXXXXXXXXXXXXXXX-%%%%%%%%%%||---
XXXXXXXXXXXXXXXXXXXXXXXXXXXXXXXXX-XXXXXXXXXX||-XXXXXXXXXXXXXXXXX--||||||||---||----XXXXXXXXXXXXXXXXXXXXXXXXXXXXXXXXXXXXXXXXXXXXXXX-||-----X---XXXXXXXXXXXXXXXXXXXXXXXXXXXXXXXXXX--||||||||-||---
