-----------------------------------------------------------------------------------------------------S---SS----------------------------S--------------------------------------------------------
-----------------------------------------------------------------------------------------------------SS-SSS----------------------------o--------------------------------------------------S-----
--------------------------------------------------------------------------------------------------------------------------------------%%-------------------------------------------------SSS----
------------------------------------------------SSSSSSSSS-----------------------SSSSSSSSSSSSSSSS--------SSS---SSSSSSSSSSSSSSSSSS------||----------------------------------------SSSSSSSSSSSSSSSS
--------------------------------------------------------------------------------SS---S----SSSS-S--------------SS----------------------||----------------------------------------SSS-SSSSSSSSSSSS
--------------------------------------------------------------------------------SS---SS---ooSSSS-S-----SS----g-------------o---S------||----------------------------------------SSSSSSSSSSSSSSSS
--------%%%%%%%%-----------------------SSS----SoSSSSSS--o-----So---------------------SSSSSSSSSSS-S----------SS------------SS--SS------||-------------QQQQ----------------------oSSSSSSSSSSSSSSSS
---------||||||--------------------------------#------------------------------------------------------------SS------------------#-----|o-------------------------#------------------------------
---------||||||---------------------------------------------------------------------------------------------SS------------------------%%%-%%%---------------------------------------------------
---------||||||-------------------------------##oooooo---------o--------------------------------------------SS--o--------------o-------|---|-------------------------------------ooooo----------
------%%%%%%%%%%----------######--------Q-----##SSSS#S-----#-#----------------------------------SSSSSSSS-SS----SS--------------S-------|---|----TT--SSSSS----------------TT-----SSSSSSS-TT------
-------||||||||------------------------------###----------####-----------------TT-----tt--------S-SSSS---------S-------------#---------|---|----TT-----------------------TT-----SSSS-TT-TT------
-------||||||||-----------------------------####-------#######-----------------TT-----tt---#----SSSSSSSS-S-------------TT--#-#---------|---|----TT-----------------------TT-----SSS--TT-TT------
-------||||||||-------------------oo--------####-#----########----kgg----------TT-----tt---#----SSSSSSSS------SS-------TT--k-k---------|---r----##-k-k----k-k--------k-k-TT----------TT-TT-----#
XXXXXXXXXXXXXXXXXXXXXXXXXXXXXXXXXXXXXXXXXXXXXXXXXXXXXXXXXXXXXXXXXXXXXXXXXXXXXXXXXXXXXXXXXXXXXXXX-XXXXXXX-US----XXXXXXXXXXXXXXXXX%%%%--X%%%%%%%%-XXXXXXXXXXXXXXXXXXXXXXXXXXXXXXXXXXXXXXXXXXXXXXXX
XXXXXXXXXXXXXXXXXXXXXXXXXXXXXXXXX-XXXXXXXXXXXXXXXXXXXXXXXXXXXXXXXXXXXXXXXXXXXXXXXXXXXXXXXXXXXXXXXXXXXXXX-X-----XXXXXXXXXXXXXXXXX-||-----|||X||--XXXXXXXXXXXXXXXXXXXXXXXXXXXXXXXXXXXXXXXXXXXXXXXX
