-------------------------------------------------------------------------------------------------------------------------------------------------------S----------------------------------------
-------------------------------------------------------------------------------------------------------------------------------------------------------S----------------------------------------
------------------------------------------------------------------------------------------------------------------------------------------------------------------------------------------------
--------------------------------S---------------S-----oooooo-SSS--------------------------------SSSSSSSSSSSSSSSS----------------------------------------------------------------SSSSSSSSSSSSSSSS
----------------------------------------------------%%%%%%%%---S--------------------------------SSSSSSSSSS---S-S-----------------------------------------------S---------------SS----SS---------
-----------------------------------------------------||||||--------------------o----------------SSSSSSSS-SS-SSSS----------oooooo-----------o-------------------S----------------S---------------
--------%%%%%%%%-------------------------------------||||ooo-------------------S------------------S--SSSSSSSSSSS--------------------------------S----------------------o----------------oo---oo-
---------||||||--------------------------------------||r||rr----------or--rr---------------o----------------------------------oo---------------#--------------------------------S---------------
---------||||||------------------------------------%%%%%%%%%%%-------%%%%%%%%---------------------------------------------------------------------------------------------------S---------SS-SSS
---------||||||---------------------------------o---|||||||||---------||||||--------------------ooo----o----------------------##--g------------------------oo-------------------S-------------SS
------%%%%%%%%%%----------######----------------%%--|||||||||---%-----||||||--------------------SSS----#--------TT---2-----#####----------------SS--------------###--------##---SSSS------------
-------||||||||----------------------------#----||--|||||||||--o|-----||||||-----SSS-------------------#--------TT---------#####---------------#----------------###-------###---o---------------
-------||||||||----------------------------#----||--|||||||||-%%|-----||||||-oo------------------------#--------TT-----TT--#####---------------#----------------###-------###---%--------#------
-------||||||||------------------------g---#----||--||||||r||-|||----g||||||---------------------------#----ggg-TT-----TT#######---------#-----#---r------------###--kg---#-k---|----g---#-k----
XXXXXXXXXXXXXXXXXXXXXXXXXXXXXXXXXXX-XXXXXXXXX--X||--||%%%%%%%%%%|-XXXXXXXX||-%--XXXXXXXXXXX---XXXXXXXXXXXXXXXXXXXXXXXXXXXXXXXXXXXXXXXXXXXXXXXXXX--%%%%%-----%%%%XXXXXXXXXXXXXXXXXXXXXXXXXXXXXXXX
XXXXXXXXXXXXXXXXXXXXXXXXXXXXXXXXXX--XXXXXXXXX--X||--||-||||||||-|-XXXXXXXX||-|--XXXXXXXXXXX--XXXXXXXXXXXXXXXXXXXXXX-XXXXXXXXXXXXXXXXXXXXXXXXXXXX---|||-------||-XXXXXXXXXXXXXXXXXXXXXXXXXXXXXXXX
