---------------------------------------------------------------------------------------------------------S--------------------------------------------S---S---S---------------------------------
--------------------------------------------------------------------------------------------------------SSS--------------------------------------SS---S---S---S---------------------------------
-----------------------------------------------------------------------------------------------------------------------------------------------------SSSSSSS--So--------------------------------
---------------------------------------------------------------------------------------------------------------S----------------SSSSSSSSSSSSSSSSSSSSSSSSSSSSSSSS--------------------------------
--------------------------------------------------------------------------------------------------------------SS-----------------S--------------SSS-SSSSSSSSSSSS--------------------------------
------------------------------------------------------------o---------------------oo-------ooo-o-------------------------ooo--------------------SSSSSSSSSSSoooSS--------------------------------
--------%%%%%%%%---------------------------------------------------------------#%%%%%----%%%%%%-------------SS------------------SSoo--------ooooSSSSSSSSSSSSSSSS--------o-----------------------
---------||||||----------------------------------------------------------------#-|||------||||--------------SS----------------------------------S-----------------------------------------------
---------||||||-------------------------------------------------------------####-|||------||||--------------SS--------------------------------SS------------------------------S-----------------
---------||||||------------------------------------------------------------#####-|||------o|||--------------S-------------------o--------------o----og------------#-----------------------------
------%%%%%%%%%%----------######-----------------SS---SS%%S----------------#####-|||---%%%%%%%SS-----SS--------TTTT----TT-------S--------#-#------SSSSS---------###-----------------------------
-------||||||||-----------------------------------------||-------------tt-######-|||----|||||---SSSSSS---------TTTT--U-TT----------------###--------------------###----------------------TT----#
-------||||||||-----------------------------------------||-------------tt#######-|||----|||||%%%SSSSSS---TT----TTTT----TT------------#-#####--------------------###----------------------TT----#
-------||||||||---------------------g-g------k-g--------||-------------#########-|||----|||||-|-SSSSSS---TToooS#TT-----TT-----------##-#####-----------------ggg####------kgk------------TT----#
XXXXXXXXXXXXXXXXXXXXXXXXXXXXXXXXXXXXXXXXXXXXXXXXXXX--XXXXXXX-XX-X%%XXXXXXXXXXXX--%%%%%%%%%|||-|-XXXXXXXXXXXX---XXXXXXXXXXXXXXXXXXXXXXXXXXXXXXXXXXXXXXXXXXXXXXXXXXXXXXXXXXXXXXXXXX%XXXXXXXXXXX%XX
XXXXXXXXXXXXXXXXXXXXXXXXXXXXXXXXXXXXXXXXXXXXXXXXXXX---XXXXX--XX-X|X-XXXXXXXXX-o---|||||||-|||-|-XXXXXXXXXXXX--XXXXXXXXXXXXXXXXXXXXXXXXXXXXXXXXXXXXXXXXXXXXXXXXXXXXXXXXXXXXXXXXXXX|XXXXXXXXXXXXXX
