-----------------------K---------------------------------------------------------------------------------------------------------------K--------------------------------------------------------
-----------------------o---------------------------------------------------------------------------------------------------------------o--------------------------------------------------------
-----------------------%--------------------------------------------------------------------------------------------------------------%%%-------------------------------------------------------
-----------------------|------------------------SSSSSSSSSSSSSSSSSSS-------------SSSSSSSSSSSSSSSSSSSSSSSSSSSSSSSS-----------------------|-----------------o--------------------------------------
-----------------------|------------------------SSSSSSSSSSSSSS-------------------------------------------------------------------------|-----------------%--------------------------------------
-----------------------|------------------------SSSSSSSSSSSSSSSS-----------------------------------------------------------------------|-----------------|--------------------------------------
--------%%%%%%%%-------|------------------------SSSSSSSSSSSSSSSS------------------------------------------------------------------r----|-----------------|--o------%%-------------oo---oo-----oo
---------||||||--------o---rr--------%%%---------------------------------------------------------------------------------------#%%%%%%%|-----%%%------orrrrrrr-----||---------------------------
---------||||||-------%%%%%%%%--------|---------------------------------------------------------------------------------------##-|||||-|------|------%%%%%%%%%%%---||----------------------#----
---------||||||--------|||o||---------|---------oooooooo------------------------------------------------------S---------------##-|||||-|------|-------|||||||||----||---------------------------
------%%%%%%%%%%-------||%%%|---------|---------TTSSSSS---------------------------TT----TT-----------------------------------###-|||||-|------|-------|||||||||----||----%%%%%%--##----###------
-------||||||||--------||-|-|---------|---------TT---------------------------TT---TT----TT----TT-------------#---------------###-|||||-|------|-------|||||||||----||-----||||----##---###------
-------||||||||--------||-|-|---------|------#--TT------TT-------------------TT---TT----TT----TT-------------#--------------####%%||||-|------|----%%-|||||||||----||-----#|||---###--####------
-------||||||||--ooo---||-|-|---#-----|k---k-#--TT---k--TT-------g-----g-----TT---TT----TT----TT--------####-#--------------####||||||-|------|----||-||||||r||----||-----#|||--##########k-----
XXXXXXXXXXXXXXXX%%%%%X%XXXXX|-%%%%%---XXXXXXXXXXXXXXXXXXXXXXXXXXXXXXXXXXXXXXXXXXXXXXXXXXXXXXXXXXXXXXXXXXXXXXXXXXXXXXXXXXXXXXXXXX||||||-|--%%%%%%--XX|XXX||%%%%%%-%%XXXXXXXXXXXXXXXXXXXXXXXXXXXXX
XXXXXXXXXXXXXXXX-|||--|XXXXX|--|X|X---XXXXXXXXXXXXXXXXXXXXXXXXXXXXXXXXXXXXXXXXXXXXXXXXXXXXXXXXXXXXXXXXXXXXXXXXXXXXXXXXXXXXXXXXXX||||||-|---||||---XX|-XX||-||||--||XXXXXXXXXX-XXXXXXXXXXXXXXXXXX
