------------------------------------------------------------------------------------------------------------------------------------------------------------------------------------------------
------------------------------------------------------------------------------------------------------------------------------------------------------------------------------------------------
------------------------------------------------------------------------------------------------------------------------------------------------------------------------------------------------
-------------------------------------------------------------------------------------------------S------------------------SS--------------------------------------------------------------------
---------------------------------------------------------------K--------------------------------------------------------------------------------------------------------------------------------
---------------------------------------------------------------------------------ooo--------------------------------------------------------------o---------------------------------------------
--------%%%%%%%%----------------------------------------------------SSo--------S----------------------------------------------------------------%%%-------------------SSSSS----o-----SSS--------
---------||||||------------oo----U-----------ooo-------------------------------#-------------------------------------------------#---------------|-----o----------------------------------------
---------||||||--------TT------------------------------------------------------------------------------------------------------------------------|----------------------------------------------
---------||||||--------TT-----------------------------------------g------------------------#-----------------------------------------------------|----------------------------------------------
------%%%%%%%%%%-------##--------------TT-----------------------###S#S-------------------TT#----###-##-------------------------------------------|------%%%%%o--Q-------------------------------
-------||||||||------------------------TT-----------------------TT-----@-----------------TT#----##------------#-------------------TT----TT-------|-------|||-----------------#------------------
-------||||||||-----------------TT-----TT---TT------------------TT----------#-----------####---TT------tt----##-------------------TT----TT-------|-------|||-----------------#------------------
-------||||||||------------o----TT-----TT---TT-----k----------o-TT----------#----------###-----TT------tt---g###------------------TT----TT--k----|-------|||-------kgg-------#k-----------------
XXXXXXXXXXXXXXXX-XXXXXXXXX%X----XXXXXXXXXXXXXXXXXXXXXX-----XXXXXXXXXXXXXXXXXXXXXXXXXXXXXXXXXXXXXXXXXXXXXXXXXXXXXXXXXXXXXXXXXXXXXXXXXXXXXXXXXXXXXXXXXXXXXXXXXXXXXXXXXXXXXXXXXXXXXXXXXXXXXXXXXXXXX
XXXXXXXXXXXXXXXX-XXX-XXXX-|X----XXXXXXXXXXXXXXXXXXXXXX-----XXXXXXXXXXXXXXXXXXXXXXXXXXXXXXXXXX-XXXXXXXXXXXXXXXXXXXXXXXXXXXXXXXXXXXXXXXXXXXXXXXXXXXXXXXXXXXXXXXXXXXXXXXXXXXXXXXXXXXXXXXXXXXXXXXXXX
