----------------------------------------------------------------------------------------------------SSSSSSSSS-----------------------------------------------------------------------------------
-------------------------------------------------------------------------------------------------S-KSSSSSSSSS-----------------------------------------------------------------------------------
----------------------------------------------------------------------------------------------------------S-------------------------------------------------------------------------------------
---------------------------------------------------------------------------------------------------------------S----------------SSSSSS-------------------------S--------------------------------
------------------------------------------------------------------------------------------------------SSSSS--SSS--------------------------------------------------------------------------------
-------------------------------------------------------------------------------------%%%%%%%----SS---oSSSSS--g-S--------------------------------------------------------------------------------
--------%%%%%%%%--------------------------------------------------------o-------------|||||-----SS---SS-----SS-------------------------%%%------------------------------------------------------
---------||||||-------------------------------------------------SS--------------%%%%%-|||||--%%%S-----------SS---------------ooo--------|----------------------------------ooo------------------
---------||||||----------------------------#--------------------S----------------|||--|||||-####------------SS--------------------------|----------------------------------%--------------------
---------||||||---------------------------#----S------------------------------S--|||--|||||####-------------SSoo------------------------|----------------------------------|--------------------
------%%%%%%%%%%----------#########-----###-------------------------------------%%||--|||||####-SSSSSSSSSSS--SSS------------------------|----------------------------------|--------------------
-------||||||||-------------------------###-------------------------------------||||--||||#####-SSSSSSLS-SK-----------------------------|----------------------------------|------TT------#-----
-------||||||||-----------------------#####--#---------------------------#---#--||||--|||#######SSSSSSSSS-S-----#----------#----------tt|----------------------------------|-S----TT----###-----
-------||||||||----------------------######--#----%%%----------##-----#--#-#-#--||||--|#########SSSSSSSS--U------------##-##----------tt|----------------------------------|------TT----###-----
XXXXXXXXXXXXXXXXXXXXXXXXXXXXXXXXXXXXXXXXXXX-XXXX---XXXXXXXXXXXXXXXXXXXXXXXXXXXXX||||-XXXXXXXX-X-XXXXXXX---SXXXXgXXX--XXXXXXX---X----XXXXXXXXXX%X---------%%XXX----XX------%%%%%-XXXXXXXXXXXXXXXX
XXXXXXXXXXXXXXXXXXXXXXXXXXXXXXXXXXXXXXXXXXX-XXXX---XXXXXXXXXXXXXXXXXXXXXXXXXXXXX||||-XXXXXXXX-o-XXXXXXXX--X-XXXXXXX--XXXXXXX--XX----XXXXXXXXX-|X---------||XXX-X--XX-------|||--XXXXXXXXXXXXXXXX
