--------------------------------------------------------------------SSS-SSS----------------------------------------------------------------------------K----------------------------------------
-----------------------------------------------------------------K-SSSSSSSSS---------------------------------------------------------------------------o----------------------------------------
-------------------------------------------------------------SS---------------------------------------------------------------------------------------%%%---------------------------------------
--------------------------------------------------S--SSSSSSSSSS----------------S-----------------------------------------------------------------------|----------------------------------------
--------------------------------------------------S-S------------------SS------S-----------------------------------------------------------------------|----------------------------------------
--------------------------------------------------SSSS-------o--SQ-Q---SSSS---SS-----------------------------------------------------------------------|-----ooo--------------------------------
--------%%%%%%%%--------------------QQ-----#--ooSSSSSSSS---SSSSS------------SS----------------------------------------------------oS---------S--%%-----|----%%%%----QSSS------------------------
---------||||||----------------------------#--------------------------------SS-------------##--------------------o------------------------------||-----|-----||---------------------------------
---------||||||--------------------------####-------------------------------SS-------------##---------------------------------------------------||-----|-----||---------------------------------
---------||||||--------------------------####---ooooo-o------ooo----------ooSSSS-oo-------###---------------------------------------------------||-----|-oooo||---------------------------------
------%%%%%%%%%%----------######--------######--SSSSSSS---SSSSSS---o-----SS----S----------###----------------------------#------QQQQS-----------||-----|%%%%%||--SS---S@SS---US-----------------
-------||||||||------------------------#######------------------S--SS----SS---SS-------TT####---------------------------##----------------------||-----|-|||-ooo--------------------------------
-------||||||||-----------------------########------------------S-oSS---S--------------TT####--------------------------####---------------------||-----|-|||%%%%--------------------------------
-------||||||||----------------------#########------------------SSSSS-U---oooooo-------TT####---------------------k---######-#------------k-----||-r---|-|||-||----ggg-----------ggk---k----kk--
XXXXXXXXXXXXXXXXXXXXXXXXXXXXXXXXXXXXXXXXXXXXXXX-XXXXXXXXXXXXXXXX--XXX----------SXXXXXXXXXXXXXXXXXXXXXXXXXXXXXX-XXXXXXXXXXXXXXX-XXXXXXXXXXXX-XXXX|%%%%%%%%%%%-||-XXXXXXXXXXXXXXXXXXXXXXXXXXXXXXXX
XXXXXXXXXXXXXXXXXXXXXXXXXXXXXXXXXXXXXXXXXXX-XXXXXXXXXXXXXXXXXXXX--XXX-----------XXXXXXXXXXXXXXXXXXXXXXXXXXXXX--XXXXXXXXXXXXXXXXXXXXXXXXXXXX-XXXX|-|||||||||--||-XXXXXXXXXXXXXXXXXXXXXXXXXXXXXXXX
