--------------------------------------------------------------------------S----------------------------------------------------------------------------K----------------------------------------
----------------------------------------------------------------------S---SS---------------------------------------------------------------------------o----------------------------------------
-------------------------------------------------------------------------SSS-S------------------------------------------------------------------------------------------------------------------
----------------------------------------------------------------SSSSSSSSSSSSSSSS-----------------------------------------------------------SSSSS--------------------SS--------SS-SSSSSSS--------
----------------------------------------------------------------SSSSSSSSSSSSSSSS----------------------------------------------------------------------------------------------------------------
----------------------------------------------------------------SSSSSSSSSSSSSSSS-------------------------------o-------------------------------------------------o------------------------------
--------%%%%%%%%----------------%%%%%------%%-------------------SSSSSSSSSSSSSSSS----------------#-----------------------------------------------------------------------------------------------
---------||||||------------------|||-------||------------------o--------------------------------#------------------------------#-------------------r---o----------------------------------------
---------||||||------------------|||-------||---------------------------------------o------------------------------------------------------------%%%%%%%%---------------------------------------
---------||||||------------------|||-----or||--------------##---ooooooo------ooo------------------------------------------------------------------||||||----------------------------------------
------%%%%%%%%%%----------######-|||-----%%%%%------------###---TTSSSSSSSSS--SSS--#-#2-------#-----------%%%--------------------------------------||||||-------------2--TT----------------------
-------||||||||------------------|||------|||------------####---TT--------------#-----------##------------|--------------------o------------------||||||--------TT------TT---TT----------#------
-------||||||||------------------|||------|||-----------####----TT------TT------##-----tt---##------------|------------------------------#--------||||||--------TT------TT---TT---------##------
-------||||||||------------------|||------|||----------#####----TT----k-TT------##-----tt---##----g-------|--------k-----------#---------#--------||||||--------TT----k-TT---TT---------##-----o
XXXXXXXXXXXXXXXXXXXXXXXXXXXXXXXX%%||XXXXXXXXXXXXXXXXXXXXXXXXX--XXXXXXXXXXXXXXXXXXXXXXXXXXXXXXXXXXXXXXXXXXXXXX---XXXXXXXXXXXXXXXX-XXXXXXXXX---X----||%%%%%%%%%%%-XXXXXXXXXXXXXXXX-XXXXXXXXX---%%%
XXXXXXXXXXXXXXXXXXXXXXXXXXXXXXXX||||XX-XXXXXXXXX--XXXXXXXXXXX--XXXXXXXXXXXXXXXXXXXXXXXXXXXXXXXXXXXXXXXXXXXXX-----XXXXXXXXXXXXXXXXXXXXXXXXX---X----||-|||||||||--XXXXXXXXXXXXXXXX-XXXXXXXXX----|-
