--------------------------------------------------------------------------------------S---------------------------------------------------------------------------------------------------------
---------------------------------------------------------------------------------S----S---S-----------------------------------------------------------------------------------------------------
---------------------------------------------------------------------------------------SSSSS-S--------------------------------------------------------------------------------------------------
--------------------------------------------------------------------------------SSSSSSSSSSSSSSSS--------------------------------SSSSSSSSSSSSSSSS----------------SSSSSS--------------------------
--------------------------------------------------------------------------------SSSSSSSSSSSSSSSS--------------------------------SSS--SSS-----S--------------------------------------------------
------------------------------------------oooo-o--o---------o-oo----------------SSSSSSSSSSSSSSSS--------------------------------SSS--SS----SSSSS---------------------------------------%%%------
--------%%%%%%%%-----------------%%%------%%%-----------------------------------SSSSSSSSoSSSSSSS---------------U-------SS------------------SSSSS----------------------------------------|-------
---------||||||-------------------|--------|------------------oo------------------------------------------------%%%%%---------S--------------------------------------------------%%-----|-----%%
---------||||||-------------------|--------|------------------------------------------------------------------oo-|||-------------------------------------------------------------||-----|-----||
---------||||||-------------------|--------|-------------------------------------ooooooo------oS-----------------|||-----SS--S----oo------------------------------o--------------||-----|-----||
------%%%%%%%%%%----------######--|--2%%%%%%%%%%------##------------------------SSSSSSSSSS-----S------------SUS--|||-------#-----SSS------------------------------S--------------||-----|--#--||
-------||||||||-------------------|----||||||||-------------------------TT------SSSSSSSSSS-----------------------|||-----#-#----------------------------TT--------------------K--||-----|--#--||
-------||||||||-------------------|----||||||||-------------------------TT------SSSSSS-SSS-----------------------|||----####----------------------------TT----------------------%||-----|-##--||
-------||||||||-------------------|----k|||||||-------------------------TT------SSSSSSSSSS--oo-o---k-------------|||---###-#-----------k----kkkg--#-----TT-----#-------k---kkk--|||----k|-##--||
XXXXXXXXXXXXXXXXXXXXXXXXXXXXXXXX%%%%-XXXXXXXXXXXXX%X--XXXXXXXX--XXXXXXXXXXXXXXXXXXXXXXXXXXXXXXXXXXXXXXXXXXXXXXXXXXXXXXXXXXXX%X-XXXXXXXXXXXXXXXXXXXX---XXXXXX---XXXXXXXXXXXXXXXXX|%%XXXXXXXXX--|X
XXXXXXXXXXXXXXXXXXXXXXXXXXXXXXXXX||---XXXXXXXXXXXXX---XXX-XXX-X-XXXXXXXXXXXXXXXXXXXXXXXXXXXXXXXXXXXXXXXXXXXXXXXXXXXXXXXXXXXX|--XXXXXXXXXXXXXXXXX-------X-XXX---XXXXXXXXXXXXXXXXX|||-XXXXXXXX--|-
