-------------------------------------------------------KS--------------------------------------------SSS----------------------------------------------------------------------------------------
-------------------------------------------------------oo--------S---------------S--------------------S---------------S-------------------------------------------------------------------------
------------------------------------------------------%%%%--------------------------------S--SS------SSS----------------------S-----------------------------------------------------------------
-------------------------------------------------------||-------SSSSSSSSSSSSSSSSSSSSSSSSSSSSSSSS----------------SSS-------------S---------------------------------------------------------------
-------------------------------------------------------||-----------------------SSSSSSSSSSSSSSSS------------------------------------------------------------------------------------------------
-------------------------------------------------------||-----------------------SSSSSSSSSSSSSSSS-o---------------------------o------------------------------------------------------------------
--------%%%%%%%%--------------------------------S------||--------Soo--SS--------SSSSSSSS----SSSS%%%--------K----SSSS--SS----SS-------------ooo--------------------------------------SSQ---------
---------||||||---------------------------------o----o-o|--o---------------------------------S---|-----o---o-----------------------------------------------------------------------------------o
---------||||||---------------------------------%%%%%%%%%-%%%----------------------------------S-|----%%%-%%%-----------------------------------------------------------------------------------
---------||||||----------------------------------|||||||---|----oooo-----------o--ooooo------ooo-|-----|---|--------------------------------------------------------------------------------##oo
------%%%%%%%%%%----------######SS--------%%SSSS-|||||||---|----SSSSS-----------SSSSSSS--S---SSS-|-----|---|----SSSSS-----------------------------------------------------------TT--#------####-
-------||||||||---------------------------||-----|||||||---|-------------#------S--SSS---S-------|-----|---|--------------------------------------------------------------------TT---K----#####-
-------||||||||---------------------------||-----|||||||---|%%%%---------#------S----------------|-----|---|----------------------TT-----------#--------------TT----------------TT--------####--
-------||||||||-------------------ggg-----||-----||||||rrrrr-||------##-##-----------SSS-S-----o-|-----|---|---------------kk-----TT-----------#-----k-k----k-TT-------k--------TT---k-k--#####-
XXXXXXXXXXXXXXXXXXXXXXXXXXXXXXXXXXXXXXXXXXXXXXXX-||||%%%%%%%%||-XXXXXXXXXXXXXXXXXXXXXXXXXXXXXXXX-%%%--%%%%XX%%-XXXXXXXXXXXXXXXXX--XXXXXXXXXX---XXXXXXXXXXXXXXXXXXXXXXXXXXXXXXX-XXXXXXXXXXXXXXXXX
XXXXXXXXXXXXXXXXXXXXXXXXXXXXXXXXXXXXXXXXXXXXXXXX-||||-||||||-||-XXXXXXXXXXXXXXXXXXXXXXXXXXX-XXXX--|----X|-XX||-XXXXXXXXXXXXXXXXX--XXXXXXXXXX---XXXXXXXXXXXXXXXXXXXXXXXXXXXXXX--XXXXXXXXXXXXXXXXX
