-----------------------------------------------------------------------K------------------------------------------------------------------------------------------------------------------------
------------------------------------------K----------------------------o--------------------------------------------------S---------------------------------------------------------------------
----------------------------------------------------------------------%%%------------------------------------------------SSS-SSS----------------------------------------------------------------
------------------------------------------U-----SSSSSSSS---------------|----------------------------------------SSSSSSSSSSSSSSSS------------------------------------------------SSSSSSSSSSSSSSSS
-----------------------------------------------------------------------|-------o--------------------------------SSS-SSSSSSSSSSSS------------------------------------------------S---------------
-----------------------------------------------------------------oo----|---oooo%--o------------o----------------SSSoSSSSSSSSSSSS--------------------------ooooo-----------------------------oSSS
--------%%%%%%%%---------------------QQ----------oo--SSS------SS%%%%---|--%%%%%|-%%----------------------------oSSSSSSSSSSSSSSSS------SSSS----SS-------------------------------------------SSSSS
---------||||||--------------------------------------------#-----||----|---|||-|-||---------------------------------------------------------------------------oo--------------------------------
---------||||||--------------------------------------------#-----||----|---|||-|-||------------------------------------------------------------------o--------------------###------------------S
---------||||||---------------------------------oo---------#-----||----|-oooo|-|-||------oooo-------------oo----ooooo--------ooo----------------------g-------------------###-----------------oo
------%%%%%%%%%%----------#########--------------------###-#-----||----|%%%%%|-|-||------%%%%---QSQo------------SSSSS--------SSS-SQS--SSSSSS--------####--------###------####--------#-------SSS
-------||||||||-----------------##---------------------#####-----||----|-|||-|-|-||-------||--oo--------------o-S-------#----------------------------------------#------#####-------------------
-------||||||||-----------------##-------------------########----||----|-|||%%%%-||-------||--%%----------------#-------#----------------------------------------------######-------------------
-------||||||||-----------------##----------k-------#########----||----|r|||-||--|gg------||--||----------------#-----k##---------------------------------------#--k--#######---k----------g----
XXXXXXXXXXXXXXXXXXXXXXXXXXXXXXXXXXXXXXXXXXXXXXXXXXXXXXXXXXXXXXXX-||---%%%%%%-||-XXXXXXXXXXXX--||XXXXXXXXXX--XXXXXXXXXXXXXXXXXXXXXXXXXXXXX-----S-XXXX-XXXXXXXXXXXXXXXXXXXXXXXXXXXXXXXXXXXXXXXXXXX
XXXXXXXXXXXXXXXXXXXXXXXXXXXXXXXXXXXXXXXXXXXXXXXXXXXXXXXXXXXXXXXX-||----||||--||-XXXXXXXXXXXX--||XXXXXXXXXX--XXXXXXXXXXXXXXXXXXXXXXXXX-XXX-------XXXXXXXXXXXXXXXXXXXXXXXXXXXXXXXXXXXXXXXXXXXXXXXX
