---------------------------------------------------------------------------------------------------------------------------------------K--------------------------------------------------------
------------------------------------------------------------------------------------------------------S--------------------------------o-----------------------------------------K--------------
--------------------------------------------------------------------------------------------------------------S-----------------------%%%-------------------------------------------------------
------------------------------------------------------------------------------------------------SSSSSSSSSSSS--S------------------------|--------SSS------------S--------------------------------
--------------------------------------------------------------------------------------------------S------------------------------------|--------------------------------------------------------
----------------------------------------------oo---------------------------------oo------ooo-------------------------------------------|-oooooo--------------------------oo---------------------
--------%%%%%%%%----------------%SS---------%%%%----------------SSoSSSSSoS---SS------------------Soo--------SSS------------------------|%%%%%%%---------%-----------------------SSSSSSS------S--
---------||||||-----------------|------------||---------------------------------------------Koo---------------------------------%------|-|||||-o%%%%%%%%|---------------------------------------
---------||||||-----------------|------------||---------------------------------------------------------------------------------|------|-|||||-#-||||||-|--S------------------------------------
---------||||||-----------------|------------||-------------------------------ooTT----------------------------------------------|------|-|o|||-#S||||||-|----SS---------------------g-----------
------%%%%%%%%%%----------######|-----%%%%%%%%%%-2-----------o---SQSSSSS-----SSSTT-----TT----------SS---------------------------|------|%%%%%|--%||||||-|---------TT----------TT---SSS-------SSS
-------||||||||-----------------|------||||||||---------------------------------TT-----TT-----------------------------tt--------|------|-|||-oo-|||||||-|---------TT----TT----TT----------------
-------||||||||-----------------|------||||||||---------------------------------TT-----TT----#------------------------tt---#---#|------|-|||%%%%|||||||-|----K----TT----TT----TT----------------
-------||||||||-----------------|------||||||||---g----------------k--K---k-----TT-----TT----#------------------------tt---##-##|------r-|||-||-|||||||-|---------TT----TT--o-TT----gg----k-----
XXXXXXXXXXXXXXXXXXXXXXXXXXXXXXXX|-%%%%%%%%%||||-XXXXXXXXXXXXXXXXXXXXXXXXXXX-XXXXXXXXXXXXXXXXXXXXXXXXXXXXXXXXXXXXXXXXXXXXXXXXXXXX%%%%%%%%%%||-||-|||||||XXX-X-X-XXXXXXXXXXXXXX-XXXXXXXXXXXXXXXXXX
XXXXXXXXXXXXXXXXXXXXXXXXXXXXXXXX|--|||||||-||||-XXXXXXXXXXXXXXXXXXXXXXXXXXX-XXXXXXXXXXXXXXXXXXXXXXXXXXXXXXXXXXXXXXXXXXXXXXXXXXXX-||||||||-||-||-|||||||XXX-X-X-XXXXXXXXXXXXXX---XXXXXXXXXXXXXXXX
