------------------------------------------------------------------------------------------------------------------------------------------------------------------------------------------------
---------------------------------------------------------SS-------------------------------------------------------------------------------------------------------------------------------------
------------------------------------------------------------------------------------------------------------------------------------------------------------------------------------------------
---------------------------------------------------------------S------------------------------------------------SSSS--SSSSSSSSSSSSSS------------SSSSSSSSSSSS-SS---------------------------------
----------------------------------------------------------------------------------------------------------------------S-------------------S-----------------------------------------------------
-------------------------------------------------oo-----oo--------------------------------------------------------------------------------o-----------------------------------------------------
--------%%%%%%%%----------------------------------------------------------------------------------------------------------------------S---S----------------#---o-------Q------o-----------------
---------||||||-------------------------------------------------------------S------------------#-----------------------------------------------#-----------y---#-----------o--------------#y---o
---------||||||-------------------------------------------------------------------------------##--S---------------SSSSS-----------------------##----------######--------------------------#-----
---------||||||---------------------------oo--------------------------------------------------##-----#----------------------------------------##---------######-------g------SS--k------#-------
------%%%%%%%%%%----------######--oo--------------TT------------------------------------------------##--------------------------------------####---------######---######---------------##-------
-------||||||||-----------------------------------TT-----#------------------------------------oo---------------------------------------TT---####-------########---###--------------#---##-------
-------||||||||-----------------------------------TT-----#-----------------------------------##----------------------------------------TT--#####------#########-#####--------------#--###-------
-------||||||||--------------------g--------------TT-----#------------------oooo------------####---------------------------------------TT--#####-----##########-####------k-------##--###-------
XXXXXXXXXXXXXXXXXXXXXXXXXXXXXXXXXXXXXXXXXXX-XXXXXXXXXXXXXX--------XXXXX--%%%%%%%XXXXXXXXXXXXXXXXXXXXXXXXXXXXXXXXXXXXXXXXX-SSSXXXXXXXXXXXXXXXXXXXXXXXXXXXXXXXXXX-XXX@X-XXXXX-XXXXXXXXXXXXXXXXXXXX
XXXXXXXXXXXXXXXXXXXXXXXXXXXXXXXXXXXXXXXXXXX-XXXXXXXXXXXXXX--------XXXXX---|||||-XXXXXXXXXXXXXXXXXXXXXXXXXXXXXXXXXXXXXXXXX----XXXXXXXXXXXXXXXXXXXXXXXXXXXXXXRXXX-XXXX--XXXXX-XXXXXXXXXXXXXXXXXXXX
