------------------------------------------------------------------------------------------------------------------------------------------------------------------------------------------------
-------------------------------------------------------------------------------------------------K----------------------------------------------------------------------------------------S-----
------------------------------------------------------------------------------------------------------------------------------------------------------------------------------------------------
--------------------------------------------------------------------------------SSSSSSSS--SSSSSS------------------------------------------------SSSSSSSSSSSS---S----------------SSS---SS------SS
------------------------------------------------------------------------------------------------------------------------------------------------------------------------------------------------
--------------------------------Q---------U-o-----------------------------------------------------------------------------ooo-o-----------------------------------------------------------------
--------%%%%%%%%----------------------Q---------------------------------------------------SS---S----SSS--------------------------oo---SS------oS------------------------------------SSSS--------
---------||||||---------------------------------------------------------------------------------------------------------------oo-----------#----------------------------------------------------
---------||||||---------------------------------------------------------------------------------------------------------------------------##----------------------------------------------------
---------||||||--------------------------------------------------------------------------------------g-------------------------o---------##-----------------------------------------------------
------%%%%%%%%%%----------######-So--SSSSS-------------------------------------------------###------SS-------USSQS---SS#SSSS------------##------TT---2---------------------------TT---TTTT------
-------||||||||----------------------------------------------------------------------------###--S---------------------------------------###-----TT-----TT------------------------TT---TTTT------
-------||||||||--------------------K--------------------------------------------##---------###----------------------------------------#####-----TT-----TT--------------##--------TT---TTTT------
-------||||||||--------------------U------k-----k--------------k------------oooo##--------####--------gg--g------------------------########-----TT-----TT--------------##--------TT---TTTT------
XXXXXXXXXXXXXXXXXXXXXXXXXXXXXXXXXXXXXXXXXXXXXXXXXXXXXXXXXXXXXXXXXXXXXXX----XXXXXXXXXXXXXXXXXXX--XXXXXXXXXXXXXXXXXXXXXXXXXXXXXXXXXXXXXXXXXXXXXXXXXXXXXXXXXXXXXXXXXoXXXXXXXXXXXXX-XXXXXXXXXXXXXXXX
XXXXXXXXXXXXXXXXXXXXXXXXXXXXXXXXXXXXXXXXXXXXXXXXXXXXXXXXXXXXXXXXXXXXXXXX--XXXXXXXXXXXXXXXXXXXXX-XXXXXXXXXXXXXXXXXXXX-XXXXXXXXXXXXXXXXXXXXXXXXXXXXXXXXXXXXXXXXXXXXXXXXXXXXXXX----XXXXXXXXXXXXXXXX
