------------------------------------------------------------------------------------------------------------------------------------------------------------------------------------------------
------------------------------------------------------------------------------------------------------------------------------------------------------------------------------------------------
------------------------------------------------------------------------------------------------------------------------------------------------------------------------------------------------
----------------#-------------------------------------------------------------------------------------------------------------------------------------------------------------------------------
------------------------------------------------------------------------------------------------------------------------------------------------------------------------------------------------
-------------------------------S---------------o------------------------------------------------------------------------------------------------------------------------------------------------
--------%%%%%%%%-----oooSo-----o-------------------------------o--------------------------ooo-----------------------------%%%-------QQQQ--------------------------------------------------------
---------||||||-%S%%%%%%-----------------------------------#---------------------------------------------------#-----------|---------------------oo------------------------o--------------------
---------||||||-|--||||--------S---------------------------##---------------------------S---------------------##-----------|--------------------%%%%---------------------------------------##---
---------||||||-|--||||-----------------------------------###-oo----------------------------------------------##-----------|---------------------||----------------------------------------##---
------%%%%%%%%%%|--||||-------S%-------------------------#####---------TT------------------------------------###-----------|-----2-----------U---||--------------S-------SS-------------#####---
-------||||||||-|--||||--------|------------------------######---------TT----#-----------------------------#####-----------|---------------------||------------------------------------######---
-------||||||||-|--||||--------|-----------------------#######--TT-----TT----#-----------K-------------tt--#####-----------|---------------------||-----------------------------------########--
-------||||||||-|--||||--------|--gg----------------gg########--TT-----TT---##---------------oo--------tt#######-----------|-kro--gk-k----k------||----------------------------------#########-#
XXXXXXXXXXXXXXXX|--||XXXXXXXXXXXXXXXXXXXXXXXXXXXXXXXXXXXXXXXXXXXXXXXXXXXX-XXXXXX---------XXX%%%%%%%-XXXXXXXXXXXX-%%------XXXXX%%XXXXXXXXXXXXXXXX-|X%------%------%%%%%XX--XX--%XXXXXXXXXXXXXXX-X
XXXXXXXXXXXXXXXX|--||XXXXXXXXXXXXXXXXXXXXXXXXXXXXXXXXXXXXXX-XXXXXXXXXXXXX-XXXXXX-----------X-X||X|---XXXXXXXXXXX-||------XXXXX|XXXXXXXXXXXXXXXXX-|-|------|-------|||-----XX--|XXXXXXXXXXXXXXXXX
