--------------------------------------------------------------------------------------------------------------------------------------------------------------------------------
--------------------------------------------------------------------------------------------------------------------------------------------------------------------------------
------------------------------------------------------------------#---------------------------------------------------------------------------Q---------------------------------
-----------------------------------------------------------------##--#----------SSSSSSSSSSSSSSSS-----------------------------------SSSSSSSSS%%%%--------------------SSS---------
------------------------------------------------------------------#g##----------SSSSSSSSSSSSSS--------------------------------------------1--||---------------------------------
-----------------------o----------------------------------------%###------------SSSSSSSSSSS-SSoS--##-----------------------------------------||---------------------------------
--------%%%%%%%%------------------------------------------------|----------------SSSSSSSo---SSS------------------SSLSU----oo------------oo---||--------------------------------S
---------||||||-------------------------------------------------|--###----o--------SS-------SSS----------------------------------------------||---------------------------------
---------||||||------#------------------------------------------|---------------SSSSS---------------------U----------------------------------||-----------------%---------------
---------||||||-------------------------------------------------|---------------------------oo-----------------------------------------r-----||-----------------|---------------
------%%%%%%%%%%---------------------Q---@S------------TT-------|---------------SS----------SS%%-US-----------------------------%%%%%%%%%---%%%-----------------|---------------
-------||||||||----------TT----------------------------TT-------|-------------TT---------TT---||---------------------------------|||||||-----|------------------|---------------
-------||||||||-#--------TT--------------#-------------TT-------|---TT--------TT---------TT--S|S----------------------B----------|||||||%%%%%%------------------|---------%-----
-------||||||||-#----y---TT----g-----y---#-----g---k---TT-------|---TT--------TT----#----TT---|-ggg-------g----------yb----------|||||||-||||-------------------|---------|-----
XXXXXXXXXXXXXXXXXXXXXXXXXXXXXXXXXXXXXXXXXXXXXXXXXXXXXXXXXXXXXXXXXXXXXXXXXXXXXXXXXXXXXXX--XX---|XXXXXXXXXXXXXXXXXXXXXXXXXXXXXXXXX%|%%%%%|-||%%%%-XXXXXXX---%%%%--|---X-X---%%%%--
XXXXXXXXXXXXXXXXXXXXXXXXXXXXXXXXXXXXXXXXXXXXXXXXXXXXXXXXXXXXXXXXXXXXXXXXXXXXXXXXXXXXXXXX-XX---|XXXXXXXXXXXXXXXXXXXXXXXXXXXXXXXXXg|g|g|-|-||-g|--XXXXXXX----||---|--XX-X----||---
