-------------------------------------------------------------------------------------------------------------------------%%-----------------------------------------------------
-------------------------------------------------------------------------------------------------------------------------||-----------------------------------------------------
-------------------------------------------------------------------------------------------------------------------------||-----------------------------------------------------
-----------------#-------------------------o-----------------------------------------------------------------------------||-------------------------------------------SSSSSSSSSS
----------------###------------------------S--o-------------------------------------------g------------------------------||---------------------------------------------SSoS----
----------------###----o------------------------------------------------------------------%%%%---------------------------||---------------------------------------------SSSS----
--------%%%%%%%%-----------------------SSSS----S---------------oSSS------------------------||-------------------------r-QQ|-----------------------@QQ---oS---------S-SS--SS-----
---------||||||-----------o------------------------------oo----------------------------or--||-----------------------%%%%%-|--------------------y--------------------------------
---------||||||----------------------------------------------------------------------%%%%%%%%%-----------------------|||--|-------------------------------------------SS--------
---------||||||-----------------------------------------------------------------------|||||||------------------------|||--|------------------@-#-------------2##oor--SSrSooo-SSS
------%%%%%%%%%%----------------%%%%-%%%%%-o----Q-------------------------------------|||||||-------Q----------------|||--|-------2-----S-----#------------g####%%--%%%%%%----S-
-------||||||||-----TT------TT---||---|||--------------------------------TT-----------|||||||------------TT----------|||--|------------------##------------#####||---||||-------
-------||||||||-----TT------TT---||---|||-----------------------------#--TT-----------|||||||------------TT----------|||--|-----------------###-------%---#####-S|---||||-------
-------||||||||-----TT---y--TT---||---|||-----------------------k--------TT-----------|||||||---------g--TT----k-----|g|--|---------------#####-------g--#######-|---||||-----#-
XXXXXXXXXXXXXXXXXXXXXXXXXXXXXXXX%%%%--|||-------XXXXXXXXXXXXXXXXXXXXXXXXXXXXXXXXXXXXXXXX|X|||---XXXXXXXXXXXXXXXXXXXXXXXXXXXXXXXX%--------XXXXXX-XXXXXXXXXXXXXXXX-|-%%%%||--2X-XX
XXXXXXXXXXXXXXXXXXXXXXXXXXXXXXXXg||---|||-------XXXXXXXXXXXXXXXXXXXXXXXXXXXXXXXXXXXXXXXX|XX||---XXXXXXXXXXXXXXXXXXXXXXXXXXXXXXXXg----X--XXXXXXX-XXXXXXXXXXXXXXXX-|--||-||-XXX-XX
