--------------------------------------------------------------------------------------------------------------------------------------------------------------------------------
---------------------------------------------------------------------------------------------------------------------------------------------------K----------------------------
--------------------------------------------------------------------------------------------------------------------------------------------------------------------------------
----------------------------S---SSSSSSSSSSSSSS--SSSSSSSSSSSSSSS-----------------------------------------------------------------SSSSSSSSSSSSSSSS--------------------------------
------------------------------------------------------------------------------------------------------------------------------------------o-------------------------------------
------------------------------------------------------------------------------------------%%----------------------------------------------S-------------------------------------
--------%%%%%%%%--------------------------------------------------------------------------||--------------------------r-----------------------------------------o--------o------
---------||||||----------oS----------------------------------------------------------oo---||------------------------%%-----------------------------------o----------------------
---------||||||---------SSK---K-S-----##-------------------------------------------%%%%%%%||------------#-TT--------||-----------------%%%--------------------------------------
---------||||||---------SSS-----------##---------------------------g----------------|||||-||-----------##-TT--------||------------------|-----r---------------------------------
------%%%%%%%%%%----------------------#---------------------------------------------|||||-%%----------###-##--TT-QQQ|QSQ@S------%%%%%%%-|-----%%---------------------#----------
-------||||||||-------------------TT--##----------------------------------------TT--|||||-||----------###-----TT----|------------|||||--|-----||---------------------#----------
-------||||||||-------------------TT-##------------S------SS---------tt-----##--TT--|||||-||----------###-----TT----|------------|||||--|-----||---------------------#---TT-----
-------||||||||-------------------TT-###---------k-----#-------------tt----####-TT--|||||-||--------#-###-----TT-gggg--ggg-----k-|||||--|-----||-----K---------------#---TT-----
XXXXXXXXXXXXXXXXXXXXXXXXXXXXXXX-XXXXXXXX--------XXXXXXXXXXX-XXXXXXXXXXXXXXXXXXXXXX--||||%-||----XXXXXXXXXXXXXXXXXXXXXXXXXXXXXXXX-|%%%%%%%--2--||XXXXXXXXXXXXXXXXXX-XXXXXXXXXXX-X
XXXXXXXXXXXXXXXXXXXXXXXXXXXXXXX-XXXXXXXX--------XXXXXXXXXXXXXXXXXXXXXXXXXXXXXXXXXX--|||||-||----XXXXXXXXXXXXXXXXXXXXXXXXXXXXXXXXg|-|||||------||XXXXXXXXXXXXXXXXXX-XXXXXXXXXXX-X
