------------------------------------------------------------------------------------------------------------------------------------------------------------------------------------------------
-----------------------------------------------------------------------------------------------------------------------------------------------------------------S----S---S---------------------
------------------------------------------------------------------------------------------------------------------------------------------------------------------------------------------------
-----------------S--------------SSSSSSSSSS---SSS---------------------------SSSSS------------------------------------------------SSSSSSS---------------------------------------------------------
-----------------------------------------------------------------------------------------------------------------------------------------------------------------------------SSS----------------
------------------------------------------------------------------------------------------------------------------------------------------------------------------------------------------------
--------%%%%%%%%-----QQQ---------------------------------------------------------------------------------------------S-----------------------------------------------S------SS-------SSS--------
---------||||||----------------------------------------------------------------------------o--------------------------------------------------------------------------------SS------------------
---------||||||-------------------------------------------------------------------------------------------------------------------------------o-----------------------------SS------------------
---------||||||----------------------------------------------------------------------------------------------------------------------------S--TT----------------------------SSSS----------------
------%%%%%%%%%%#---#--#------------------###---SSS-------%SSSS------------------------TT----------------------------SS%%S%S-SS---------------TTSSQo--SS---------SSSSSSSSSS---SS----------------
-------||||||||-#------#-----#-----------####-------------|--------------#-------------TT------------------------------||-|-------------------TT-------------------SS---------SS----------------
-------||||||||-##-----#----##----------#####-------------|--------------#------------###------------------------------||-|-------TT----------TT-------------------SS---------SS----------------
-------||||||||-##-----#----##-------k-######--#---r------|--------------#-----------####---------g---------kkkg-------||-|-------TT----------TT-------------------SSkk-------SS--gggg------k---
XXXXXXXXXXXXXXXXXXXXXXXXXXXXXXXXXXXXXXXXXXXXX--X-X%X%---XXX-XXXXXXXXXXXXXXXX-X-XXXXXXXXXXXXXXXXXXXXXXXXXXXXXXXXX-XXXXXXXXXX----XXXXXXXXXXXXXXXXX--XXXXX------XXXXXXXXXXXXXXXXXXXXXXXXXXXXXXXXXXX
XXXXXXXXXXXXXXXXXXXXXXXXXXXXXXXXXXXXXXXXXXXXX-XX-XXX|---XXX-XXXXXXXXXXXXXXXXXX-XXXXXXXXXXXXXXXXXXXXXXXXXXXXXXXXX-XXXXXXXX-X-----XXXXXXXXXXXXXXXX--XXX-X------XXXXXXXXXXXXXXXXXXXXXXXXXXXXXXXXXXX
