-----------------------------------------------------------------------K------------------------------------------------------------------------------------------------------------------------
------------------------------------------------------------------------------------------------------------------------------------------------------------------------------------------------
------------------------------------------------------------------------------------------------------------------------------------------------------------------------------------------------
--------------------------------SSSSSSS-----------------------------------------SS--------------------------------------------------------------------------------------------------------------
------------------------------------------------------------------------------------------------------------------------------------------------------------------------------------------------
------------------------------------------------------------------------------------------------------------------------------------------------------------------------------------------------
--------%%%%%%%%---------------------------------------------------------------------------S----------------------------o------o----------------------------------------------------------------
---------||||||------------------------------------------------#--------------------------------------------------------------------------##----------------------------------------------------
---------||||||-----------------------------------------------##--------------------------------------------------------------------------###---------------------------------------------------
---------||||||----------------------------------------------###-----------#-------------------------------------------------------------####---------------------------------------------------
------%%%%%%%%%%----------######------------------------TT--####-----------#-----------------------------------S------------------------######------------------------------------TT----TT------
-------||||||||------------------------tt----TTTT-------TT-####------------#----#----------#---#---------------S-----------------TT-----#####------------TT--------------------#--TT----TT------
-------||||||||------------------------tt----TTTT-------TT-####------------#-%%%#----------#---#-------------------------TT------TT---#######------------TT--------------------#--TT----TT----TT
-------||||||||------------------------tt----TTTT----k--TT-####-----------#---|-#---------##---#------#----------##------TT------TT---#######--------kk--TT---k-----------k---##--TT----TT----TT
XXXXXXXXXXXXXXXXXXXXXXXXXXXXXXXXXXXXXXXXXXXXXXXXXXXXXXXXXXXXXXX-%%%%XXXX%XX---|-XXXX-XXXXXXXXXXXXXXXXXXXXXXXXXXXXXXXXXXXXXXXXXXXXXXXXXXXXXXXXXXXXXXXXXXXXXXXXXXXXXXXXXXXXXXXXXXXXXXXXXXXXXXX--XX
XXXXXXXXXXXXXXXXXXXXXXXXXXXXXXXXXXXXXXXXXXXXXXXXXXXXXXXXXXXXXXX--||--X-XXXX---|-XXX--XXXXXXXXXXXXXXXXXXXXXX-XXXXXXXXXXXXXXXXXXXXXXXXXXXXXXX-XXXXXXXXXXXXXXXXXXXXX-XXXXXXXXXX-XXXXXXXXXXXXXXX--XX
