--------------------------------------------------------------------------------------------------------------------------------------------------K-2---------------------------
---------------------------------------------------------------------------------------------K-----------------------------------------------------Q----------------------------
--------------------------------------------------------------------------------------------------------------------------------------------------#-----------------------------
----------------S----------------------------------------------------SSSSSSSSSSS-----------------------------------------------------------------##--#--------------------------
---------------------------------------------------------------------SSSSSSSS--------------------------------------------------------------------##k##--------------------------
------------------o----o---oooo--------------------------------------SSSSSSS----%%%%%%%---------------------------------------------------------####----------------------------
--------%%%%%%%%%%---------------1----U--r----2--------------------SSSSSSSSSSSSS-|||||------------------------------------------------R-----------------------------------------
---------||||||-||------------------o%%%-----------------------------------------|||||--------------------------------------------SSS-------------------------------------------
---------||||||-S|--------------------|------------------------------------------|||||--------------------------------------------S---------------------------------------------
---------||||||--|----------oooo------|----------------------------ooo-oo--------|||||------------------------------------------------------------------------------------------
------%%%%%%%%%%-|T----------%%%------|---------------------------%%%%%%%%%%%S---|||||------------------------------------------#-#-##----------------------------QS----@----Q--
-------||||||||--|TT----------|-------|----------------------------|||||||||-----|||||-------#----------------------------------#-#-#-----------------------TT------------------
-------||||||||--|TT----------|------B|---------#------------------|||||||||SS---|||||------##----------------------------------###-#---------------TT------TT------------------
-------||||||||--|TT----------|------b|k-----ggg#------------------|||||kk||-----|||||-----###------g--------k---------------ggg#---#-#-------------TT--g---TT--ggggg-g--gggg-g-
XXXXXXXXXXXXXXXXXXXXXXX-------|-XXXXXXXXXXXXXXXXXX--XXX------X-----|||||XXXX--XXXXX|XXXXXXXXXXX-XXXXXXXXXXXXXXXXXXXXXXXXXXXXXXXXXX--XXXX-X-----XXXXXXXXXXXXXXXXXXXXXXXXXXXXXXXXX
XXXXXXXXXXXXXXXXXXXXXXX-------|-XXXXXXXXXXXXXXXXXX--XXX------XX----|||||XXXX--XXXXXXXXXXXXXXXXX-XXXXXXXXXXXXXXXXXXXXXXXXXXXXXXXXX---XXXX-------XXXXXXXXXXXXXXXXXXXXXXXXXXXXXXXXX
