------------------------------------------------------------------------------------------------------------------------------------------------------------------------------------------------
-------------------------------------------------K----------------------------------------------------------------------------------------------------------------------------------------------
------------------------------------------------------------------------------------------------------------------------------------------------------------------------------------------------
-----------------S------------SS------------------------------------------------------------------------------------------------SSSSSSSS-------------------SSSSS----------------SSSS------------
------------------------------------------------------------------------------------------------------------------------------------------------------------------------------------------------
------------------------------------------------------------------------------------------------------------------------------------------------------------------------------------------------
--------%%%%%%%%---------------------QQ--------U--------------------QQQQQ----------SQSSS-------S--%--------------SS----------S---SS--------oo---------------------------------------------------
---------||||||----------------------------------------------------------------o------------------|--------------------------S------------------------------------------------------------------
---------||||||-------------------------------o---------------o-----------------------------------|--------------------------S------------------------------------------------------------------
---------||||||-------------------------------------------------------------#------------------o--|--------------------------S-------------------------------------------SS---------------------
------%%%%%%%%%%----------------------------SSS--------------SS-----------#-###-----S-------------|--2------------SSSSSS------------------------------------------------------------------------
-------||||||||------------------------------------------TT---------------#-#-#-------------------|------TT--------S-------------------------TT-------------------------------------------------
-------||||||||----------------#-------------------------TT--------------####---------------------|------TT--------SS-SS--------------tt-----TT----------TT-------------------------------------
-------||||||||-#------g-----g##--og-g----k--------------TT-------gy--g--####-------ggg---------g-|----k-TT---------Skk-----k--k------tt-----TT---#------TT---------------------k------k--------
XXXXXXXXXXXXXXXXX-XXXXXXXXXXXXXXXXXXXXXXXXXXXXXXXXXXXXXXXXXXXXXXXXXXXXXXXXXXXXXXXXXXXXXXXXXXXXXXXXXXXXXXXXXXXXXXXXXXXXXXXXXXXXXXXXXXXXXXXXXXXXXXXXX-XXXXXXXXXXXX---XXX---XXXXX%XXXXXXXXXXXXXXXXX
XXXXXXXXXXXXXXXXX-XXXXXXXXXXXXXXXXXXXXXXXXXXXXXXXXXXXXXXXXXXXXXXXXXXXXXXXXXXXXXXXXXXXXXXXXXXXXXXXXXXXXXXXXXXXXXXXXXXXXXXXXXXXXXXXXXXXXXXXXXXXXXXXXX-XXXXXXXXXXXX---XXX-X-XXXXXXXXXXXXXXXXXXXXXXX
