--------------------------------------------------------------------------------------------------------------------------------------------------------------------------------
--------------------------------------------------------------------------------------------------------------------------------------------------------------------------------
--------------------------------------------------------------------------------------------------------------------------------------------------------------------------------
-----------------------------------------SSSS-SS--------------------------------------------------SSSSSSSSSSSSSS--------------------------K-------------------------------------
--------------------------------------S---------------------------------------------------------------S--SS-SSS----------------------------------------------------k------------
--------------------------------------S-----------------------------------------------------------------SSS--S----------------------------------------------------##------------
--------%%%%%%%%------------1-@S--QSQSSSSSSSSSS%--------------------------------SSS-----SQQS--@S---------SSSSSS---------------------Q-S-oooo---%-----o--ooo---@%----------------
---------||||||--------------------------------|--SSS-------------------------------------------------------------SSS--------------------------|---------------|--------oooo----
---------||||||--------------------------------|--SS--------------------------------------------------------------SS---------------------------|-------SSSSS---|----------------
---------||||||--------------------------------|-K-----------------------------------------------------o---o--r---S--------------------r-------|-------------#-|----------------
------%%%%%%%%%%---Q-----LSS------SS-%%%S---2SS|------#-----------------------------------SS----%%%%%%%%%%%%%%%%#---------------%-%%%%%%%------|-------SSS--##-#----------------
-------||||||||-----------------------|--------|#-----#--------#---------------------------------||||||||||||||-#---------------|--|||||-------|---#-------###-#----------------
-------||||||||-----------------------|-%-%%%--|#-----#-------##-------TT--tt--------------------||||||||||||SS-#--------------#%--|||||-------|---#------##-#-#-------TT-------
-------||||||||----------------gK--g--y-gggg--k|#-----#-------##-------TT--tt---------g------ggg-||||||||||||---#--------------#|--|||||-------|-#-#-###-#####-#-------TT-------
XXXXXXXXXXXXXXXXX---XXXXXXX---XXXXXXXXXXXXXXXXXXX---XXXX---XXXXXXXXXXXXXXXXXXXXXXXXXXXXXXXXXXXXX-||||%%%%||||--XX-----X--------X%%%%%|||-------|XXXXXXXXXX--XX-XXXXXXXXXXXXXXXXX
XXXXXXXXXXXXXXXXX---XXXXXXXX--XXXXXXXXXXXXXXXXXXX---XXXX--XXXXXXXXXXXXXXXXXXXXXXXXXXXXXXXXXXXXXX-||||-||-||||--XX-----X--------Xg|g|-|||-------|XXXXXXXXXX--XX-XXXXXXXXXXXXXXXXX
