----------------------------------------------------------------------------------------------------------------------------------------------------------------
----------------------------------------------------------------------------------------------------------------------------------------------------------------
----------------------------------------------------------------------------------------------------------------------------------------------------------------
----------------------------------------------------------------SSSS-SS---SSSSSS--------------------------------------------------------------------------------
---------------------------------------------------------------------SSSSSo-------------------------------------------------------------------------------------
-----------------------------------------------------g---------------SSSSSS-----------------------------------------------oooooo--------------------------------
-----Q--SSQS--------------------SS---------------####---------------------S------------------------QSQSUSSU----%---SSSS-------------------------%---------------
--------------------------o---------------------------------------------------o--------------------------------|-----SS-------------------------|---------------
-------------------------%---------------------------#----------%%%----S---S---------------------------SSS---y-|--------------------------------|---------------
-------------------------|--------------------------##------TT---|----SSSSUSSSSS-------------2---------------2-|--SoS---------------------------|---------------
--------SQSQQQQ----------|-------------------------###------##--%%---%%%%%------%-%%-%%%%%%-----------SSS--S##-|--SSSS-----------##-------------|---------------
------------------TT-----|------TT-------TT--------###-----###--||----|||-------|-||--||||-----------------###-|----S---------------TT----------|---------------
------------------TT-----|------TTT---tt-TT------#####----####--S|----|||%%-----%-||--||||----------------####-|--------------------TT----------|---------------
---ggg----y--gg---TT-----|------TTT---tt-TT-----######-#-#####---|----|||||-----|-||--||||------K--------#####-|-------k------------TT----------|---------------
XXXXXXXXXXXXXXXXXXXXXXXXXXXXXXXXXXXXXXXXXXXX--XXXXXXXXXXXXXXXX-X-|%%%%%|%%%-----|-||--||||XX----RXXXXXXXXXXXXXXXX---XXXXXXXXXXXXXXX-XXXXXXXXXXXXXXXXXXXXXXXXXXXX
XXXXXXXXXXXXXXXXXXXXXXXXXXXXXXXXXXXXXXXXXXXX---XXXXXXXXXXXXXXX-X-|-|||-|g|----X-|-||--||||------XXXXXXXXXXXXXXXXX---XXXXXXXXXXXXXXX-XXXXXXXXXXXXXXXXXXXXXXXXXXXX
