------------------------------------------------------------------------------------------------------------------------------------------------------------------------------------------------
------------------------------------------------------------------------------------------------------------------------------------------------------------------------------------------------
------------------------------------------------------------------------------------------------------------------------------------------------------------------------------------------------
--------------------------------SSSS----------------------------SSSSSSSSSSSSSSSS----------------SSS------SSSS----------------------------------S------------------------------------------------
------------------------------------------------------------------------------------------------------------------------------------------------------------------------------------------------
----------------------------------------------------------------------------------------------------------------------------------oo------------------------------------------------------------
--------%%%%%%%%-------------------------------------------------------%%----o---------QQS-----o-----Q---------oSSSSS--------SSS-----------------------SS-SS---------Q--------------------------
---------||||||--------------------------------------------------------||-----------------------------------------------------------------------------------------------------------------------
---------||||||--------------------------------------------------------||-----S-----------------------------------------------------------------------------------------------------------------
---------||||||--------------------------------------------------------|SSSSSSS---------------------gg-----------oooo---------oo-------------------------------------------------------TT-------
------%%%%%%%%%%----------######-----------------------------S---------|-------------SQQQ---So---#####----------SSSSSS-------SSS---------TT--------------------------------------------TT----###
-------||||||||-----------------o--------------------------------------|-------------------------##--------------------------------------TT---K----------------------------------------TT----###
-------||||||||-----------------%%-------------------------------------|-------------------------##--------------------------------------TT-------------------------------------#------TT---###-
-------||||||||-----------------||---------#-------o-------------------|-----------k--------k---###-------#-------gg-g----k-k---k--------TT----o------k-------##--gg------------#----#-TT---###-
XXXXXXXXXXXXXXXXXXXXXXXXXXXXXXXX||----XXXXXXX--X-XXX%S-----XX-----XXXXXXXX-S%%-XXXXXXXXXXXXXXXXXXXXXXXXXXXXXXXXXXXXXXXXXXXXXXXXXXXXXXXXXXXXXXXXXXXXXXXXXXXXXXXXXXXXXXXXXXXXXXXXXXXXXXXXXXXXXXXXX
XXXXXXXXXXXXXXXXXXXXXXXXXXXXXXXX||----XXXXXXX--X-XXX|------XX--X--XXXXXXXX--||-XXXXXXXXXXXXXXXXXXXXXXXXXXXXXXXXXXXXXXXXXXXXXXXXXXXXXXXXXXXXXXXXXXXXXXXXXXXXXXXXXXXXXXXXXXXXXXXXXXXXXXXXXXXXXXXXX
