--------------------------------------------------------------------------------------------------------------------------------------------------------------------------------
--------------------------------------------------------------------------------------------------------------------------------------------------------------------------------
---------------------------------------o----------------------------------------------------------------------------------------------------------------------------------------
--------------------------------SSSSSSSSS---------------------------------------------------------------------------------------------------------------------------------------
--------------------------------SS---------------------------------g------------------------------------------------------------------------------------------------------------
------------------------------------------------------------------##------------------------------------------------------------------------------------------------------------
--------%%%%%%%%--SSS--------------------------------------------------------------------------------o---------S--------SS------SSS-----------------------------SSSS-----QQQ----
---------||||||-----------------S-----------------------ooo--------------oo----------------------------------------------------------o------------------------------------------
---------||||||-----------------SS--------------------------------------------------------------S-S-----------------------------------------------------SSS---------------------
---------||||||-----------------S-------------------------------------------------1---------------------------------------------------------------------------------------------
------%%%%%%%%%%----------------------#-----------S------------------------------------------------####--##-----------------------------------------------------------------QQ--
-------||||||||-------------------TT--#-----------------------------------------------------------######-##----#------------##--TT-------TT-----------------##------------------
-------||||||||-------------------TT###-------------------------------------TT---------TT--------#######-##----#------------##--TT----tt-TT----------------#-#--------tt--#-----
-------||||||||----ggg---------y--TT###---------ggg-------g-g----gg-------k-TT---------TT-------########-##----#-------g---###--TT----tt-TT----y--------y-####--g-----tt--#----g
XXXXXXXXXXXXXXXXXXXXXXXXXXXXXXXXXXXXXXXXXX-----XXXXXXXXXXXXXXXXXXXXXXXXXXXXXXXXXX----XXXXXXXXXXXXXXXXXXXXXXXXXXXXXXXXXXXXXXXXXXXXXXXXXXXXXXXXXXXXXXXXXXXXXXXXXXXXXXXXXXXXXXXXXXX
XXXXXXXXXXXXXXXXXXXXXXXXXXXXXXXXXXXXXXXXXX----XXXXXXXXXXXXXXXXXXXXXXXXXXXXXXXXXXX---XXXXXXXXXXXXXXXXXXXXXXXXXXXXXXXXXXXXXXXXXXXXXXXXXXXXXXXXXXXXXXXXXXXXXXXXXXXXXXXXXXXXXXXXXXXX
