------------------------------------------------------------------------------------------------------------------------------------------------------------------------------------------------
------------------------------------------------------------------------------------------------------------------------------------------------------------------------------------------------
------------------------------------------------------------------------------------------------------------------------------------------------------------------------------------------------
-----------------------------------------------------------------------------------------------------------------------------------S-SSSSSSSSSSS----------------SS--------------------S---------
------------------------------------------------------------------------------------------------------------------------------------------------------------------------------------------------
------------------------------------------------------------------------------------------------------------------------------------------------------------------------------------------------
--------%%%%%%%%-----------%%--------------------%%%---------------------------------QQQ------------------------------------------------------------Q-SSS--SSS-S--------------------------------
---------||||||------------||---------------------|-------------------------S--------------#---S-----------------------------------------------------------------o------------------------------
---------||||||------------||---------------------|-------------------------S--------------#----------------------------------------------------------------------------------------------------
---------||||||------------||---------------------|--------------------g---------#---------##----------------------------------------------------------k----------------------------------------
------%%%%%%%%%%---------%%%|--------S------------|-------------Q#----###--------##------####----------#-----S-----------TT--SS-----------------SQS----UQS--SQS----------------------------#----
-------||||||||-----------|-|-ooTT----------------|------TT----------------------###-----####---TT-----------------------TT---------------------------------------------TT---------------#-#----
-------||||||||-----------|-|%%%TT----------------|------TT---------------------####----#####---TT-----------------------TT--------------TT-----------------------TT----TT--------------####-###
-------||||||||-----------|-|-|-TT--------------%-|----k-TT----#----------------####---######---TT--------kgk------k-----TT---------gg---TT----k---g------------k-TT----TT------------######-###
XXXXXXXXXXXXXXXX%%%%%%%%%%%-|-|-XXXXXXXXXXXXXXXX|-|-XXXXXXXXXXXXXXXXXXXXXXXXXXXXXXXXXXXXXXXXXXXXXXXXXXXXXXXXXXXXXXXXXXXXXXXXXXXXXXXXXXXXXXXXXXXXXXXXXXXXXXXXXXXXXXXXXXXXXXXXXXXX-XXXXXXXXXXXXXXX
XXXXXXXXXXXXXXXX-|||||||||--|-|-XXXXXXXXXXXXXXXX|-|-XXXXXXXXXXXXXXXXXXXXX-XXXXXXXXXXXXXXXXXXXXXXXXXXXXXXXXXXXXXX-XXXXXXXXXXXXXXXXXXXXXXXXXXXXXXXXXXXXXXXXXXXXXXXXXXXXXXXXXXXXXXXXXXXXXXXXXXXXXXX
