------------------------------------------------------------------------------------------------------------------------------------------------------------------------------------------------
------------------------------------------------------------------------------------------------------------------------------------------------------------------------------------------------
------------------------------------------------------------------------------------------------------------------------------------------------------------------------------------------------
----------------------------------------------------------------------------------------------------------------SSSSSSSSSSSSSSSS----------------------------------------------------------------
------------------------------------------------------------------------------------------------------------------------------------------------------------------------------------------------
-------------------------------------------------------------------------------------------------------------------------------------------------oo-----oo--------------------------------------
--------%%%%%%%%-------------------------------------------------------SS----------------------------------#--------------------SSSSSSSS--------------------------------------------------------
---------||||||-------------S------------------o---------------------------------o------------------------##------------------------------------------------------------------------------------
---------||||||--------TT--------------------------------------------------------------------------------###------------------------------------------------------------#-----------------------
---------||||||--------TT-----------------oo--------------------------------------o--------#------------####-----------------------------------------------------------k------------------------
------%%%%%%%%%%-------##-----------------%%-------------%%-----------------------t-----TT--------------###-------TT----------------S---------S---------TT-------------##----#-------------#----
-------||||||||---------------------------||--o----------||-----------------------TT----TT------------y####-------TT---TT-------------------------TT----TT------#------#---#-#-------------##---
-------||||||||---------------------------||-%%%---------||-----------------------TT----TT------------#####-------TT---TT-------------------------TT----TT------#------#---###-------------##---
-------||||||||------------k--------------||--|----r-----||-----------------------TT----###----------#####--------TT---TT---g--------kg-----k-----TT----TT-----##-----##---####-#------g--###--#
XXXXXXXXXXXXXXXXXXXX-----XXXX--X-------%%%%|--|---%%%%%%%%%%%%%%XXXXXXXXXX-------XXXXXXXXXX-----XXXXXXXXXX-----XXXXXXXXXXXXXXXXXXXXXXXXXXXXXXXXXXXXXXXXXXXXXXXXXXXXXXXXXXXXXXXXXXXXXXXXXXXXXXXXX
XXXXXXXXXXXXXXXXXXXX-----XXXX-XX--------||-|--|----||||||||||||-X-XXXXXXXX------XXXXXXXXXXX-----XXXXXXXXXX-----XXXXXXXXXXXXXXXXXXXXXXXXXXXXXXXXXXXXXXXXXXXXXXXXXXXXXXXXXXXXXXXXXXXXXXXXXXXXXXXXX
