---------------------------------------------------------------------------------------------------------------------------------------------------------Q----------------------
-----------------------------------------------------------------------------------------------------------------------------------------------------------K-K------------------
--------------------------------------------------------------------------------------------------------------------------------------------------------------Q-----------------
--------------------------------------------------------------------------------------------------------------------------------------------------------------------------------
-----------------------------------------------------------------g-g-------------------------------k------------------------------------------------------g---------------o-----
-----------------------------------------------------g----------%%%%-----------------------------###--------------------------------------oo---------%%%%%%%--------------------
--------%%%%%%%%-------#-------------SSSSS---------SSSS----------||-------------------------SS------------------------R-------------------------------|||||---------------------
---------||||||-------##---------------------------SSS-----------||-----ooooo------------o----------------o-------------------------------------------||r||---U-----------------
---------||||||------####-------------------------SSSSS----------||---------------------SS--------------------------------------------------------%%%%%%%%|-----%%%%%-----------
---------||||||-----#####---------o------------#-----------------||------S-------------SSSS--------------------------------------------------------||||||-|------|||---r------r-
------%%%%%%%%%%----#-###--------------------###---------------#-||---------------------SS-------US------------------------------------------------||||||%%%%%%--%%%-%%%%%%%%%%%
-------||||||||---#######-------------------###----------------#-||--------------------------------------------------------------------------------||||||-||||----|---|||||||||-
-------||||||||--########------------------####-SS-------------#-||--------------------------------------------------------------------------------||||||-%%%|%---|---|||||||||-
-------||||||||-#########----------kk-----#####----------#-----#-||---------##------------k-----gg----------g-g--------k---------------------------||||||--|-||---|---|||||||||-
XXXXXXXXXXXXXXXXXXXXXXXXX--XXXX-XXXXXXXXXXXXXXXXX---XXXXXXXXXXXXXXX-XXXXXXXXXXXXXXXXXXXXXXXXXXXXXXXXXXXXXXXXXXXXX---XXXXXX------XXXXXXXXXX----XX-%%||%%|%%%%%%%---|---%%%%|||||-
XXXXXXXXXXXXXXXXXXXXXXXXX--XXXX-XXXXXXXXXXXXXXXXX---XXXXXXXXXXXXXXXXXXXXXXXXXXXXXXXXXXXXXXXXXXXXXXXXXXXXXXXXXXXXX---XXXXXX------XXXXXXXXX-----XX-|||||||g|||||----|----||-|||||-
