------------------------------------------------------------------------------------------------------------------------------------------------------------------------------------------------
------------------------------------------------------------------------------------------------------------------------------------------------------------------------------------------------
------------------------------------------------------------------------------------------------------------------------------------------------------------------------------------------------
--------------------------------SSSS------------------------------------------------------------------------------------------------------------------------------------------------------------
-------------------------------------------------------------------------------------------------------------------------------------------------------------------------o----------------------
------------------------------------------------------------------------------------------------------------------------------------------------------------------------------------------------
--------%%%%%%%%-----------------------------------------------------------------ooo----------oo-%%%--------------------------------------------SSSS---------S--------SSSS---SS-----%%----%%%%--
---------||||||------------------------------------------------#----------------------------------|---------------------------------------------------------------o-----------------||-----||---
---------||||||------------------------------------------------#----------------------------------|-----------------------#---------------------------------------------------------||-----||--#
---------||||||----------------------------#------------------##----------------ooo------------o--|----------------------##---------------------------------------------------------||-----||-##
------%%%%%%%%%%----------######-----------##------------TT---------------------S-----------------|---------%%S----------##-------TT----------------S--------USS-----------SSS------||-%%%%%|-##
-------||||||||---------------------------###------------TT----o----------------------------------|---------||----------###-------TT----------TT------------------------------------||--|||-|###
-------||||||||------------------------TT-###------------TT----#----------------------------------|---------||-----K--#####----TT-TT-----TT---TT------------------------------------||--|||-####
-------||||||||-----------------k----k-TT-###------------TT---##---------------k----ggg-----------|---------||--------#####----TT-TT-----TT---TT----------k-------------------------||--|||-####
XXXXXXXXXXXXXXXXXXXXXXXXXXXXXXXXXXXXXXXXXXXXXXXX-%%%-----XXXXXXXXXXXXX---XXXXXXXXXXXXXXXXXXXXXXX--|-XXXXXXXXXXXXXXXXXXXXXXX-XXXXXXXXXXXXXXXXXXXXXXXXXXXXXXXXXXXX--XX-%%------%%%%%%%%XXXXXXXXXXX
XXXXXXXXXXXXXXXXXXXXXXXXXXXXXXXXXXXXXXXXXXXXXXXX--|------X-XXXXXXXXXXX----XXXXXXXXXXXXXXXXXXXXXX--|XXXXXXXXXXXXXXXXXXXXXXXX-XXXXXXXXX-XXXXXXXXXXXXXXXXXXXXXXXXXX-----||-------||||||--XXXXXXXXXo
