------------------------------------------------------------------------------------------------------------------------------------------------------------------------------------------------
------------------------------------------------------------------------------------------------------------------------------------------------------------------------------------------------
------------------------------------------------------------------------------------------------------------------------------------------------------------------------------------------------
--------------------------------SS------------------------------SSSS------------------------------------------------------------------------------------------------------------SSS-------------
------------------------------------------------------------------------------------------------------------------------------------------------------------------------------------------------
-------------------------------------------------------------------------------------------------------------------------------------g----------------------------------------------------------
--------%%%%%%%%-----------------------o------------------------%%%---------------------------------------SS-------------------------SQ-oS-----------------------SSS----------o-----------------
---------||||||--------------------------------------------------|--------------------------------------------------------------------------------------------##-------------------%%--------SSS
---------||||||--------------------------------------------------|-S----------------------------------------------------------------------------------------####--------------SS---||-----------
---------||||||--------------------------------------------------|--------------------------------------------------g--------------------------------------#####-----------S-ooo---||-----------
------%%%%%%%%%%----------######---#####-------------------------|--------------------SSSSSS--------------%%SS-------------------SS---SS-----SS------------#####--------#----------||------#----
-------||||||||-----------------#----------------#---------------|----------------------------------------||----TTTT--K---------S----------------------TT--#####--------#----------||------#----
-------||||||||-----------------#---------------##-----------K---|----------------------------------------||----TTTT-----TT----------------------------TT--#####-------##----------||-SS---#----
-------||||||||-----------------#----------kgg--##-----k-----#---|-----------------k----------------------||----TTTT-----TT-----------U----------------TT--#####-------###------#--||-----##----
XXXXXXXXXXXXXXXXXXXXXXXXXXXXXXXXXXXXXXXXXXXXXXXXXXXXXXXXXXXXXXXX-|---XXXXXXXXXXX-X%X------XXXXXX-----%%%--||-%%-XXXXXXXXXXXXXXXXXXXXXXXXXXX-XXXXXXXXXXXXXXXXXXXXXXXXXXXXXXX-XXXXXXX|XXXXXXXXXXXX
XXXXXXXXXXXXXXXXXXXXXXXXXXXXXXXXXXXX-XXXXXXXXXXXXXXXXXXXXXXXXXXX-|----XXXXXXXXXX--X-------XXXXXX------|---||-||-XXXXXXXXXXXXXXXXXXXXXXXXXXX-XXXXXXXXXXXXXXXXXXXXXXXXXXXXXXX-XXXXXXX|XXXXXXXXXXXX
