------------------------------------2-------------------------------------------------------------------------------------------------------------------------------------------
-----------------------------------#--------------------------------------------------------------------------------------------------------------------------------------------
----------------------------------#---------------------------------------------------------------------------------------------------------------------------------------------
---------------------------------##--#----------------------------------------------------------SS-S--SSSSSSSSSS-------------------------------------------SSS--o---------------
---------------------------------##k##--------------------------------------------------------------SSSSSSSSSSS--------------------g----------------------------%---------------
--------------------------------%###----------------------------------------------------------------SSSSSSSS---------------------###----------------------------|---------------
--------%%%%%%%%--SQQQSUSS------|-----------------------------2--------#----------------------------------------------SooSS----%--------------------------------|---------------
---------||||||-----------------|#-------oooo-------------------------##-------------------------------------S-----------------|-------------------------o------o---------ooo---
---------||||||-----------------|------------------------------------####-------------------------%--------------------SSSS----|--------------------------------|---------------
---------||||||--------------R--|-----------------------------------####--------------------------|---Sr---oSSSS---------------|---------S---------------S----o-|--------------o
------%%%%%%%%%%---S---------#--|----------------oSS------------------##--------------------------|%%%%%%%%%%%%-------SSSS-----|------------------------------S-|-TT------------
-------||||||||-------------##--|------TT-------------------------TT-####-----TT---------TT-------|-||||||||||-----------------|--------------------------------|-TT---TT-------
-------||||||||------------###--|------TT----TT---------%--------#TT#####-----TT---------TT-------|-||||||||||---------S---#---|----TT--------------------------|-TT---TT-------
-------||||||||------k----####--|-k----TT-k--TT---g-----|-k-y---##TT#####-----TT-----y---TT-------|-||||||||||-----------k-#---#----TT----k----------------g----|-TT---TT-------
XXXXXXXXXXXXXXXXXXXXXXXXXXXXXXXXXXXXXXXXXXXXXXXXXXXXXXXXXXXXXXXXXXXXXXXXXXXXXXXXXXXXXXXXXXXXXXXX--|%%%%|%%||||------XXXXXXXXXXXXXX--XXXXXXXXXXXXXXXXX---XXXXXXXX|XXXX--XX----XX-
XXXXXXXXXXXXXXXXXXXXXXXXXXXXXXXXXXXXXXXXXXXXXXXXXXXXXXXXXXXXXXXXXXXXXXXXXXXXXXXXXXXXXXXXXXXXXXXX--|-||-|g|||||--X---XXXXXXXXXXXXXXX-XXXXXXXXXXXXXXXXX----XXXXXXXXXXXX--XX----XX-
