--------------------------------------------------------------------------------------------------------------------------------------------------------------------------------
---------------------------------------------------------------------------------------------------------------------------------------------K----------------------------------
----------------------------------------------------------------------------------------------------------------------------------------------QU--------------------------------
--------------------------------------------------------------------------------------------------------------------------------------------------------------------------------
------------------------------------------------------------------------------------------------------------------------------------------gR------------------------------------
------------------------------------------------------------------------------------------------------------------------------------%%%%----------------------------------------
--------%%%%%%%%-----------------------------------Q-----------------------------------#---------SQSSS--SSS@------SoSUSSooo----%-----||-----------------------------------------
---------||||||------------------------------------------------------------------------#---------------------------------------|-----||-----------------------------------------
---------||||||----------------------------------------------------------------------###--------------------------SSS----------|-----||-------------------------S---------------
---------||||||----------------------------------------------------------SSS--------####-------------------gg---------------y#-|-----||r---r--@----------------------#----------
------%%%%%%%%%%---------------------------------------#---------------------------#-###-----------------@--Q------SoS------##-|%%%%%%%%%%%%%------S---------##--------#--------
-------||||||||---------------------TT-------------#---#----------------------TT--######-------------B-B-------------------###-#-|||||||||||-----K----------###------#----------
-------||||||||---------------------TT-------------#-#-#---------------TT-----TT-#######-------------b--U------------------#---#-|||||||||||---------------####--#-#-#----------
-------||||||||------y--------------TT---y---------#-#-#---------------TT---k-TT-#######-----------g-b---------g-----g---###-----|||||||||||------K-------######-#-#-#-#--------
XXXXXXXXXXXXXXXXXXXXXXXXXXXXXXXXX---XXXXXXX-----XXXXXXXXXXXXXXXXXXXX---XXXXXXXXXXXXXXXXXXXXXXXXXXXXXXXXXXXXXXXXXX--XXXXXXXXXXX-X-||||||||XXX--X-XXXXXXXXXXXXXXXXXXXXXXXXXXXXXXXX
XXXXXXXXXXXXXXXXXXXXXXXXXXXXXXXXX---XXXXXXX-----XXXXXXXXXXXXXXXXXXXX---XXXXXXXXXXXXXXXXXXXXXXXXXXXXXXXXXXXXXXXXXX---XXXXXXXXXX-X-||||||||XXX--X-XXXXXXXXXXXXXXXXXXXXXXXXXXXXXXXX
