------------------------------------------------------------------------------------------------------------------------------------------------------------------------------------------------
------------------------------------------------------------------------------------------------------------------------------------------------------------------------------------------------
------------------------------------------------------------------------------------------------------------------------------------------------------------------------------------------------
---------------------------------------------------------------------------------------------------------------oSSSSS--S-----------------------------------o------------------------------------
------------------------------------------------------------------------------------------------------------------------------------------------------------------------------------------------
------------------------------------------------------------------------------------------------------------------------------------------------------------------------------------------ooo---
--------%%%%%%%%-------------------------------o------------------------SS---------------------------------------------------o-o-------SSSS%%%--------------ooo---------------------SSSS--------
---------||||||---o-------------------------------------------------------------------ooo------o-------------------S%-------------o---------|----------o---------------------------------------o
---------||||||--%%%-------------------------SSS-----TT-------------------------------------------------------------|--------SS--%%%--------|----------S--SSSSSS--------------------------------
---------||||||---|----------------------------------TT----------------------------------------------------o--------|---------S---|---------|--------------ooSSS------------------------------oo
------%%%%%%%%%%--|------------------S------SSSS-----##---------------------SSS---------------------------%%--------|----#-#------|---------|--SS-----------SSS-----------------#SSSS----------S
-------||||||||---|------------o--------------------------------------------------------------------------||-o------|----#-#------|---------|-----------------------------------#------TT----#--
-------||||||||---|------------%--------------------------------------------------------------------------||-K%-#---|g--####------|---------|%##--------------------------------#------TT----#--
-------||||||||---|------------#--------------------------g-------o---------------------------------------||--|-#-#####-####------|---------||##--------------------------------#------TT---##--
XXXXXXXXXXXXXXXX-%%XXX%XXXX----XXXXXXXXXXXXXXXXXXXX---XXXXXXXXXXXXXXXXXXXXXXXXXXXoXXXXXXXXXXX-XX----%%%%%-||%%%%XXXXXXXXXXXXXXXX-%XXXXXXXXXXXXX-XXXX--XX---XXX-X------%%%%%-%%%XXXXXXXXXXXXXXXXX
XXXXXXXXXXXXXXXX-||XXXXXXXX----XXXXXXXXXXXXXXXXXXXX---XXXXXXXXXXXXXXXXXXXXXXXXXXXXXXXXXXXXXXXXXX-----|||--||-||-XXXXXXXXXXXXXXXX-|XXXXXXXXXXXXX-XXXX-XXX---XXX-X-------||X---|-XXXXXXXXXXXXXXXXX
