---------------------------------------------------------------------------------------------------------------------------------%----------------------------------------------
-----------------------------K---------------------------------------------------------------------------------------------------|----------------------------------------------
---------------------------------o-----------------------------------------------------------------------------------------------|----------------------------------------------
--------------------------------SSSSSSS---SSSSSS---------------------------------------------------------------------------------|----------------------------------------------
---------------------------------------------------------------------------------------------------------------------------------|----------------------------------------------
--------------------------------------------------##-----------------------------------------------------------------------------|----------------------------------------------
--------%%%%%%%%---------------------------------------------------------------------------------------------SSS-----------------|-------------------------------------#--------
---------||||||---------------------------------%-------------------------------------------------------------------%%-----------|%%%%%-------------------------SSS---##--------
---------||||||-----------------%---------------|-------------------------------------------------------------------||-----------|-|||--------------------------S----###--------
---------||||||-----------------|---------------|-------------------------SS--S-------------------------------------||-----------|-|||------------------------------####----TT--
------%%%%%%%%%%--2-------------|---------------|-------------------------------------------------S-------S---------||----------QQQQ||---------#-------------------#####-#--TT--
-------||||||||-----------------|---------------|---TT------TT---------TT------------------------------TT-----------||--------------||---------#------------------######----TT--
-------||||||||------------B----|------##-------|---TT------TT---------TT------------------------------TT-----------||tt------------||---------#-----------------#######----TT--
-------||||||||-K----------b----|---------------|-k-TT----k-TT---------TT------------------------------TT---kk------||tt-------g----||----g----#-------k--------########----TT--
XXXXXXXXXXXXXXXXXXXXXXXXXXXXXXX-|-------X-----XXXXXXXXXXXXXXXXXXXXXX---XXXXXXXX-XXXX-XXXXXXXXXX-XXXXXXXXXXXXXXXXXXXXXXXXXXXXXXXXXXXXXXXXXXXXXXXXXXXXXXXXXXXXXXXXXXXXXXXXXXXXXXXX
XXXXXXXXXXXXXXXXXXXXXXXXXXXXXXX-|-------X-----XXXXXXXXXXXXXXXXXXXXXX---XXXXXXXX-XXXX-XXXXXXXXXX-XXXXXXXXXXXXXXXXXXXXXXXXXXXXXXXXXXXXXXXXXXXXXXXXXXXXXXXXXXXXXXXXXXXXXXXXXXXXXXXX
