--------------------------------------------------------------------------------------------------------------------------------------------------------------------------------
--------------------------------------------------------------------------------------------------------------------------------------------------------------------------------
---------------------------1---------------------------------------------------------------------------K-------------------R----------------------------------------------------
--------------------------------SSSSSSSSSSSSSSSS--------------------------------------------------------------------------------------------------------------------------------
--------------------------------SSS---------------------------------------------------------------------------------------------------------------------------------------------
---------------------------------SSSS--------------------------------------------------o----------------------------------------------------------------------------------------
--------%%%%%%%%----SSSooooo---%--------------S--------------------S-----------S----------------o--------g--------ooSUSUSSSSS-@%------UR----------------------------------------
---------||||||----------------|--SSS------------o--------------------------------oo-----------------%%%-----U-----------------|--%%%%%%----------------------------------------
---------||||||----------------|SSSS-------------------##---------------------------------------------|------------------------|---||||-----------------------------------------
---------||||||-------------U--|-----------------------##---------------------------------------------|------------------------|---||||----------------------------g---------g--
------%%%%%%%%%%-2-------@SS---|S-#-#-----------------###---------%%%%%%%--------##--------------2----|------------------@SSQQQQQQQQQ||-----------------------------------------
-------||||||||----------------|#-#-#----##----#------###----------|||||---------------TT-------------|-----TT-----------------------||--------------------------------------#--
-------||||||||----------------|###-#-#--#-----#------###----------|||||--%%%----------TT------------B|--TT-TT-----#--B--------------||-------------TT----------------------##--
-------||||||||-----gR---------|#---#-#--------#------###----------|||||--g|-----------TT------g-----b|k-TT-TT-k---#-rb------ggg-g-gggg--------k----TT------#-----------K--###--
XXXXXXXXXXXXXXXXX---XXXXXXXXXXXXX---XXXX-X-----XXXXXX--XX-----XX---|||||---|----XXXXXXXXXXXXXXXXXX--XXXXXXXXXXXXXXXXXXXXXXXXXXXXXXXXXXXXXXXXXXXXXXXXXXXXXXXXXXXXXXXXXXXXXXXXXXXX
XXXXXXXXXXXXXXXXX---XXXXXXXXXXXXX---XXXX-------XXXXXX-XXX-----XX---|||||---|----XXXXXXXXXXXXXXXXXXX-XXXXXXXXXXXXXXXXXXXXXXXXXXXXXXXXXXXXXXXXXXXXXXXXXXXXXXXXXXXXXXXXXXXXXXXXXXXX
