--------------------------------------------------------------------------------------------------------------------------------------------------------------------------------
--------------------------------------------------------------------------------------------------------------------------------------------------------------------------------
--------------------------------------------------------------------------------------------------------------------------------------------------------------------------------
------------------------------------------------SSSSSSSSSSSSSSSS----------------SSSSSSSSSSSSSSSS--SSSSSSS--SSSSS-----------------------------------oo---------------------------
----------------------------------------------------------------------------------SSSSS---S-------SSS---------------------------------------------------------------------------
---------------------------------------o------------------------------------------------------S---SSSSooo----SS-----------------------------------------------------------------
--------%%%%%%%%-------------------------------------------o-SSSSS-------QQQ-----SooSUS--oSSSSSS------------SS------------------------r-----------------------------------------
---------||||||-----------------o--------------------------SSSS--------------------S---------------------SSSSSS-----------------%%%%%%%%%%-----------r------------------oo------
---------||||||-----------------------------------SS------SSS--------------------SSSSSS-S-----------------SSSS-------------------||||||||-------%%%%%%%%---------------%%%%%----
---------||||||----------SS------------------ooo-------------------------------------------------KS-------SSSSS------------------||||||||--------||||||-----------------|||-----
------%%%%%%%%%%-------TT--------------------%%%S--------SSS---------------Q@---o--S------S----S--------------S-----------------SS|||||S|---TT---||||||--%%%------------|||-----
-------||||||||--------TT-----TT--------------|--------------------------------------------------S--------------------------------|||||-|---TT---||||||---|-------------|||---TT
-------||||||||--------TT-----TT--------------|-----------%%%---------tt--------SS--------S-------------T-------B-----------------|||||-|---TT---||||||---|-------------|||---TT
-------||||||||---K----TT---kkTT--------------|------------|----------tt-------g------------------------T-kkk---T----y---------g--|||||k|y--TT---||||||---|-------------|||---TT
XXXXXXXXXXXXXXXXXXXXXX-XXXXXXXXXXXXXXXX-------|----------%%%%%--XXXXXXXXXXXXXXXXX--XXXXX-------XXXXXXXXXXXXXXXXXXXXXXXXXXXXXXXXXXXXXXXXXXXXXXXXXXXXX|X|---XX--XXXXXXXXX-XXXXXXXX
XXXXXXXXXXXXXXXXXXXXXXXXXXXXXXXXXXXXXXX-------|-g---------||g---XXXXXXXXXXXXXXXXX--XXXXX-------XXXXXXXXXXXXXXXXXXXXXXXXXXXXXXXXXXXXXXXXXXXXXXXXXXXXX|X|---XX--XXXXXXXXX-XXXXXXXX
