------------------------------------------------------------------K-----------------------------------------------------------------------------------------------------------------------------
------------------------------------------------------------------------------------------------------------------------------------------------------------------------------------------------
---------------------------------------------------------------------------------------------------------------------------------------------------------------------------2--------------------
------------------------------------------------------------------------------------------------------------------------------------------------------------------------------------------------
------------------------------------------------------------------------------------------------------------------------------------------------------------------------------------------------
------------------------------------------------------------------------------------------------------------------------------------------------------------------------------------------------
--------%%%%%%%%--So-----------------------------------------------------------------------------------@S---------------------------------------------------------------------------------------
---------||||||---------------------------------------------------------------------------o-----------------------------------------------------------------------------------------------------
---------||||||---------------------------------------------------------------------------------------------------------SS--------------------------------------------------------------SS------
---------||||||-------------------------SSoo---#--------S-----------------------------------------------SS-----------------------------------------------------------------------------SSSS-----
------%%%%%%%%%%-------#----------------------##--------SS---------S-------------@S--------------------SSS----------------------Q-------SSQ-------2-----S----##-------------------S----SSS------
-------||||||||--------#---------K-----------##------------------K--K-------T-------K--TT--------------------#---K------------------------------------------###--K--K---------------------------
-------||||||||----#------------------------###-----------------------------TT---------TT--------------------#---------------------------------------------####---K-----------------------------
-------||||||||----#---#-----ggg--K--------####--------------------k--------TT----g----TT---g---K----------###----K-----------#-----------------K-------y-#####--------#------------------------
XXXXXXXXXXXXXXXXXXXXXXXXX--XXXX-XXXXXXXXXXXXXXXXXXX-XXXXXXXXXXXXXXXXXXXXXXXXXXXXXXXXXXXXXXXXXXXXXXXXXXXXXXXXXXXXXXXXXXXXXXXXXXXXXXXXXXXXXXXXXXXXXXXXXXXXXXXXXXXXXXXXXXXXXXXXXXXXXXXXXXXXXXXXXXXX
XXXXXXXXXXXXXXXXXXXXXXXXX--XXXXXXXXXXXXXXXXXXXXXXXX-XXXXXXXXXXXXXXXXXXXXXXXXXXXXXXXXXXXXXXXXXXXXXXXXXXXXXXXXXXXXXXXXXXXXXXXXXXXXXXXXXXXXXXXXXXXXXXXXXXXXXXXXXXXXXXXXXXXXXXgXXXXXXXXXXXXXXXXXXXXX
