------------------------------------------------------------------------------------------------------------------------------------------------------------------------------------------------
------------------------------------------------------------------------------------------------------------------------------------------------------------------------------------------------
------------------------------------------------------------------------------------------------------------------------------------------------------------------------------------------------
--------------------------------SSS------------------------------------S--------SSSSSSSS----------------------------------------SSSSSSSSSSSSSS-S---------------------------------SSSSSS---------
-------------------------------------------------------------oo-----------------------------------------------o-----------------------------------------------oo--------------------------------
------------------------------------------------------------------------------------------------------------------------------------------------------------------------------------------------
--------%%%%%%%%---------------------------------SoS@SSSSS---S-----------------o-------------------SQS----------@SSSQSSSoS---Soo--------------------QSS-------@-----Q2---S----@#----------------
---------||||||------------o--------------------------------------------------------------------------------------------------------------------------------------------------------------------
---------||||||---------------------------------------------------------------S-----------------------------------------------o----------------------------------------------oo-----------------
---------||||||----------SSS-------------------------------------------------------------------------------------g------------------------------------------------------------------------------
------%%%%%%%%%%---------#--------------------------S--------US-----------------------------------------------S-SSQ----------US----------------------------------2----------S@S-----------------
-------||||||||---------##---------------------------------------------------------------------------------------------------------------K---------------##-------------------------------------
-------||||||||-------####-----------------------------------------------------------tt--------------------------------------------------B----TT--------###-------------------------------------
-------||||||||-------###---------k--g-k--#----#----gg------------kkgg---------------tt-----kk------gggg#---------ggggy---k-k-----#----k-b----TT----gggg##k-k-----kgggk-----------k--k-k-----kkg
XXXXXXXXXXXXXXXX-XXXXXLS@X---XXXXXXXXXXXXXXXXXXXXXXXXXXXXXXXXXXXXXXXXXXXXXXXXXXXXXXXXXXXXXXXXXXXXXXXXXXXXXXXXXXXXXXXXXXXXXXXXXXXXXXXXXXXXXXXXXXXXXXXXXXXXXXXXXXXXXXXXXXXXXXXXXXXXXXXXXXXXXXXXXXX
XXXXXXXXXXXXXXXXXXXXXXXXXX---XXXXXXXXXXXXXXXXXXXXXXXXXXXXXXXXXXXXXXXXXXXXXXXXXXXXXXXXXXXXXXXXXXXXXXXXXXXXXXXXXXXXXXXXXXXXXXXXXXXXXXXXXXXXXXXXXXXXXXXXXXXXXXXXXXXXXXXXXXXXXXXXXXXXXXXXXXXXXXXXXXX
