------------------------------------------------------------------------------------------------------------------------------------------------------------------------------------------------
------------------------------------------------------------------------------------------------------------------------------------------------------------------------------------------------
------------------------------------------------------------------------------------------------------------------------------------------------------------------------------------------------
-------------------------------------------------------------------------------------------------------------------------SSSSS--SSSSSSSS----------------------------------------SSSSSS----------
--------------------------------------------------------------------------------------------------------------o-----------------------------------------------oo--------------------------------
--------------------------o---------------------------------------------------------------------------------------------------------------------------------------------------------------------
--------%%%%%%%%---------------------------------SSQQQ---------------------------------------------UQQQ--S---S@S-----------------------------------SQS--------@S---------------U----------------
---------||||||---------------------------------------------------------------------------------------------------------------------------------------------------------------------------------
---------||||||-----------------------------------------------------------------------------------------------o----------------------------------------------oo--------------oK-----------------
---------||||||---------------------------------------------------------------------------------------------------o-----------------------------------------------------------------------------
------%%%%%%%%%%-2----S#------------------------##Q----------US---------------------------------QQQ---------S@S---------------------------------QQQ---------S@S--------------U------------------
-------||||||||---------------------------------------------------------------T-------tt---------------------------------TT---K------------------------------------------TT---------------#-----
-------||||||||----------------------------------------------------------------T-----ttt---------------------------------TT----------t-----------------------------------TT--------------t#-----
-------||||||||-------------------ggg-----k----k----ggy---kkk------gg-------k-kT--#--ttk-----k-----kggy---k------gg--k-k-TT-k-k------t--------k---kgggy---k-------kggggk-TT---kg-ok--k-k%t#---#T
XXXXXXXXXXXXXXXXXXXXXXX-XXXXXXXXXXXXXXXXXXXXXXXXXXXXXXXXXXXXXXXXXXXXXXXXXXXXXXXXXXXXXXXXXXXXXXXXXXXXXXXXXXXXXXXXXXXXXXXXXXXXXXXXXXXXXXXXXXXXXXXXXXXXXXXXXXXXXXXXXXXXXXXXXXXXXXXXXXXXXXXXXXXXXXXX
XXXXXXXXXXXXXXXXXXXXXXX-XXXXXXXXXXXXXXXXXXXXXXXXXXXXXXXXXXXXXXXXXXXXXXXXXXXXXXXXXXXXXXXXXXXXXXXXXXXXXXXXXXXXXXXXXXXXXXXXXXXXXXXXXXXXXXXXXXXXXXXXXXXXXXXXXXXXXXXXXXXXXXXXXXXXXXXXXXXXXXXXXXXXXXXX
