------------------------------------------------------------------------------------------------------------------------------------------------------------------------------------------------
------------------------------------------------------------------------------------------------------------------------------------------------------------------------------------------------
------------------------------------------------------------------------------------------------------------------------------------------------------------------------------------------------
------------------------------------------------SS------------------------------SSSSSSSS--------SSSSSSSSSSSSSS----------------------------------SSSSSSSSSSS-------------------------------------
------------------------------------------------------------------------------------------------------------------------------------------------------------------------------------------------
------------------------------------------------------------------------------------------------------------------------------------------------------------------------------------------------
--------%%%%%%%%--------------------------------------------------------------------------------------------------------------------QQQ---------------------------oo--SSSo----oS---UQS----------
---------||||||-%S-----------%%%-o---------------------------------------------------------------------------------------------------------------------------------%----------------------------
---------||||||-|----o--------|#-------------------------------------------------------------------------------------------------------------Ko--------------------|-----------S-------------oo-
---------||||||-|---%%%-------##-----------------------------------------------------------------------------------------------------------------------------------|----------------------------
------%%%%%%%%%%|----|--------##--------------------------------------------------------------------------#----------------------------------US--------------------|o----##------2----------S@S-
-------||||||||-|----|--------##---------TT------------t------TT-----------------------------------------##--------------------------------------------------------|-t---##---------------------
-------||||||||-|----|-----#-###--B------TT----T------tt------TT-----------------------------------------##---------------------------------------------t-----TT---|tt--###---------------------
-------||||||||-%%%--|----##--##--bggg-g-TT----T------tt------TT--kggg------kkk---gg-g-----gy-k---------###--------y-gg-----kkk----ygggg--k-k-k---y--g-ktt----TT---|tt-####-------ggggy-------k-
XXXXXXXXXXXXXXXX-|---|-XXXXXX-XXXXXXXXXXXXXXXXXXXXXXXXXXXXXXXXXXXXXXXXXXXXXXXXXXXXXXXXXXXXXXXXXXXXXXXXXXXXXXXXXXXXXXXXXXXXXXXXXXXXXXXXXXXXXXXXXXXXXXXXXXXXXXXXXXXXXXXXXXXXXXXXXXXXXXXXXXXXXXXXXX
XXXXXXXXXXXXXXXX-|---|-XXXXX--XXXXXXXXXXXXXXXXXXXXXXXXXXXXXXXXXXXXXXXXXXXXXXXXXXXXXXXXXXXXXXXXXXXXXXXXXXXXXXXXXXXXXXXXXXXXXXXXXXXXXXXXXXXXXXXXXXXXXXXXXXXXXXXXXXXXXXXXXXXXXXXXXXXXXXXXXXXXXXXXXX
