--------------------------------------------------------------------------------------------------------------------------------------------------------------------------------
--------------------------------------------------------------------------------------------------------------------------------------------------------------------------------
--------------------------------------------------------------------------------------------------------------------------------t-----------------------------------------------
--------------------------------------------------------------------------------------------------------------------------------tt----------------------------------------------
----------------------------------------------------------------------------------------------------------------t---------------tt------------------------------t---------------
--------------------------------------------------------------------------------------------------------------------------------tt----------------------------------------------
---------------------------------------------------------------o-----------------------------------------------o---------------oS--------------o-------------------------------o
-------------------------o-----------------------------------------------ooo----%--##--%---------------------------------------------%%-----------------------------------------
--------------------------------------------------------------------------------|------|---------------------------------------------||-----------------------------------------
--o-------SS-------------SS---------------------------------------o-------S-----|------|---------------------------------------------||------------------------#----------------
-------TT-----#---------------------------------------------------------------#-Q------|-2---------------------------tt---------QQQ--||-----------2-----------#-Q---------------
-K-----TT-----#--------TT-----#---------------------tt-----------------TT-----#------T-|------------tt---------------tt--------------||-------------tt-------##------------tt---
-S-----TT-----#--------TT-----#---------------------tt-----------------TT---###-----TT-|------------tt--------------ttt--------------||-------------tt------###------------tt---
---kk--TT---kk#--------TT---k-#----------------kg---tt-----------------TT---###-----TT-|-------kg---tt--------g-----ttt----tt-g------||------gggK---tt-----####--g---------tt-g-
XXXXX--XXXXXXXXXXXXXXX-XXXXXXXXXXXXXXXXXXXXXXXXXXXXXXXXXXXXXXXXXXXXXXX-XXXXXXXXXXXXXXXXXXXXXXXXXXXXXXXXXXXXXXXXXXXXXXXXXXXXXXXXXXXXXXXXXXXXXXXXXXXXXXXXXXXXXXXXXXXXXXXXXXXXXXXXX
XXXXX--XXXXXXXXXXXXXXXXXXXXXXXXXXXXXXXXXXXXXXXXXXXXXXXXXXXXXXXXXXXXXXX-XXXXXXXXXXXXXXXXXXXXXXXXXXXXXXXXXXXXXXXXXXXXXXXXXXXXXXXXXXXXXXXXXXXXXXXXXXXXXXXXXXXXXXXXXXXXXXXXXXXXXXXXX
