------------------------------------------------------------------------------------------------------------------------------------------------------------------------------------------------
------------------------------------------------------------------------------------------------------------------------------------------------------------------------------------------------
------------------------------------------------------------------------------------------------------------------K-----------------------------------------------------------------------------
------------------------------------------------------------------------------------------------------------------------------------------------------------------------------------------------
---------------------------------------------------------------------------------------------------g--------------------------------------------------------------------------------------------
------------------##----------------------------------------------------------------------------------------------------------------------------------------------------------------------------
--------%%%%%%%%-----------------S------o------------------------------------------S-------------------------------Q-------------------------------SQQS--------Q--------------------------------
---------||||||-----------o--------------------------------------------------------------------------------------------------------------oo-------------------------##--------------------------
---------||||||---------------------------------------------------------------------------------------------------------------------------------------------------------------------------------
---------||||||-----------------------------------------SSS--------------S-----o-------------------------S------------------------------------------------------------------------------SS------
------%%%%%%%%%%Q---------------SS-------------%------------------------------SS----o----#--------------------#----S------------------------------2----------QQ-QS----------------2-----S----##-
-------||||||||--------------------------------|-------------------------------------------------------------##--K--K------------------------------------------------------------------------##-
-------||||||||--------------------------------|----------------------------------------------------tt------###--SK----TT-----------tt-------------------------------------tt---------------###-
-------||||||||----------------------------gg--|----------k----------------g---------y----------K---tt-----####--------TT-----------tt------------K--------y--k------------tt-g-K---------#####-
XXXXXXXXXXXXXXXXXXXXXXXXXXXXXXXXX---XXX--------|XXX-XXXXXXXXXXXXXXXX---XXXXXXXXXX---XXX---------XXXXXXXXXXXXXXXXXXXXXXXXXXXXXXXXXXXXXXXXXXXXXXXXXXXXXXXXXXXXXXXXXXXXXXXXXXXXXXXXXXXXXXXXXXXXXXXX
XXXXXXXXXXXXXXXXXXXXXXXXXXXXXXXXX---XXX--------|XXX-XXXXXXXXXXXXXXXX---XXXXXXXXXX---XXXX-X------XXXXXXXXXXXXXXXXXXXXXXXXXXXXXXXXXXXXXXXXXXXXXXXXXXXXXXXXXXXXXXXXXXXXXXXXXXXXXXXXXXXXXXXXXXXXXXXX
