------------------------------------------------------------------------------------------------------------------------------------------------------------------------------------------------
------------------S-----------------------------------------------------------------------------------------------------------------------------------------------------------------------------
------------------------------------------------------------------------------------------------------------------------------------------------------------------------------------------------
----------------SSSSSSSSSSSSSSSS--------------------------------SSSSSS----------------------------------------------------------------------------------------------------------SSSS------------
------------------------------------------------------------------------------------------------------------------------------o-----------------------------------------------------------------
----------------------------------------------------------------------------------------------------------------------------------o-------------------------------------------------------------
--------%%%%%%%%--------------So-----------------------------------------------------Q-------------------------U@SSSQSQSQS---SSS--%---------------------------------S----------o--------o-------
---------||||||-------------------------------------------------------------------------------------------------------------------|-------------------------------------------------------------
---------||||||-----------------------------------------------o------------------------------S------------------------------------|-------------------------------------------K-----------------
---------||||||-o-oo-----------o---------------------------------------------------------------------------------------g----------|-------------------------------------------------------------
------%%%%%%%%%%--------------------------------------------S@S------------------------------U--------------------QQQ-SSS----US---|-------------------------------------------------------------
-------||||||||-------------#-------------K--------------TT------------tt--------------------------------TT-----------------------|--------------------------------------TT---------------------
-------||||||||-----------#-#--------B-------------------TT------------tt--------------------------------TT-----------------------|--------------------------------------TT-----TT--------------
-------||||||||----------##-k-----kk-k-k------kg---kgggg-TT---k--------tt---kkkg---k------k-k-----kk-gok-TT---k----k--y---k------gkk---k-----kkg-----k----kkk-------gggg-TT-----TT---kkk----k---
XXXXXXXXXXXXXXXXXXXXXXXXXXXXXXXXXXXXXXXXXXXXXXXXXXXXXXXXXXXXXXXXXXXXXXXXXXXXXXXXXXXXXXXXXXXXXXXXXXXXXXXXXXXXXXXXXXXXXXXXXXXXXXXXXXXXXXXXXXXXXXXXXXXXXXXXXXXXXXXXXXXXXXXXXXXXXXXXXXXXXXXXXXXXXXXX
XXXXXXXXXXXXXXXXXXXXXXXXXXXXXXXXXXXXXXXXXXXXXXXXXXXXXXXXXXXXXXXXXXXXXXXXXXXXXXXXXXXXXXXXXXXXXXXXXXXXXXXXXXXXXXXXXXXXXXXXXXXXXXXXXXXXXXXXXXXXXXXXXXXXXXXXXXXXXXXXXXXXXXXXXXXXXXXXXXXXXXXXXXXXXXXX
