------------------------------------------------------------------------------------------------------------------------------------------------------------------------------------------------
------------------------------------------------------------------------------------------------------------------------------------------------------------------------------------------------
------------------------------------------------------------------------------------------------------------------------------------------------------------------------------------------------
-------------------------------#----------------------------------------------------------------------------------------------------------------------------------------------------------------
------------------------------------------------------------------------------------------------------------------------------------------------------------------------------------------------
-------------------------------------------------------------------------------------------------oo---------------------------------------------------------------------------------------------
--------%%%%%%%%-------------------------------------------------------------------------------S-%%----------------------------U---------------o---------------o-----------------o-------------S
---------||||||-%%%%%%%%-------------------------------------------------------------------------||---------------------------------------------------------------------------------------------
---------||||||--||||||-------S----------------------------S%SSS---------------------------------||---------------------------------------------------------------------------------------------
---------||||||--||||||---#---------------------------------|------------------------------------||----------------------------------------------------------------------------------------#----
------%%%%%%%%%%-||||||--#----------------------------------|------------------------------------||--2-------o---------------o------------------------------------------------------------###---
-------||||||||--||||||--#----------------------------------|------------------------------------||----tt-----------------------------------------------------------------K---K------S---####---
-------||||||||--||||||###----------------------------------|-----B------------------------------||----tt------------------------------------------------##--------------------------S--#####---
-------||||||||--|||||####---r---k-----k-----ggg------------|---y-b----k----kkkg--#k-----------g-gg----tt---gggg--gggg----k--------k-k----k--------k----###-------gggg-k----k-k---------####k---
XXXXXXXXXXXXXXXX-||XXXXXXX%%%%%-XXXXXXXXXXXXXXXXXXXXXXXXXXXXXS%%XXXXXXXXXXXXXXXXXXXXXXXXXXXXXXXXXXXXXXXXXXXXXXXXXXXXXXXXXXXXXXXXXXXXXXXXXXXXXXXXXXXXXXXXXXXXXXXXXXXXXXXXXXXXXXXXXXXXXXXXXXXXXXXX
XXXXXXXXXXXXXXXX-|X-XXXXXX-|||--XXX-XXXXXXXXXXXXXXXXXXXXXXXXX-||XXXXXXXXXXXXXXXXXXXXXXXXXXXXXXXXXXXXXXXXXXXXXXXXXXXXXXXXXXXXXXXXXXXXXXXXXXXXXXXXXXXXXXXXXXXXXXXXXXXXXXXXXXXXXXXXXXXXXXXXXXXXXXXX
