------------------------------------------------------------------------------------------------------------------------------------------------------------------------------------------------
------------------------------------------------------------------------------------------------------------------------------------------------------------------------------------------------
------------------------------------------------------------------------------------------------------------------------------------------------------------------------------------------------
-------------------------------------------------S--------------------------------------------------------------------------------------------------------------SSSSSS--------------------------
------------------------------------------------------------------------------------------------------------------------------------------------------------------------------------------------
------------------------------------------------------------------------------------------------------------------------------------------------------------------------------------------------
--------%%%%%%%%-------------------------------o-------o-------o------------------------------------QSQS-S---SSS--------------------QQQQ------@-S---QS---------#------------------------------US
---------||||||--------------------------------#------------------------------------------------------------------------------------------------------------------------------------------------
---------||||||----------------S-----------------------------------------------------------------------------oo----------------------------------------------oo-------------------------------o-
---------||||||----------------o-----------------oo----------------------------------------------o-------------------------------------------------------------------------------o--------------
------%%%%%%%%%%--------------------------------------------------------------------------------------------S@S-------------------Q----------US--------------@S-------------------------------S-
-------||||||||------------------------------#---------------------------------------------------------------------------TT-------------------------------K------------t------------------K-----
-------||||||||------------------------------##------B----#-------B----TTT----TT-----------------------------------------TT--------------------------------------------t------------------#-----
-------||||||||-----------k-------gg---------##o-----bog-##-k-----b----TTT----TT--gk--------k-k---gggggg--k-------yg-g-k-TT---kg---k--y---k-k-----ggggk---k------------t----kkkT--gggggg-g#-----
XXXXXXXXXXXXXXXXXXXXXXXXXXXXXXXXXXXXXXXXXXXXXXXXXXXXXXXXXXXXXXXXXXXXXXXXXXXXXXXXXXXXXXXXXXXXXXXXXXXXXXXXXXXXXXXXXXXXXXXXXXXXXXXXXXXXXXXXXXXXXXXXXXXXXXXXXXXXXXXXXXXXXXXXXXXXXXXXXXXXXXXXXXXXXXXX
XXXXXXXXXXXXXXXXXXXXXXXXXXXXXXXXXXXXXXXXXXXXXXXXXXXXXXXXXXXXXXXXXXXXXXXXXXXXXXXXXXXXXXXXXXXXXXXXXXXXXXXXXXXXXXXXXXXXXXXXXXXXXXXXXXXXXXXXXXXXXXXXXXXXXXXXXXXXXXXXXXXXXXXXXXXXXXXXXXXXXXXXXXXXXXXX
