------------------------------------------------------------------------------------------------------------------------------------------------------------------------------------------------
------------------------------------------------------------------------------------------------------------------------------------------------------------------------------------------------
------------------------------------------------------------------------------------------------------------------------------------------------------------------------------------------------
------------------------------------------------------------------------------------------------------------------------------------------------------------------------------------------------
----------------------------------------------------------------------------------------------oo------------------------------------------------------------------------------------------------
------------------------------------------------------------------------------------------------------------------------------------------------------------------------------------------------
--------%%%%%%%%-------Q-----------------------o----------------SSoS-----------S----QQSQQ---------------------------Q--------------------------------Qoo-----U------Q----------S--------o-------
---------||||||---------------------------------------------------------------------------------------------------------------------------------------------------------------------------------
---------||||||---------------------------------------------------------------------------------------------------------------------------------------------------------------------------------
---------||||||--------g#---------------------------------------oo----------------------------------------------------------------o-------------------------------------------------------------
------%%%%%%%%%%-##----##--------------------------------------------------------------------U-----------TT----------------------------------------------------------------------------------U--
-------||||||||--##----##--------------------------------------------------#-----------------------------TT-----------------------K-----TTT-------------------K---------------------------------
-------||||||||--###---#-----------------##----------------------------#####-----------------------------TT-----------------------------TTT---TT------------------------------------------------
-------||||||||-####---#----k-----ggggg--#k-k----gy----g----kkkg-----g######k-----ggggg-----k-----kk-ggk-TT---k----k--g#k-k-k-----yg-g--TTT---TT---k-kg----kk------gggg---k-----------ok----kkk-
XXXXXXXXXXXXXXXXXXXXXXXXXXXXXXXXXXXXXXXXXXXXXXXXXXXXXXXXXXXXXXXXXXXXXXXXXXXXXXXXXXXXXXXXXXXXXXXXXXXXXXXXXXXXXXXXXXXXXXXXXXXXXXXXXXXXXXXXXXXXXXXXXXXXXXXXXXXXXXXXXXXXXXXXXXXXXXXXXXXXXXXXXXXXXXXX
XXXXXXXXXXXXXXXXXXXXXXXXXXXXXXXXXXXXXXXXXXXXXXXXXXXXXXXXXXXXXXXXXXXXXXXXXXXXXXXXXXXXXXXXXXXXXXXXXXXXXXXXXXXXXXXXXXXXXXXXXXXXXXXXXXXXXXXXXXXXXXXXXXXXXXXXXXXXXXXXXXXXXXXXXXXXXXXXXXXXXXXXXXXXXXXX
