------------------------------------------------------------------------------------------------------------------------------------------------------------------------------------------------
------------------------------------------------------------------------------------------------------------------------------------------------------------------------------------------------
------------------------------------------------------------------------------------------------------------------------------------------------------------------------------------------------
------------------SSSSSSSSSSSS-----------------------------------------------------S----------------------------SSSSSSSS-SSSSS--SSSSSSSS----------------------------------------SSSS------------
--------------------------------------------------------------------------------------------------------------o----------------------------------------------Uoo--------------------------------
-------------------------------------------------------------------o-----------o----------------------------------------------------------------------------------------------------------------
--------%%%%%%%%SSSSSSSSSSSSSSSS---------------U-------o-------o%-SSS------------------------------SQS-------SSS--------------SS-------------------SQQQS------------QS--------------------------
---------||||||-------------------------------------------------|-------------------------------------------------------------------------------------------------------------------------------
---------||||||----------------------------------------------oo-|---------------------------------------------o--------------------------------------------------------------oo-----------------
---------||||||-ooooo---------oo--------------------------------|-------------------------------------------------o----------------------------------------------o----------------o-------------
------%%%%%%%%%%SSSSSS-------SSS-------------U----#----------US-|----------SS@So------------------Q-Q--------USS----------------------------------Q----------US-SS-----------@S-----------------
-------||||||||-----------------------------------#-------------|------------------------------------------------------------------------TT-------------------------------K---------------------
-------||||||||------------------------#---------#--------------|--------------------------------------------------------TT--------------TT--------------------------------------------tt-------
-------||||||||------kg--------g--kg---#----kggg-#-k---k----k---|-gggg-g-------------k-y-g--k-k----k--y---k----------g---TT-------#--k-k-TT-k-k---ggggy---k-k-----gggggg--k------------tt-----gg
XXXXXXXXXXXXXXXXXXXXXXXXXXXXXXXXXXXXXXXXXXXXXXXXXXXXXXXXXXXXXXXXXXXXXXXXXXXXXXXXXXXXXXXXXXXXXXXXXXXXXXXXXXX-XXXXXXXXXXXXXXXXXXXXXXXXXXXXXXXXXXXXXXXXXXXXXXXXXXXXXXXXXXXXXXXXXXXXXXXXXXXXXXXXXXXX
XXXXXXXXXXXXXXXXXXXXXXXXXXXXXXXXXXXXXXXXXXXXXXXXXXXXXXXXXXXXXXXXXXXXXXXXXXXXXXXXXXXXXXXXXXXXXXXXXXXXXXXXXXX-XXXXXXXXXXXXXXXXXXXXXXXXXXXXXXXXXXXXXXXXXXXXXXXXXXXXXXXXXXXXXXXXXXXXXXXXXXXXXXXXXXXX
