------------------------------------------------------------------------------------------------------------------------------------------------------------------------------------------------
------------------------------------------------------------------------------------------------------------------------------------------------------------------------------------------------
------------------------------------------------------------------------------------------------------------------------------------------------------------------------------------------------
--------------------------------SSSS------------------------------------------------------------------------------------------------------------------------------------------------------------
------------------------------------------------------------------------------------------------------------------------------o-----------------------------------------------------------------
-------------------------------o-----------------------------------------------------------------ooo--------------------------------------------------------------------------------------------
--------%%%%%%%%%%%%--------------------------------QQQ-------o----------------U---------------o%%%-------------S--QQSQS@S---S@S--------------------------------S--SQQQQ------@-----------------
---------||||||--||------------------------------------------------------------------------------|----------------------------------------------------------------------------------------------
---------||||||--||----------------------------------------------------------o-------------------|----------------------------o-----------------------------------------------o-----------------
---------||||||--||----------------------o-------------------------------------------------------|---------------g-----g---------------------------------------------------------oo-------------
------%%%%%%%%%%-||-------%%%S------------------#----------------------------U-------------------|---------------QQQ---SS----US------2--------------------------Q#QQ---------USS----------------
-------||||||||--||--------|----------------------------------------------K---------------K------|-----TT-----TT-------------------------TT--------------TT-------------------------------------
-------||||||||--||--------|--------------------------------------------------------------#------|-----TT-----TT-------------------------TT---TT-----#---TT---TT--------------------------------
-------||||||||--||--------|----k-#--k-k------kg---k-gg-----k-----kk-ggy------kg--kk-k----#------|gggg-TT---k-TT---kggy---k-k--------k-k-TT---TT--kggg---TT---TT---kggy---k-k-----gyogkk--g-k-k-
XXXXXXXXXXXXXXXX%%%%%XXXXXXXXXXXXXXXXXXXXXXXXXXXXXXXXXXXXXXXXXXXXXXXXXXXXXXXXXXXXXXXXXXXXXXXXXXXXXXXXXXXXXXXXXXXXXXXXXXXXXXXXXXXXXXXXXXXXXXXXXXXXXXXXXXXXXXXXXXXXXXXXXXXXXXXXXXXXXXXXXXXXXXXXXXX
XXXXXXXXXXXXXXXXX|||-XXXXXXXXXXXXXXXXXXXXXXXXXXXXXXXXXXXXXXXXXXXXXXXXXXXXXXXXXXXXXXXXXXXXXXXXXXXXXXXXXXXXXXXXXXXXXXXXXXXXXXXXXXXXXXXXXXXXXXXXXXXXXXXXXXXXXXXXXXXXXXXXXXXXXXXXXXXXXXXXXXXXXXXXXXX
