------------------------------------------------------------------------------------------------------------------------------------------------------------------------------------------------
------------------------------------------------------------------------------------------------------------------------------------------------------------------------------------------------
------------------------------------------------------------------------------------------------------------------------------------------------------------------------------------------------
------------------------------------------------------------------------------------------------SSSSSSS-----------------------------------------------------------------------------------------
----------------------------------------------------------------------------------------------oo------------------------------o-----------------------------------------------------------------
------------------------------------------------------------------------------------------------------------------------------------------------------------------------------------------------
--------%%%%%%%%-o---SSQQ-------------ooo---------------------------------------@SoSS--------S@S-------------------UQ----S---S@S----S--------------------------o----QQQ---------S--SQS---S---SSS
---------||||||---------------------------------------------------------------------------------------------------------------------------------------------------------------------------------
---------||||||----------------------------------------------o--------------------------------o-------------------------------o-----------------------------------------------------------------
---------||||||---k----U--------------------------------------------------------o-------------------------------------------------o-------------------------------------------------------------
------%%%%%%%%%%-SQS---##--------------------o---------------@S--------------U---------------US-----------------QQQ----S---SS@S--SS----------U--------------------Q----------U--SSQQ----SSSSS@S-
-------||||||||--------##---------------------------------K----------------------------------------------------------------------------#-----------------TT-------------------------------------
-------||||||||--------##------------#------------------------------------------------------------------------TT-----------------------B-------------B---TT-------------------------------------
-------||||||||-------#-k----------k-k-k----k-k---gggggg--k---k---gy---k---kkkk----kgggg--g------------k----k-TT--gggg------------gggggb----kkk---k--b---TT---kg--ggggy-----k-----gggg----------
XXXXXXXXXXXXXXXXXXXXXXXXXX--XXXXXXXXXXXXXXXXXXXXXXXXXXXXXXXXXXXXXXXXXXXXXXXXXXXXXXXXXXXXXXXXXXXXXXXXXXXXXXXXXXXXXXXXXXXXXXXXXXXXXXXXXXXXXXXXXXXXXXXXXXXXXXXXXXXXXXXXXXXXXXXXXXXXXXXXXXXXXXXXXXXX
XXXXXXXXXXXXXXXXXXXXXXXXXX--XXXXXXXXXXXXXXXXXXXXXXXXXXXXXXXXXXXXXXXXXXXXXXXXXXXXXXXXXXXXXXXXXXXXXXXXXXXXXXXXXXXXXXXXXXXXXXXXXXXXXXXXXXXXXXXXXXXXXXXXXXXXXXXXXXXXXXXXXXXXXXXXXXXXXXXXXXXXXXXXXXXX
