------------------------------------------------------------------------------------------------------------------------------------------------------------------------------------------------
------------------------------------------------------------------------------------------------------------------------------------------------------------------------------------------------
------------------------------------------------------------------------------------------------------------------------------------------------------------------------------------------------
--------------------------------SS--------------------------------------------------------------------------------------------------------------SS----------------------------------------------
------------------------------------------------------------------------------------------------------------------------------------------------------------------------------------------------
------------------------------------------------------------------------------------------------------------------------------------------------------------------------------------------------
--------%%%%%%%%------SSSS-------------ooo-----o------------------------o-------------SSSS-----o---------------------QQQQ-----------QQQQQSS----o--------o---------------------------QQQQoS-----U
---------||||||--------------------------------------------------------------------------------------------------------------------------------------------------o------------------------------
---------||||||------------------------------------------------------------------------------------------------------------------------------------------------------------------------------oo-
---------||||||-----------------------------------------------------------------------------------------------------------------------------------------S--S------------------------------------
------%%%%%%%%%%------tt-----o-------------------##--####---#-----###2------------#----Q----SSS-------SS--------########Q----Q---------------o---###-----------------------------##---Q-----S@S-
-------||||||||-------tt-------------------------##---------##--TT--------------#-##------------------tS--------####---K-------------------------###---@-----------------#---#---##-------------
-------||||||||-------tt-------------tt----------###-#------##--TT-------TT-----####-----------------tt---------####-----------------------------##--------------------###---##-###-------------
-------||||||||-------tt-----g-g#----tt----kk---######----#####-TT-----k-TT---k-####-----------------tt------kgg###----k----k-----ggg----------g###----k---kk--------#####---##-###k-k------k---
XXXXXXXXXXXXXXXXXXXXXXXXXXXXXXXXXXXXXXXXXXXXXXXXXXXXXXXXXXXXXXXXXXX-XXXXXXXXXXXXXXXXXXXXXXXXXXXXXXXXXXXXXXXXXXXXXXXXXXXXXXXXXXXXXXXXXXXXXXXXXXXXXXXXXXXXXXXXXXXXXXXXXXXXXXXXXXXXXXXXXXXXXXXXXXXX
XXXXXXXXXXXXXXXXXXXXXXXXXXXXXXXXXXXXXXXXXXXXXXXXXXXXXXXXXXXXXXXXXXX-XXXXXXXXXXXXXXXXXXXXXXXXXXXXXXXXXXXXXXXXXXXXXXXX-XXXXXXXXXXXXXXXXXXXXXXXXXXXXXXXXXXXXXXXXXXXXXXXXXXXXXXXXXXXXXXXXXXXXXXXXXXX
