------------------------------------------------------------------------------------------------------------------------------------------------------------------------------------------------
------------------------------------------------------------------------------------------------------------------------------------------------------------------------------------------------
------------------------------------------------------------------------------------------------------------------------------------------------------------------------------------------------
------------------------------------------------------------------------------------------------SS----------------------------------------------SSSSSSS-----------------------------------------
------------------------------------------------------------------------------------------------------------------------------------------------------------------------------------------------
--------------------------------------------------------------------------------------------@---------------------------------------------------------------------------------------------------
--------%%%%%%%%-----------------------------------------------------SSSSS--------------------------------------------oo-----------------------o---------------U-------------------SQ-----------
---------||||||------------------------------K--------------------------------------------------S-----------------------------------------------------------------------------------------------
---------||||||-------------------------------------------------------------------------------------------------------------------------------o----------------------------------------------U--
---------||||||---------------------------------------------------------------------------oo----------------------#-----------------------------------------------------------------------------
------%%%%%%%%%%------------------TT----------------------------SSQ--------------QQQ---@%%%%%SS------------------------------o---------------@S---------------------------#-----SSQ----------US-
-------||||||||----------TT-------TT----##-----o-----------------------------------------|||--oo-----------------#-----------------------TT------------------------------##-#-------------------
-------||||||||----------TT-------TT--####--------B------TT------------------------------|||------B-----tt----@--#-----#-----------------TT------------------------------####-------------------
-------||||||||----------TT----o--TT--####--------b------TT----g---kk-k-------kg---------|||------b-----tt---ggg-#----##----kkk---gggggg-TT-------kk-k-k------kg--gggg--####------ggggy---k-k---
XXXXXXXXXXXXXXXX----XXXXXXXXXXXX-XXXXXXXXX------XXXXXXXXXXXXXXXXXXXXXXXXXXXXXXXX--XXXXXXX|||----XXXXXXXXXXXXXXXXXXXXXXXXXXXXXXXXXXXXXXXXXXXXXXXXXXXXXXXXXXXXXXXXXXXXXXXXXXXXXXXXXXXXXXXXXXXXXXXX
XXXXXXXXXXXXXXXX----XXXXXXXXXXXX-XXXXXXXXX------XXXXXXXXXXXXXXXXXXXXXXXXXXXXXXXX--XXXXXXX|||----XXXXXXXXXXXXXXXXXXXXXXXXXXXXXXXXXXXXXXXXXXXXXXXXXXXXXXXXXXXXXXXXXXXXXXXXXXXXXXXXXXXXXXXXXXXXXXXX
