------------------------------------------------------------------------------------------------------------------------------------------------------------------------------------------------
------------------------------------------------------------------------------------------------------------------------------------------------------------------------------------------------
------------------------------------------------------------------------------------------------------------------------------------------------------------------------------------------------
----------------SSSSSSSSSSSSSSSS-----------------SS-------SSSSSS--S-------SSSSSS--SSS-----SSSSSS-----------S--------------SSSSSS----------SSSSSS--SSS-----SSSSSS----------SSSSSS----------SSSSSS
----------------SSSSSS-------S----------------------------------------S---S----------SSS-SSS--S----------------------SSS-------------SSS--SS---------SSS-SSS-SS---------------------------------
-----------------SS-SS----S--S----------------K----------------------SS--SS----------SS--SSS-S---------------S-------SS--S-----------S---SS---------SSS--SSS-SS---------------------------------
--------%%%%%%%%------------------1-----oooR--@%--------------S--------------SS--------------SS--------------SSS--------------S--------------SSS-------------SSS--------------SS--------------SS
---------||||||-------------------K------------U-------------SS---K-----------o------------------------------SSS-------S---S-----------S-S-S-S---------S-S-S-S---------S---S-----------S---S-SS-
---------||||||-------------------S-----SSS----|-------------SS------------------------S---S----------SS-----SSS-------SS--S-S---------SS--S-SSS-------SS----S-S-------SSS---SSS-------SS----SSS
---------||||||--K-----------ooo---------------|--------S----SS---r---SrSS---SSS--ooSSSrSooSSSSSooSSSSSSSSoSSSSS--ooSSSSSSUSSSSSo-ooSSSrSSSSSSSS--ooSSSSSSSSSSSS--ooSSSSSSSSSSSSo-ooSSSSSSSSSSSS
------%%%%%%%%%%-------------%%%----2%%-SSSooo-|%%%%%%%%%-----%-%%%%%%%%%%%--%%-%%%%%%%%%%------%%%%%%%---------%%%%%%%%S%------%--%%%%%%%----S-%--%%%%%%S---------%%%%-SS----S----%%%%-SS------
-------||||||||---------------|------||--------|-|||||||------|--|||||||||---||--||||||||--------|||||-----K-----||||||--|-K----|---|||||-------|---||||------------||--------------||----------
-------||||||||---------------|------||-%%%%%%%|-|||||||-%%%%%%--|||||||||---||-SSS||||||-------SS||||----------SS|||||--|------SS--||||SS------SS--||||SS%---------||--SS----------||--SS------
-------||||||||---------------|------||--|||||-|-|||||||--||||---|||||||||---||----||||||---------||||------------|||||--|----------||||------------||||--|---------||--------------||----------
XXXXXXXXXXXXXXXX---------%%%%-|-%-%%%%|--|||||-|%|%%%%%|%%%%%%--%|%%%%%%%%-%%||-%-%%%%%%%%%%%---%-%%%%%-%%%%%---%-%%%%|%%%-2----%-%%%%||%%------%-%%%%%|%%|-----%-%%||-------------%||----------
XXXXXXXXXXXXXXXX----------||--|-ggg|g-|--|||||-|gg-||g-|ggggg---g|-||||||--||||-g--|||||g|||----g--|||--g|g|g---g--||-|-g-------g--||-||g|U-----g--|||-|g|U-----g-||||-------------|||----------
