------------------------------------------------------------------------------------------------------------------------------------------------------------------------------------------------
------------------------------------------------------------------------------------------------------------------------------------------------------------------------------------------------
------------------------------------------------------------------------------------------------------------------------------------------------------------------------------------------------
------------------------------------------------SSSSSSSS--------SSSSSSSSSSSSSSSS--------------------------------SSSSSSSSSSSSSSSS--------------------------------SSSSSSS-------------------------
----------------------------------------------------------------S-----------------------------o-----------------S----S-------------------------------------------------------------------------o
------------------------------------------------------------------------------------------------------------------------------------------------------------------------------------------------
--------%%%%%%%%--------------------------------------SSS------S----------------@SSSQSSS-----SSS---------------U---------------S----QQQQQ-----oS@SSS@SQ------------------------------oS---------
---------||||||--------------U------------------------------------------------------------------------------------------------------------------------------------------------------------------
---------||||||-------------------------------------------------------------------------------o--------------oo-----------------------------------------------o---------------------------------
---------||||||-----------------------------------------------------------------o---------------------------------------------------------------------------------------------------------------
------%%%%%%%%%%--TT------------------------------------------------------------#------------USS-------------@S------------------##-----------S-SSQQ---------US---------------------------------
-------||||||||---TT----TT---------------------------tt----------------tt-----K---------------------------B-------------------------------------------------------------------------------------
-------||||||||---TT----TT-------------2-------------tt----------------tt---------------------------------b----------S-------------#------------------------------------------------------#-----
-------||||||||---TT--k-TT--------kk--------k-k------tt-------g--#-----tt---kgg----kgggg--k-k-----kggggg--b---k---------------y---#k------k-------ggggy---k-k-----b----k----k-kg---kgggg-#k---k-
XXXXXXXXXXXXXXXXXXXXXXXXXXXXXXXXXXXXXXXXXXXXXXXXXXXXXXXXXXXXXXXXXXXXXXXXXXXXXXXXXXXXXXXXXXXXXXXXXXXXXXXXXXXXXXXXXXXXXXXXXXXXXXXXXXXXXXXXXXXXXXXXXXXXXXXXXXXXXXXXXXXXXXXXXXXXXXXXXXXXXXXXXXXXXXXX
XXXXXXXXXXXXXXXXXXXXXXXXXXXXXXXXXXXXXXXXXXXXXXXXXXXXXXXXXXXXXXXXXXXXXXXXXXXXXXXXXXXXXXXXXXXXXXXXXXXXXXXXXXXXXXXXXXXXXXXXXXXXXXXXXXXXXXXXXXXXXXXXXXXXXXXXXXXXXXXXXXXXXXXXXXXXXXXXXXXXXXXXXXXXXXXX
