--%-----------------------------------------------------------------------------------------------------------------------------------------------------------------------------
--|-----------------------------------------------------------------------------------------------------------------------------------------------------------------------------
--|-----------------------------------------------------------------------------------------------------------------------------------------------------------------------------
--|-----------------------------------------------------------------------------------------------------------------------------------------------------------------------------
--|-----------------------------------------------------------------------------------------------------------------------------------------------------------------------------
%-%%----------------------------------------------------------------------------------------------------------------------------------------------------------------------------
|-||---------------------------o-------------------------------@---------------o---------------@---------------------Q-@--------------------------------------------------------
|-||----oo----o----------o------------------------------------------------------------------------------------------------------------------------------------------------------
|-||---%%%%%%%------------------------------------------------------------------------------------------------------------------------------------------------------------------
|-||----|||||-@---------------------------------------------------------------------------------------------------------------------------------------------------------SS------
|-||----|||||-#------------------US-----@---------2-----------------tt------------2------------t----------------QQQ-----QQQQQ-----------S-------------------------2----SSS---Q--
|-||----|||||-#-----tt--------------tt--------------tt--------------tt--------------tt-------##t----K--TT---------------------------tt---------------------------------------#--
|-||----|||||##-----tt-----tt-------tt--------------tt--------------tt--------------tt------###--------TT------------t--------------tt-----B------------------------tt------##--
|-||----|||####-g---tt-----t--g-g---tt----g---g-K---tt--------------tt----------K---tt-----####--------TT-------g----t--K-------K---tt-----b--------------------K----------####-
|-||----XXXXXXX-XXXXXXXXXXXXXXXXXXXXXXXXXXXXXXXXXXXXXXXXXXXXXXXXXXXXXXXXXXXXXXXXXXXXXXXXXXXXXXXXXXXXXXXXXXXXXXXXXXXXXXXXXXXXXXXXXXXXXXXXXXXXXXXXXX--XXXXXXXXXXXXXXXXXXXXXXXXXXXX
|-||----XXXXXXX-XXXXXXXXXXXXXXXXXXXXXXXXXXXXXXXXXXXXXXXXXXXXXXXXXXXXXXXXXXXXXXXXXXXXXXXXXXXXXXXXXXXXXXXXXXXXXXXXXXXXXXXXXXXXXXXXXXXXXXXXXXXXXXXXX-X-XXXXXXXXXXXXXXXXXXXXXXXXXXXX
