------------------------------------------------------------------------------------------------------------------------------------------------------------------------------------------------
------------------------------------------------------------------------------------------------------------------------------------------------------------------------------------------------
------------------------------------------------------------------------------------------------------------------------------------------------------------------------------------------------
----------------SSSSSSSSSSSSSSSS----------------SS-S--------------------------------------------------------------------------------------------SSSSSSSSSS--------------------------------------
----------------S------------------------------------------------------------------------------------------------------------------------------------------------------------oo-----------------
----------------SS-------------S----------------------------------o-----------------------------------------------------------------------------------------------------------------------------
--------%%%%%%%%SSS--------SSSSS----------------------------------------------------QQoo-------o--------------------QQQ------------------------o-------------------SQQQS-S---S%%-----S----------
---------||||||---------------------------------------------------------------------------------------------------------------------------------------------------------------||----------------
---------||||||--------------------------------------------------------------------------------S-----------------------------K------------------------------------------------||-------------oo-
---------||||||-Sooo-----------o-------------------------------------------------------------------------------------------------oo-------------------------------------------||----------------
------%%%%%%%%%%SSSS-S-------SSS----------------#-----------------------------TT---------------------------------------------US---------------------------------Q-QQQ--------USS-SS----------@S-
-------||||||||-S-------------------------------------tt-----------------TT---TT-------------------------TT-------------------K----------TT-----------------------------------------------------
-------||||||||-S------TT----#------------------------tt----------B------TT---TT-------------------------TT------------------------------TT-------------------TT--------------------------S-----
-------||||||||-S------TT--g-#----gggg-g#--gk---------tt---kkkk---bgg----TT-k-TT---kgggg--k-k------k--gg-TT---k---gggggg--k-k-----kkgg---TT----------k-g------TT---ggg------------gggggk--------
XXXXXXXXXXXXXXXXXXXXXXXXXXXXXXXXXXXXXXXXXXXXXXXXXXXXXXXXXXXXXXXXXXXXXXXXXXXXXXXXXXXXXXXXXXXXXXXXXXXXXXXXXXXXXXXXXXXXXXXXXXXXXXXXXXXXXXXXXXXXXXXXXXXXXXXXXXXXXXXXXXXXXXXXXXX-XXXXXXXXXXXXXXXXXXXX
XXXXXXXXXXXXXXXXXXX-XXXXXXXXXXXXXXXXXXXXXXXXXXXXXXXXXXXXXXXXXXXXXXXXXXXXXXXXXXXXXXXXXXXXXXXXXXXXXXXXXXXXXXXXXXXXXXXXXXXXXXXXXXXXXXXXXXXXXXXXXXXXXXXXXXXXXXXXXXXXXXXXXXXXXXX-XXXXXXXXXXXXXXXXXXXX
