------------------------------------------------------------------------------------------------------------------------------------------------------------------------------------------------
---------------------------------------------------------------------------------------------------------------------------------K--------------------------------------------------------------
------------------------------------------------------------------------------------------------------------------------------------------------------------------------------------------------
--------------------------SSSS-------------------------------------------------------------------S----------------------------------------------SSSSSSSS----------------------------------------
------------------------------------------------------------------------------------------------------------------------------------------------------------------------------------------------
-------------------------------------------------------------------------------------------------------------------g--------------------------------------------o-------------------------------
--------%%%%%%%%------------------oo-----------o-------------------SQSSS-SS----S----QSo--------o------------------SQQSQQ------------S-------------------------------QQQQ--------SSSSSSQ---------
---------||||||---------------------------------------------------------------------------------------------------------------------------------------------------------------------------------
---------||||||-------------------------------o-------------------------------o--------------K--------------------------------o-----------------------------------------------------------------
---------||||||-----------------o--------------------------------------------------------------------------------------g---------o--------------------------------------------------------------
------%%%%%%%%%%---------T-----------------------------tt------------------SS@SS-------------U------------------Q#Q-S-@S-----SSS--------------------------------Q#Q----------S--SSSSU--------@S-
-------||||||||---S------TT----------------------------tt-------------------------------------K-----------B------------------------------TT---K-------------------------------------------------
-------||||||||----------TT---------------#------#-----tt-------------------------------------------------T------------------------------TT----------tt-------T---------------------------------
-------||||||||------k---TT--------k-kgg--------###----tt---kk----gggg-------------k-ggg--k-k-----y-----------k----k-ky---k-k------gggg--TT-------k---ty------bT--gk--------------ggggg---k-k---
XXXXXXXXXXXXXXXXXXXXXXXXXXXXXXXXXXXXXXXXXXXXXXXXXXXXXXXXXXXXXXXXXXXXXXXXXXXXXXXXXXXXXXXXXXXXXXXXXXXXXXXXXXXXXXXXXXXXXXXXXXXXXXXXXXXXXXXXXXXXXXXXXXXXXXXXXXXXXXXXXXXXXXXXXXXXXXXXXXXXXXXXXXXXXXXX
XXXXXXXXXXXXXXXXXXXXXXXXXXXXXXXXXXXXXXXXXXXXXXXXXXXXXXXXXXXXXXXXXXXXXXXXXXXXXXXXXXXXXXXXXXXXXXXXXXXXXXXXXXXXXXXXXXXXXXXXXXXXXXXXXXXXXXXXXXXXXXXXXXXXXXXXXXXXXXXXXXXXXXXXXXXXXXXXXXXXXXXXXXXXXXXX
