------------------------------------------------------------------------------------------------------------------------------------------------------------------------------------------------
------------------------------------------------------------------------------------------------------------------------------------------------------------------------------------------------
------------------------------------------------------------------------------------------------------------------------------------------------------------------------------------------------
---------------------------------S------------------------------------------------S-------------------------------------------------------------------------------------------------------------
--------------------------------------------------------------------------------------------------------------o---------------------------------------------------------------o-----------------
------------------------------------------------------------------------------------------------------------------------------------------------------------------------------------------------
--------%%%%%%%%-------QQSS----S--------------------QQQ--------US--SSS-------SSS--------------------QQQ------------SQS----------------------------------------------QSSSSS---S@S-------------SSS
---------||||||---------------------------------------------------------------------------------------------------------------------------------------------------------------------------------
---------||||||----------------------------------------------oo---------------------------------------------------------------o-----------------------------------------------o-----------------
---------||||||----------------------------------g--------------o------------------------------------------------g---------------oo----------------------------------------------oo-------------
------%%%%%%%%%%###--2QQ----S@S------------------2----------S@S-S------------USS-----------------Q-----------U---SQ----------SSS----------------TT---2----------QQQQQ--------US--SSSS--------US-
-------||||||||---------------------------------------------------------------------------K----------------------------------------------TT-----TT-------------------------------------K--------
-------||||||||------------------------------------------------------------------------B---------------------------------------------#---TT-----TT-----TT-----TT--------------------------------
-------||||||||----k---k-------------g------k-##--gy--gg--k-------gggggg--k-------k--k-b----k-k---ggggy-----k------k-kgg--k-k-----kggg---TT-----TT-----TT-----TT--ggk--------------y-goy--k-k-k-
XXXXXXXXXXXXXXXXXXXXXXXXXXXXXXXXXXXXXXXXXXXXXXXXXXXXXXXXXXXXXXXXXXXXXXXXXXXXXXXXXXXXXXXXXXXXXXXXXXXXXXXXXXXXXXXXXXXXXXXXXXXXXXXXXXXXXXXXXXXXXXXXXXXXXXXXXXXXXXXXXXXXXXXXXXXXXXXXXXXXXXXXXXXXXXXX
XXXXXXXXXXXXXXXXXXXXXXXXXXXXXXXXXXXXXXXXXXXXXXXXXXXXXXXXXXXXXXXXXXXXXXXXXXXXXXXXXXXXXXXXXXXXXXXXXXXXXXXXXXXXXXXXXXXXXXXXXXXXXXXXXXXXXXXXXXXXXXXXXXXXXXXXXXXXXXXXXXXXXXXXXXXXXXXXXXXXXXXXXXXXXXXX
