------------------------------------------------------------------------------------------------------------------------------------------------------------------------------------------------
------------------------------------------------------------------------------------------------------------------------------------------------------------------------------------------------
------------------------------------------------------------------------------------------------------------------------------------------------------------------------------------------------
-----------------S------------------SSSSSSSS----SSSSSSSSSS------------------------------------------------------SSSSSSS-------------------------SSSSSSSS----------------------------------------
------------------------------------------------------------------------------------------------------------------------------------------------------------------------------------------------
------------------------------------------------------------------------------------------------------------------------------------------------------------------------------------------------
--------%%%%%%%%-----------------SoSS--------------------------o--------oo----------QQSSSSS--Soo---QQQQQQo--------------------------QQQQQS----@-----------------------Qoo----------------------U
---------||||||---------------------------------------------------------------------------------------------------------------------------------------------------------------------------------
---------||||||-------------------------------SS-------------SSS--------------------------------------------------------------------------------------------------------------------------------
---------||||||-----------------------------------------------------------------oo---------------------------------------------------------------------------------g---g------------------------
------%%%%%%%%%%----------------S--SS--------------------------------------------------------U--########Q-----------------------#-##--QQQS---S------------------#-####@#Q---SSS-----------------
-------||||||||--------------------------#------------------------------------------------------#####-#-------------------------#-##----------------------------####----------------------------
-------||||||||-------------------------##------------------------------------------------------#####-----------#---------------#####---------------------------###-----------------------------
-------||||||||------g-------kkg-----g#-##--k--------------gggg-g----k------k-----gggg----------#####-y-----k---%%----------gg-g#####-k---------------------kkk-###k-------kk-----gggg--------gg
XXXXXXXXXXXXXXXXXXXXXXXXXXXXXXXXXXXXXXXXXXXXXXXXXXXXXXXXXXXXXXXXXXXXXXXXXXXXXXXXXXXXXXXXXXXXXXXXXXXXXXXXXXXXXXXXXXX--XXXXXXXXXXXXXXXXXXXXXXXXXXXXXXXXXXXXXXXXXXXXXXX-XXXXXXXXXXXXXXXXXXXXXXXXXXX
XXXXXXXXXXXXXXXXXXXXXXXXXXXXXXXXXXXXXXXXXXXXXXXXXXXXXXXXXXXXXXXXXXXXXXXXXXXXXXXXXXXXXXXXXXXXXXXXXXXXXXXXXXXXXXXXXXX--XXXXXXXXXXXXXXXXXXXXXXXXXXXXXXXXXXXXXXXXXXXXXXX-XXXXXXXXXXXXXXXXXXXXXXXXXXX
