------------------------------------------------------------------------------------------------------------------------------------------------------------------------------------------------
---------------------------------------------------------------------------------------------------------------------------------------------------------------------------------k--------------
------------------------------------------------------------------------------------------------------------------------------------------------------------------------------------------------
------------------------------------------------------------------------------------------------------------------------------------------------------------------------------------------------
------------------------------------------------------------------------------------------------------------------------------------------------------------------------------------------------
------------------------------------------------------------------------------------------------------------------------------------------------------------------------------------------------
--------%%%%%%%%-------------------------------U---------------USSSSSSSS------------QQQQ-----------------------o----------------SSSSSSSS-------S----------------SSoS@SSSSS---SSS-------oo-------
---------||||||---------------------------------------------------------------------------------------------------------------------------------------------------------------------------------
---------||||||----------------------------------------------oo-----------------------------------------------oo--------------------------------------------------------------------------------
---------||||||----------o-------------------------------------------------------------------------------------------------------oo------------o-----------------g------------------------------
------%%%%%%%%%%-------------------------------------S------S@S--------------USS------------------------------S-----S2----------SSSS----------S-----------------SSQQ---------USS-#--------------
-------||||||||------------------------------------------------------------------------------------------TT--------------TT---------------------------------------------------------------------
-------||||||||------------------------------------------------------------------------------------------TT--------------TT---------------------------tt---------------------------------TT-----
-------||||||||---%%%----------#--kggg-k----kkk----k---k--k-k-----ggggg-----k------k-gy---k-k------gggg--TT----------k-#-TT----------gg---k-k---------tt----kkk---ggggy---k--------k-kgk-TT-----
XXXXXXXXXXXXXXXX---|-X-XXXXXXXXXXXXXXXXXXXXXXXXXXXXXXXXXXXXXXXXXXXXXXXXXXXXXXXXXXXXXXXXXXXXXXXXXXXXXXXXXXXXXXXXXXXXXXXXXXXXXXXXXXXXXXXXXXXXXXXXXXXXXXXXXXXXXXXXXXXXXXXXXXXXXXXXXXXXXXXXXXXXXXXXX
XXXXXXXXXXXXXXXX---|-X-XXXXXXXXXXXXXXXXXXXXXXXXXXXXXXXXXXXXXXXXXXXXXXXXXXXXXXXXXXXXXXXXXXXXXXXXXXXXXXXXXXXXXXXXXXXXXXXXXXXXXXXXXXXXXXXXXXXXXXXXXXXXXXXXXXXXXXXXXXXXXXXXXXXXXXXXXXXXXXXXXXXXXXXXX
