------------------------------------------------------------------------------------------------------------------------------------------------------------------------------------------------
------------------------------------------------------------------------------------------------------------------------------------------------------------------------------------------------
------------------------------------------------------------------------------------------------------------------Q-----------------------------------------------------------------------------
----------------SSSSSSSSSSSSSSSS----------------------------------------------------------------------------------------------------------------------------------------------------------------
------------------------------------------------------------------------------------------------------------------------------------------------------------------------------------------------
------------------------------------------------------------------------------------------------------------------------------------------------------------------------------------------------
--------%%%%%%%%SS----------SSSS-------------------------SSS-----------USSSS-----------SSS-------------------------------------S------------------------SS-------------@S-----------------------
---------||||||-------------------------------------------S-------------------------------------------------------------------------------------------------------------------------------------
---------||||||-----------------------------------------SSSS------------------------------------------------------------------------------------------------------------------------------------
---------||||||---------------------------------------------------------S-----------------------------------------------------------------------------------------------------------------------
------%%%%%%%%%%------------------S------------------------------------SSS--------SS---SSS-------------------------------------Q------------------S-----S--------------SSS--------2-------------
-------||||||||----------------------------------K-----------------------------------------------K---------------K---------tt----K--K---------------tt-----------------------#------------------
-------||||||||----------------------------------S-----------------------------------------------------T------------tt-TT--tt--------------B--------tt----------------------##-------------B----
-------||||||||---------------------------K-----k-K---------y---K---------------g-------k---------K----T--------K-K-tt-TT--tt-----K--------b----K---tt----------g---------####--K----------b----
XXXXXXXXXXXXXXXX-XXXXXX--XXXXXXXXXXXXXXXXXXXXXXXXXXXXXXXXXXXXXXXXXX-XXXXXXXXXXXXXXXXXXXXXXXXXXXXXXXXXXXXXXXXXXXXXXXXXXXXXXXXXXXXXXXXXXXXXXXXXXXXXXXXXXXXXXXXXXXXXXXXXXXXXXXXXXXXXXXXXXXXXXXXXXX-
XXXXXXXXXXXXXXXXXXXXXXX-XXXXXXXXXXXXXXXXXXXXXXXXXXXXXXXXXXXXXXXXXXX-XXXXXXXXXXXXXXXXXXXXXXXXXXXXXXXXXXXXXXXXXXXXXXXXXXXXXXXXXXXXXXXXXXXXXXXXXXXXXXXXXXXXXXXXXXXXXXXXXXXXXXXXXXXXXXXXXXXXXXXXXXXX
