------------------------------------------------------------------------------------------------------------------------------------------------------------------------------------------------
------------------------------------------------------------------------------------------------------------------------------------------------------------------------------------------------
------------------------------------------------------------------------------------------------------------------------------------------------------------------------------------------------
------------------------------------------------------------------------------------------------------------------------------------------------------------------------------------------------
------------------------------------------------------------------------------------------------------------------------------------------------------------------------------------------------
-------------------------------------------------------------------------------------------------------------------------------U----------------------------------------------------------------
--------%%%%%%%%-------------------------------------------------------@SS---------------------------------------------@S----------------------------------------------@------------------------
---------||||||-----------o---------------------------------------------------------------------------------------------------------------------------------------------------------------------
---------||||||-------------------------------------------------------------------------------------------------------------------------------------------------------------------------SSS-----
---------||||||-----------S---------------------------------------------------------------------------------------------------------------K-----------------------------------------------------
------%%%%%%%%%%-------TT-----------------------------------------S-----QQQQQQ----2-----------#-------------------2----SSS---Q----2--------------##---------------2-----@----Q------------------
-------||||||||--------TT-----------tt-------##-----tt-----tt-----------------------tt-------##--K--K-------------------------------------------#--------------------------------K--K--------#--
-------||||||||--------TT-----------tt------###-----tt-----tt-----------------------tt------###--------TT---------------------------tt--------#-----TT--------------tt------------K--------#-#--
-------||||||||--------TT----k#-----tt-----####-g---tt-----tt---g--------g----g-K---tt-----####--------TT---g---K---------gg----K-K-tt--------#-----TT----------K---tt-----y--------------####--
XXXXXXXXXXXXXXXXXXXXXX-XXXXXXXXXXXXXXXXXXXXXXXXXXXXXXXXXXXXXXXXXXXXXXXXXXXXXXXXXXXXXXXXXXXXXXXXXXXXXXXXXXXXXXXXXXXXXXXXXXXXXXXXXXXXXXXXXXXXXXXXXXXXXXXXXXXXXXXXX-XXXXXXXXXXXXXXXXXXXXXXXXXXXXXXX
XXXXXXXXXXXXXXXXXXXXXX-XXXXXXXXXXXXXXXXXXXXXXXXXXXXXXXXXXXXXXXXXXXXXXXXXXXXXXXXXXXXXXXXXXXXXXXXXXXXXXXXXXXXXXXXXXXXXXXXXXXXXXXXXXXXXXXXXXXXXXXXXXXXXXXXXXXXXXXXX-XXXXXXXXXXXXXXXXXXXXXXXXXXXXXXX
