------------------------------------------------------------------------------------------------------------------------------------------------------------------------------------------------
------------------------------------------------------------------------------------------------------------------------------------------------------------------------------------------------
------------------------------------------------------------------------------------------------------------------------------------------------------------------------------------------------
----------------SSSSSSS----------------------------------------------SS---------SSSSSSSSSSSSS-------------------SSSSSSSSSS--------------------------------------SSSSSSSS------------------------
------------------------------------------------------------------------------------------------------------------------------------------------------------------------------------------------
------------------------------------------------------------------------------------------------------------------------------------------------------------------------------------------------
--------%%%%%%%%-----------------------ooo-----o------SSoS-----S------------------------------o---oo----o------o--------o----o--------SSQ----------------------------------------------oo-------
---------||||||---------------------------------------------------------------------------------------------------------------------------------------------------------------------------------
---------||||||-------------------------------------------------------------------------------S--------------o----------------------------------------------------------------------------------
---------||||||----------------------------------------o-------------------------------------SS-o-----------------------SSSSS----------k-----------------------------------------------g--------
------%%%%%%%%%%--------------------------------------SQQ---SQS-----------------------####-------S----------S@S------------------------SS---------#-----------------------------#-#---#QQ---SSS-
-------||||||||--------S----------------------------------------------------------###-###------------------------##-------------------------------#------------------tt---------#-#-------------
-------||||||||-T------S-------------tt------------#------------######----------#########------------------------###---------------##------------##------------------tt---------####------------
-------||||||||-T----------kgg-------tt----kk----##k--------k---######------kkk-#########--k------ok-k----k-k---####-------kkggg---##-----------###--kk----kk---#----tt----#----###--------kk---
XXXXXXXXXXXXXXXXXXXXXXXXXXXXXXXXXXXXXXXXXXXXXXXXXXXXXXXXXXXXXXXXXXXXXXXXXXXXXXXXXXXXXXXXXXXXXXXXXXXXXXXXXXXXXXXXXXXXXXXXXXXXXXXXXXXXXXXXXXXXXXXXXXXXXXXXXXXXXXXXXXXXXXXXXXXXXXXXXXXXXXXXXXXXXXXX
XXXXXXXXXXXXXXXXXXXXXXXXXXXXXXXXXXXXXXXXXXXXXXXXXXXXXXXXXXXXXXXXXXXXXXXXXXXXXXXXXXXXXXXXXXXXXXXXXXXXXXXXXXXXXXXXXXXXXXXXXXXXXXXXXXXXXXXXXXXXXXXXXXXXXXXXXXXXXXXXXXXXXXXXXXXXXXXXXXXXXXXXXXXXXXXX
