------------------------------------------------------------------------------------------------------------------------------------------------------------------------------------------------
------------------------------------------------------------------------------------------------------------------------------------------------------------------------------------------------
------------------------------------------------------------------------------------------------------------------------------------------------------------------------------------------------
----------------------------------------------------------------------------------------------------------------------------------------------------------------SSSSSSS-------------------------
-------------------------------o--------------------------------------------------------------------------------------------------------------o----------------------------------------------Uoo
--------------------------------------------------------------------------------------------------------------------------------------------------------------------------------Q---------------
--------%%%%%%%%--------------------------------------------------------------------QQQo----------------------------------------S-@SQSQS-----SSS------------------------------------QQQ---------
---------||||||---------------------------------------------------------------------------------------------------------------------------------------------------------------------------------
---------||||||------------------------------------------------------------------------------Ko-------------------------------------------------------------------------------------------------
---------||||||--------------------------------------------------o--------------------------------------------------------------------------------o---------------------------------------------
------%%%%%%%%%%-------t-------------------------------------U-------------------#-----------US----------------------------------QQQ---------USS---------------------------------------------U--
-------||||||||--#-----tt-----K--------------------------TT----------------------#-----------------------TT--------------TT----------------------------K------K----------S----------------------
-------||||||||--#-----tt------------B-------------------TT----------------------#----------------B------TT----------B---TT---------------------------------------------tt----------------------
-------||||||||--#-----tt---kk----kkkgky----kkk---kgg----TT-------ggggg---b---k--##k-kk-----k-----b---gg-TT---kT--kk-b---TT---ko---kggy---k-k------k-kok--k-k-k---b----ttt----gg--ggggy---k-k---
XXXXXXXXXXXXXXXXXXXXXXXXXXXXXXXXXXXXXXXXXXXXXXXXXXXXXXXXXXXXXXXXXXXXXXXXXXXXXXXXXXXXXXXXXXXXXXXXXXXXXXXXXXXXXXXXXXXXXXXXXXXXXXXXXXXXXXXXXXXXXXXXXXXXXXXXXXXXXXXXXXXXXXXXtXXXXXXXXXXXXXXXXXXXXXXX
XXXXXXXXXXXXXXXXXXXXXXXXXXXXXXXXXXXXXXXXXXXXXXXXXXXXXXXXXXXXXXXXXXXXXXXXXXXXXXXXXXXXXXXXXXXXXXXXXXXXXXXXXXXXXXXXXXXXXXXXXXXXXXXXXXXXXXXXXXXXXXXXXXXXXXXXXXXXXXXXXXXXXXXXXXXXXXXXXXXXXXXXXXXXXXXX
