------------------------------------------------------------------------------------------------------------------------------------------------------------------------------------------------
------------------------------------------------------------------------------------------------------------------------------------------------------------------------------------------------
------------------------------------------------------------------------------------------------------------------------------------------------------------------------------------------------
------------------------------------------------------------------------------------------------------------------------------------------------------------------------------------------------
------------------------------------------------------------------------------------------------------------------------------------------------------------------------------------------------
------------------------------------------------------------------------------------------------------------------------------------------------------------------------------------------------
--------%%%%%%%%---------------o-----------------o-------------S-------------------------------b----oSSS-------o--------------oo---o-----------oS-oSSSS------S------Q---------------------------
---------||||||-------oo-------%SS%%%%%%-------------------------------------------------------#------------------------------------------------------------------------------------------------
---------||||||----------------|---||||---------------------------------------------------------------------------------------K----------------------------------------------K------------------
---------||||||-----------oo---|---||||----------o----------------------------------------------oo-------------o------------------------------------------------------------------o-------------
------%%%%%%%%%%---------%%%---|---||||-----------------------------------#----------2-----------S-------------------------------------------U-------------------------------U------------------
-------||||||||-----------|--ooo---|oo|-------------------#---------------#----------------------------------------------o------------------------------#---------------------K---K------TT-----
-------||||||||-----------|-%%%%%%-%%%|----K---------B----#--------------##-------------TTT------------------------------#-----------------------------##--------------K-----------------TT-----
-------||||||||----r------|--||||---|-|-----------gggg---##--------k--gg###-k-----g-----TTT--g#g---k-g------k------ggg---##--------k-k------k---------###-k-k-----gggg-g----k-----yg-g---TT-----
XXXXXXXXXXXXXXXX-%%%%%%%%%%--||||-XXXXXXXXXX%X%XXXXXXXXXXXXXXXXXXXXXXXXXXXXXXXXXXXXXXXXXXXXXXXXXXXXXXXXXXXXXXXXXXXXXXXXXXXXXXXXXXXXXXXXXXXXXXXXXXXXXXXXXXXXXXXXXXXXXXXXXXXXXXXXXXXXXXXXXXXXXXXXX
XXXXXXXXXXXXXXXX--||||||||---||||-XXXXXXXXXXXXXXXXXXXXXXXXXXXXXXXXXXXXXXXXXXXXXXXXXXXXXXXXXXXXXXXXXXXXXXXXXXXXXXXXXXXXXXXXXXXXXXXXXXXXXXXXXXXXXXXXXXXXXXXXXXXXXXXXXXXXXXXXXXXXXXXXXXXXXXXXXXXXXX
