------------------------------------------------------------------------------------------------------------------------------------------------------------------------------------------------
------------------------------------------------------------------------------------------------------------------------------------------------------------------------------------------------
------------------------------------------------------------------------------------------------------------------------------------------------------------------------------------------------
------------------------------------------------------------------------------------------------SSSSSSSSSSSSSSSS----------SS---S--------------------------SS---S--------------------------------
--------------------------------------------------------------------------------------------------------------S---------------------------------------------------------------------------------
------------------------------------------------------------------------------------------------------------------------------------------------------------------------------------------------
--------%%%%%%%%---------------------------------------------------------------------------------------------------S----------SS--------------SS--------------S%--------------S%--------------S%
---------||||||---o----------------------------S----------------------------------------oooo--U-------------------------------K--------------------------------o---------------U---------------U
---------||||||-----------------------------------%%-----------------------------------%%%%----------------------------SS------S-------SS---------------SSS---SS-------SSSS----S-------SSS-----S
---------||||||------------------------r----------||---oUSS-------oo-----------Sg-g-----|QQ-----o-oo------o---SS---o-S----------------SSSSo---S-g-o-------------K--o--------------------SSS-----
------%%%%%%%%%%-#----------------%%%%%%%%%--%%---||---SSS------%%%%%%%-------2%--%-----|-------%---%-----------%%%%%%%-SSS-----%%%%%%%-%%--------%%%%--S----------@%---------------%---SS------
-------||||||||-T------------------|||||||---||---||-------------|||||---------|--|-----|-------|---|------------|||||-----------|||||--||---------||----U----------|----U----------|----U------
-------||||||||-T--------%%--------||||||%%%%||---||-------------|||||---------|--|-----|-------S---|-----------S|||||--S%%%%----|||||--|%%--------||----%%%%-------|----%%%%-------|---S-%%%---
-------||||||||-T--------||--------||||||-||-||---||------gg-----|||||---------|--|-----|-----------|------------|||||----||-----|||||--|||--------||-----||--------|-----||--------|-----K|----
XXXXXXXXXXXXXXXXX--------||-----%-%|%%%|%%%%%%|-XXXXXX--XXXXXXXX%|%%%%--%------|--|--X--|-XXXXXX%-%-|%--------X-%|%%%%%-%%||----%|%%%%--|||-----%-%||-----||--------|-----||--------|X-----|-XX-
XXXXXXXXXXXXXXXXX--------||-----g-||-|-|g|g||-|-XXXXXX--XXXXXXXXg|-||---g------|--|--X--|-XXXXXXg-|-||--------X-g|-|||--g|||----g|-||---|||-----g-|||-----||--------|-----||-XX-----|XX----|-XX-
