------------------------------------------------------------------------------------------------------------------------------------------------------------------------------------------------
------------------------------------------------------------------------------------------------------------------------------------------------------------------------------------------------
------------------------------------------------------------------------------------------------------------------------------------------------------------------------------------------------
----------------SSSSSSSS--------SSSSSSSS----------------------------------------SSSSSSSS---------------------------------------------------------S----------------------------------------------
----------------SS------------------------------------------------------------------------------------------------------------o-----------------------------------------------------------------
----------------SSS------------------------------------------------------------------------------------------------------------------------------------------------o----------------------------
--------%%%%%%%%------SS---SSSS--------------------SQS---------USSSSSSS-------SS------------------------------------QQQQQ----S@S---------------U-------------------2QQQ---------S---Q---oS-----U
---------||||||---------------------------------------------------------------------------------------------------------------------------------------------------------------------------------
---------||||||----------------------------------------------oo---------------------------------------------------------------------------------------------------------------o--------------ooo
---------||||||-------------------------------------------------oooo-------------------------------------------------------------o-----------------------------------------------g--------------
------%%%%%%%%%%---------------------------------------------@S-SSSSS--------SSS---------------------------------#QQ---------US--------------o-------------------------------US-SS----------S@S-
-------||||||||-------tt----------------------------------K-------------------------------B--------------TT-------------------------------#-----------------------------------------------------
-------||||||||-------tt-------------------------------------------------------------B----b--------------TT---TT---------------------#----#-----------------------------------------------------
-------||||||||-------tt-------g------------k-kg--gggggg--k---k----gggg---k-k-----k--b-y--b---k---k------TT---TT--ggggy---k-k-----gk-k-k--#---k-------k-------k----kogy---k-------gggggg--------
XXXXXXXXXXXXXXXXXXXXXXXXXXXXXXXXXXXXXXXXXXXXXXXXXXXXXXXXXXXXXXXXXXXXXXXXXXXXXXXXXXXXXXXXXXXXXXXXXXXXXXXXXXXXXXXXXXXXXXXXXXXXXXXXXXXXXXXXXXXXXXXXXXXXXXXXXXXXXXXXXXXXXXXXXXXXXXXXXXXXXXXXXXXXXXXX
XXXXXXXXXXXXXXXXXXXXXXXXXXXXXXXXXXXXXXXXXXXXXXXXXXXXXXXXXXXXXXXXXXXXXXXXXXXXXXXXXXXXXXXXXXXXXXXXXXXXXXXXXXXXXXXXXXXXXXXXXXXXXXXXXXXXXXXXXXXXXXXXXXXXXXXXXXXXXXXXXXXXXXXXXXXXXXXXXXXXXXXXXXXXXXXX
