------------------------------------------------------------------------------------------------------------------------------------------------------------------------------------------------
------------------------------------------------------------------------------------------------------------------------------------------------------------------------------------------------
------------------------------------------------------------------------------------------------------------------------------------------------------------------------------------------------
---------------------------------SSSSSSSSSSSSSSS---------------------------SSSS------------S---------------SS--------------------------------------------------------------S---S----------------
----------------------------------------------S--------------------------------------------S---------------S--------------------------------------------------o-----------SS--o-----------------
----------------------------------------------------------------------S-------------------------------------------------------------------------------------------------------------------------
--------%%%%%%%%---------------------------S-------------------%--------SSSSSS---------SSSSS-SSS-------SSS----SS---SS--SSSSSSSSS-------SSSS---SS-------SSSSSSSSS--SS-SSSSSSS--S%----------------
---------||||||--------#---------------------------------------|---------S--------------SSS--------------S----------------S---------------------------------------------SSS----|----------------
---------||||||----------------------------------------SSSSS---|--------SSS------------SSSS------------SSSS------------SSSS------------SSSS------------SSSS------------SSSS----|--------SSS-----
---------||||||--------#---------------------------------------|--------SSS-------------SS---------o----SSSS----------------------------SSS------------------------------------|----------------
------%%%%%%%%%%--TT---#--------SSS----------------------------|--------SSS--SSo--SS----SS-----S--SS----SS--------SS----SSS---SS--S-----------S---S-----------SQ--SSS-SSSS-----|----------------
-------||||||||---TT---#-------------------------K-------------|-----------------K---------------K---------------K---------------K---------------------------------------------|-K--------------
-------||||||||---TT-----------------------------S-------------|-------------------------------------------------------------------------------------------B-------------------|----------------
-------||||||||---TT---#----y----------------------------------|K----------g----K-K--------g------K---------------K--------g------K--------g----K----------b----K----k---------|--K-------------
XXXXXXXXXXXXXXXXXXXXXXXXXXXXXXXXX----XX---------XXXXXXXXXXXXXXXXXXXXXXXXXXXXXXXXXXXXXXXXXXXXXXXXXXXXXXXXXXXXXXXXXXXXXXXXXXXXXXXXXXXXXXXXXXXXXXXXXXXXXXXXXXXXXXXXR----XXXXXXXXXX|XXXXXXXXXXXXXXXX
XXXXXXXXXXXXXXXXXXXXXXXXXXXXXXXXX---XXX---------XXXXXXXXXXXXXXXXXXXXXXXXXXXXXXXXXXXXXXXXXXXXXXXXXXXXXXXXXXXXXXXXXXXXXXXXXXXXXXXXXXXXXXXXXXXXXXXXXXXXXXXXXXXXXXXXX----XXXXXXXXXX|XXXXXXXXXXXXXXXX
