--------------------------------------------------------------------------------------------------------------------------------------------------------------------------------
--------------------------------------------------------------------------------------------------------------------------------------------------------------------------------
--------------------------------------------------------------------------------------------------------------------------------------------------------------------------------
--------------------------------------------------------------------------------------------------------------------------------------------------------------------------------
--------------------------------------------------------------------------------------------------------------------------------------------------------------------------------
--------------------------------------------------------------------------------------------------------------------------------------------------------------------------------
-------------------------------------------------------------------------------U--------------SS---------------Q----------------------------------------------------------------
--------------------------------------------------------------------------o-----------------------------------------------------------------------------------------------------
--------------------------------------------------------------------------%-----------------------------------------------------------------------------------------------------
---------------------------------------------------g---------g------------|-----------------------------------------------------------------------------------------------------
-------------###------------------S---------------2-----2----Q--QQQ-------|--------S----------QQ--------------QQQQQ-----Q-Q------Q@--tt-QQQQ---t-----------------------SSS------
-------------##-----tt---------------------------------------#------------|---------K---------------tt-------------------------------tt--------t-------TT--tt-------tt-------#--
------------###-----tt-----B###-----------------------------##------------|------------TT--B--------tt-----t---------t---------------tt--------t----tt-TT--tt-------tt------##--
---k------######K---tt-----b###-K-------y-ggg---K----------####-----------|---g--------TT--b--k-K-K-tt-----t---------t------g-g-g----tt--------t----tt-TT--tt-g-K---tt-----y##--
XXXXXXXXXXXXXXXXXXXXXXXXXXXXXXXXXXXXXXXXXXXXXXXXXXXXXXXXXXXXXXXXXXXXXXXXXXXXXXXXXXXXXXXXXXXXXXXXXXXXXXXXXXXXXXXXXXXXXXXXXXXXXXXXXXXXXXXXXXXXXXXXXXXXXXXXXXXXXXXXXXXXXXXXXXXXXXXX
XXXXXXXXXXXXXXXXXXXXXXXXXXXXXXXXXXXXXXXXXXXXXXXXXXXXXXXXXXXXXXXXXXXXXXXXXXXXXXXXXXXXXXXXXXXXXXXXXXXXXXXXXXXXXXXXXXXXXXXXXXXXXXXXXXXXXXXXXXXXXXXXXXXXXXXXXXXXXXXXXXXXXXXXXXXXXXXX
