------------------------------------------------------------------------------------------------------------------------------------------------------------------------------------------------
------------------------------------------------------------------------------------------------------------------------------------------------------------------------------------------------
------------------------------------------------------------------------------------------------------------------------------------------------------------------------------------------------
------------------------------------------------------------------------------------------------------------------------------------------------SSSSSSSS----------------------------------------
------------------------------------------------------------------------------------------------------------------------------------------------------------------------------o-----------------
------------------------------------------------o--o--------------------------------------------------------------------------------------------------------------------------------------------
--------%%%%%%%%------------------%-----------------------------S--SSSSS-------------Qoo----------------------------QQQQo------USSSSQSS------2----------------------QQ--------@-----QS----------
---------||||||-------ooo-ooo-----|-------------------------oo----------------------------------------------------------------------------------------------------------------------------------
---------||||||-------------------|-o---------------------------------------------------------------------------------------------------------o-------------------------------o--------------oo-
---------||||||-------------------|--%--------------------oo------------------------------------------------------------------------------------------------------------------------------------
------%%%%%%%%%%------------------|--|---------------------------------------@S-------------S@S------------------------------U---S--U--------US-----------------QQQ--------SS@S--------------@S-
-------||||||||----------------o--|--|---TT--------------------------------------------------------------TT-------------------------------------------------------------------------------------
-------||||||||-------------------|--|---TT---TT---T-----------------------------------------------------B-------------------------------------------tt--B--------------------------------T-----
-------||||||||----rr-----------%%k--|-k-tT---kT---T-----------o--ggggk---k-k-kg--gggg-b----k-----kg-g-k-t---ggg---k---------------kggy---k----------tty-t----kg--gggg------------ggggg---T-k---
XXXXXXXXXXXXXXXX--%%%%%%-%%----XXXXXXXXXXXXXXXXX--XXXXXX--------XXXXXXXXXXXXXXXXXXXXXXXXXXXXXXXXXXXXXXXXXXXXXXXXXXXXXXXXXXXXXXXXXXXXXXXXXXXXXXXXXXXXXXXXXXXXXXXXXXXXXXXXXXXXXXXXXXXXXXXXXXXXXXXX
XXXXXXXXXXXXXXXX--X||||--||----XXXXXXXXXXXXXXXXX--XXXXXX--------XXXXXXXXXXXXXXXXXXXXXXXXXXXXXXXXXXXXXXXXXXXXXXXXXXXXXXXXXXXXXXXXXXXXXXXXXXXXXXXXXXXXXXXXXXXXXXXXXXXXXXXXXXXXXXXXXXXXXXXXXXXXXXXX
