------------------------------------------------------------------------------------------------------------------------------------------------------------------------------------------------
------------------------------------------------------------------------------------------------------------------------------------------------------------------------------------------------
------------------------------------------------------------------------------------------------------------------------------------------------------------------------------------------------
------------------------------------------------------------------------------------------------------------------------------------------------------------------------------------------------
------------------------------------------------------------------------------------------------------------------------------------------------------------------------------------------------
------------------------------------------------------------------------------------------------------------------------------------------------------------------------------------------------
--------%%%%%%%%-%%--------------o----SSSS-----S---------------o------------------------oo-----o--------oo-----o--------SS---------------------o-----------------------oo------o-o------o------o
---------||||||--||-----------------------------------------------------------------------------------------------------------------------------------------------------------------------------
---------||||||--||--------------------------oo-------------------------------------------------------------------------------------------------------------------------------------------------
---------||||||--||------------------------------o---------------o----------------------------------------------------------------#-------------------------------------------------------------
------%%%%%%%%%%-||-------------------------S@S------------------SSS---------U------------------------------SS-------------------##----------SS-------------------###-##Q---SSS--------------o--
-------||||||||--||-------------------------------------------------------------------------------#------------------------------##----K-------------------------###--#--------------tt---------
-------||||||||--||----------------------------------------------#--------------------------------##----------------------------###------------------------------####----------------tt---------
-------||||||||--g|----k-----ggg--ggggk-----k-----gg---g----gggg-#-----k-----g-g#-##-------k------##-----------------k-------kkg###---ok-------g--kggy-------ggg#####k-----kk--------tt-----k---
XXXXXXXXXXXXXXXXXXXXXXXXXXXXXXXXXXXXXXXXXXXXXXXXXXXXXXXXXXXXXXXXXXXXXXXXXXXXXXXXXXXXXXXXXXXXXXXXXXXXXXXXXXXXXXXXXXXXXXXXXXXXXXXXXXXXXXXXXXXXXXXXXXXXXXXXXXXXXXXXXXXXXXXXXXXXXXXXXXXXXXXXXXXXXXXX
XXXXXXXXXXXXXXXXXXXXXXXXXXXXXXXXXXXXXXXXXXXXXXXXXXXXXXXXXXXXXXXXXXXXXXXXXXXXXXXXXXXXXXXXXXXXXXXXXXXXXXXXXXXXXXXXXXXXXXXXXXXXXXXXXXXXXXXXXXXXXXXXXXXXXXXXXXXXXXXXXXXXXXXXXXXXXXXXXXXXXXXXXXXXXXXX
