--------------------------S-----------------------------------------------------------------------------------------------------------S---------------------------------------------------------
-------------------------SS-----------------------------------------------------------------------------------------------------------S---------------------------------------------------------
------------------------------------------------------------------------------------------------------------------------------------------------------------------------------------------------
------------------------------------------------SSS-----------------------------SSSSS-SSS---------------------------------------SSSSSSS---------------------------------------------------------
------------------------------------------------------------------------------o------------------------------------------------------------------------------ooo--------------------------------
-----------------------------g------------------------------------------------------------------------------------------------------------------------------------------------------------------
--------%%%%%%%%-------------S------------------------------------@QQQQQ-----S@S--------------------QQQQQ------SSSSSSS-----------------------------SQS-------SSSS--------------#----------------
---------||||||-------------SS------------------------------------------------------------------------------------------------------------------------------------------------------------------
---------||||||--------U-----S------------------------------------------------o-------------------------------------------------------------------------------o--------------oo-----------------
---------||||||--------------------------------------------------------g-----------------------------------------------------------------------------------------o---------------oo-------------
------%%%%%%%%%%---o-----------S-S-----------SSS-------tt--------#Q-Q--S-----USS--------------------------------------------S@SS------------------Q----------US-SSQ----------@S-----------------
-------||||||||----------------S-----------------------tt-------------------------------------------------------------------------------------------------------------------------------------K-
-------||||||||----------------------------------------tt-------------------------B------B----TT-------------------------------------tt--------------------------------------------------TT-----
-------||||||||-------S---------------------k-----y----tt---kggg---k-ky---k-------b------b----TT--gk--gg--k-k-----ggggg--------------tt-----kkk---ggggy---k-------gggg------------gg-gok-TT-k-k-
XXXXXXXXXXXXXXXX-XXXXXXXSSS-----XXXXXXXXXXXXXXXXXXXXXXXXXXXXXXXXXXXXXXXXXXX-XXXXXXXXXXXXXXXXXXXXXXXXXXXXXXXXXXXXXXXXXXXXXXXXXXXXXXXXXXXXXXXXXXXXXXXXXXXXXXXXXXXXXXXXXXXXXXXXXXXXXXXXXXXXXXXXXXXX
XXXXXXXXXXXXXXXX-XXXXXXg--------XXXXXXXXXXXXXXXXXXXXXXXXXXXXXXXXXXXXXXXXXXX-XXXXXXXXXXXXXXXXXXXXXXXXXXXXXXXXXXXXXXXXXXXXXXXXXXXXXXXXXXXXXXXXXXXXXXXXXXXXXXXXXXXXXXXXXXXXXXXXXXXXXXXXXXXXXXXXXXXX
