-----------------------K------------------------------------------------------------------------------------------------------------------------------------------------------------------------
-----------------------o---------------------------------------------------------K-----------------------------------------------K--------------------------------------------------------------
----------------------%%%-----------------------------------------------------------------------------------------------------------------------------------------------------------------------
-----------------------|-------oSSSSSSSSSSSSSS--SSSS------------SSSS----------------------------SSSSSS------------------------------------------SSSSSSSSSS--------------------------------------
-----------------------|-------%---------------------------------------------------------------------------------------------------------------------------------------------U-o----------------
-----------------------|-------|-----------------o-----------------------------------------------------------------o--------------------------------------------o-------------------------------
--------%%%%%%%%-------|-------|-------------o---------------------So----------o----QQo---------------------------SQQQQQ--------SSSSSSSS-----SSS--------------------QQQ------------------------U
---------||||||--------|-------|----------------------------------------------------------------------------------------------------------------------------------------------------------------
---------||||||--------|---%---|---------------S-----------------------------K---------------K--------------------------------o--------------------------------------------------------------oo-
---------||||||--------|---|---|o-----------------------------------------------------------------------------------------------ooooo--------------------------------------------o--------------
------%%%%%%%%%%%%-----|---|---|----SS---------------------------##--------------------------U------------------Q#QQ---Q-----USSS--SS--------USS-----------------------------US--------------@S-
-------||||||||-||-----|---|---|--------------K------------------##-----------------------K----------------------------------------------------------------------------------------K-----TT-----
-------||||||||-||-----|---|---|---------TT------------#------TT-##-----------------------#----------tt----------------------------------TT----------------------------------------------TT-----
-------||||||||-||-----|---|---|-----ggk-TT-k-----k----#----k-TT-##k-kgg--k-k-----gy-gg---#-k--------tt----kkkk----k------k--------gggg--TT----------g--------y---ggggy-----k-----gggg---TT---kg
XXXXXXXXXXXXXXXX||-----|%%%%%%%%XXXXXXXXXXXXXXXXXXXXXXXXXXXXXXXXXXXXXXXXXXXXXXXXXXXXXXXXXXXXXXXXXXXXXXXXXXXXXXXXXXXXXXXXXXXXXXXXXXXXXXXXXXXXXXXXXXXXXXXXXXXXXXXXXXXXXXXXXXXXXXXXXXXXXXXXXXXXXXXX
XXXXXXXXXXXXXXXX||-----|-||||||-XXXXXXXXXXXXXXXXXXXXXXXXXXXXXXXXXXXXXXXXXXXXXXXXXXXXXXXXXXXXXXXXXXXXXXXXXXXXXXXXXXXXXXXXXXX-XXXXXXXXXXXXXXXXXXXXXXXXXXXXXXXXXXXXXXXXXXXXXXXXXXXXXXXXXXXXXXXXXXXX
