------------------------------------------------------------------------------------------------------------------------------------------------------------------------------------------------
------------------------------------------------------------------------------------------------------------------------------------------------------------------------------------------------
------------------------------------------------------------------------------------------------------------------------------------------------------------------------------------------------
------------------------------------------------------------------------------------------------SSSSSSSSS--------------------------------------------SS-----------------------------------------
------------------------------------------------------------------------------------------------------------------------------------------------------------------------------------------------
------------------------------------------------------------------------------------------------------------------------------------------------------------------------------------------------
--------%%%%%%%%-------SSSS---S----------------U---------------U---S@Soo-------------------------oo---------------oo-----------S-SSSQQQQ--------ooo-----oo-------------------------UQSSSSS---S@S
---------||||||---oo--oo------------------------------------------------------------------------------------------------------------------------------------------------------------------------
---------||||||------------------------------ooo-------------oS--------------K--------------------------------SS-----------------------------oo-----------------------------------------------o-
---------||||||---------------------------------------------------------------------------------o------------------------------------------------o----------------------------------------------
------%%%%%%%%%%-----------S-------SSS------S@S------------------------------U---------------------------------------------------#----------S@S---------------------------------QQQQQ-------S@S-
-------||||||||--------------------------TT-------------------------------------------------------------------------------#--------------------------#--------------------B---------------------
-------||||||||--------------------------TT----------------------------------------------##-----------------------------###--------------------------#---##---------------b---------------------
-------||||||||--------------------k-k---TT-------kggggg----k-k----k-g----k-k------gggg-###------------g----k-k----kgggg###--------k-ky---k-k--------#---##-------kk---g--y-k-k---ggggy---------
XXXXXXXXXXXXXXXX-%%%--XXXXX--XXXXXXXXXXXXXXXXXXXXXXXXXXXXXXXXXXXXXXXXXXXXXXXXXXXXXXXXXXXXXXXXXXXXXXXXXXXXXXXXXXXXXXXXXXXXXXXXXXXXXXXXXXXXXXXXXXXXXXXXXXXXXXXXXXXXXXXXXXXXXXXXXXXXXXXXXXXXXXXXXXX
XXXXXXXXXXXXXXXX--|X--XXXXX--XXXXXXXXXXXXXXXXXXXXXXXXXXXXXXXXXXXXXXXXXXXXXXXXXXXXXXXXXXXXXXXXXXXXXXXXXXXXXXXXXXXXXXXXXXXXXXXXXXXXXXXXXXXXXXXXXXXXXXXXXXXXXXXXXXXXXXXXXXXXXXXXXXXXXXXXXXXXXXXXXXX
