------------------------------------------------------------------------------------------------------------------------------------------------------------------------------------------------
------------------------------------------------------------------------------------------------------------------------------------------------------------------------------------------------
---------------------------------------------------------------------------2----------------------------------------------------------------------U-Q-------------------------------------------
-----------------------SS-----------------------------------------------------------------------------------------------------------------------------------------------------------------------
-----------------------------------------------------------------------------------------------------------------------------------------------------------------g------------------------------
------------------------------------------------------------------------------K--------------------------------U----------------------------------------------K---##----------------------------
--------%%%%%%%%------------------------S-------------------------------------@%-----Q-@SS------------S@S--------------USS-----%-------@-----------Q-------------------------------------------U
---------||||||----------------------------------------------------------------|-----------------------------------------------|----------------------------------------------------------------
---------||||||------#--------------------------------------------------SSS----|-----------------------------------------------|----------------------------------------------------------------
---------||||||-----##-----------------------2----------SSSS-------------------|-----------------------------------------------|--------------------------------------------------g-------------
------%%%%%%%%%%---#-#------------SS---------##---------------#----S-----------|--2----SS-----Q---2----SSS---Q-----------SS-Q--|--2----SS----QQ----S--------------S----SSS-----QQ-@-----@Q---Q--
-------||||||||----#-#---TT-----------------###--------------##--K--K----------|-----------------------------------------------|----tt-----------K--K-------------------------------------------
-------||||||||--#-#-#---TT---------------#####---------T---###----------------|--------------------tt-------------------------|----tt-----------------TT-----------tt-----B--------------------
-------||||||||--#-###---TT---------------######--------T--####-------------y--|K------------##-K----------#-#----------U------|K---tt-----y-#k--------TT---K---K---tt--y--b----g---------------
XXXXXXXXXXXXXXXXXXXXXXXXXXXXXXXXXXXXXXXXXXXXXXXXXXXXXXXXXXXXXXX-XXXXXXXXXXXXXXXXXXXXXXXXXXXXXXXXXXXXXXXXXXXXXXXXXXX-XXXXXXXXXXXXXXXXXXXXXXXXXXXXXXXXXXXXXXXXXXXXXXXXXXXXXXXXXXXXXXXXXXXXXXXXXXXX
XXXXXXXXXXXXXXXXXXXXXXXXXXXXXXXXXXXXXXXXXXXXXXXXXXXXXXXXXXXXXXX-XXXXXXXXXXXXXXXXXXXXXXXXXXXXXXXXXXXXXXXXXXXXXXXXXXX-XXXXXXXXXXXXXXXXXXXXXXXXXXXXXXXXXXXXXXXXXXXXXXXXXXXXXXXXXXXXXXXXXXXXXXXXXXXX
