------------------------------------------------------------------------------------------------------------------------------------------------------------------------------------------------
------------------------------------------------------------------------------------------------------------------------------------------------------------------------------------------------
------------------------------------------------------------------------------------------------------------------------------------------------------------------------------------------------
-------------------------------------------------------------------------------------------------------------------------------------------S----------------------------------------------------
------------------------------------------------------------------------------------------------------------------------------------------------------------------------------------------------
---------------------------------------------------------------------------------------------------------------U--------------------------------------------------------------------------------
--------%%%%%%%%-------S--------------------------------------------------------------SSSS---------------------S----------------------------------------S-------------SSSS--------------S-------
---------||||||----------------y---------------------------------------------------------------------------------------------------------------------------------------------------------S------
---------||||||--------SS------------------------------------------------------------------------------SS------------------------------SSSS--------------------------------------------SSS------
---------||||||--------------------------SSo----------------------------SS------------------------------SSS------------------------o------------------------------------------------------------
------%%%%%%%%%%-----%%SSS---#------------------------------------------S---------SS---SU--------------SSSS--SS-------------------SS-------------------SSS--------S----SSS---Q------------------
-------||||||||------||----###-----------------------------------------------#-----------------------------------K--K--TT--------K-----------------------------------------------K--------------
-------||||||||------||-S--###----------------------------------------------###-------------##-------------------------TT---------------------------tt----------------------##-------------B----
-------||||||||------||---####------------kk-----------------k--K-------y--####---------g---##--------------------K----TT-------k-K----------#--K---------------K-----------##--K-K--------b----
XXXXXXXXXXXXXXXX-----||---XX----XXXXXXXXXXXXXXXXX-------X--XXXXXRXX--XXXXXXXXXX-XXXXXXXXXXXXXXXXXXXXXXXXXXXXXXXXXXXXXXXXXXXXXXXXXXXXXXXXXXXXXXXXXXXX-XXXXXXXXXX-XXXXXXXXXXXXXXXXXXXXXXXXXXXXXXX-
XXXXXXXXXXXXXXXX-----||---------XXXXXXXXXXXXXXXXX---------XXXXXXXXX--XXXXXXXXXX-XXXXXXXXXXXXXXXXXXXXXXXXXXXXXXXXXXXXXXXXXXXXXXXXXXXXXXXXXXXXXXXXXXXXXXXXXXXXXXX-XXXXXXXXXXXXXXXXXXXXXXXXXXXXXXX-
