------------------------------------------------------------------------------------------------------------------------------------------------------------------------------------------------
------------------------------------------------------------------------------------------------------------------------------------------------------------------------------------------------
------------------------------------------------------------------------------------------------------------------------------------------------------------------------------------------------
--------------------------------SSSSSSSSSSS---------------------------------------------------------------------SSSSSSSSSSSSSSS---------------------------------SSSSSSSS------------------------
----------------------------------------------------------------------------------------------------------------------------------------------o-----------------------------------------------oo
------------------------------------------------------------------------------------------------------------------------------------------------------------------------------------------------
--------%%%%%%%%--------------------------------------------------------------------QQQQQ-----------Q----------U--------------------Q------------SSoSS--o-----So---------------o----QQQQ--------
---------||||||---------------------------------------------------------------------------------------------------------------------------------------------------------------------------------
---------||||||-----------------------------------------------------------------------------------------------o------------------------------Ko-------------------------------------------------
---------||||||---------------------------------------------------------------------------------------------------------------------------------oooo--------------------------------------------
------%%%%%%%%%%###--###-----U-----------------------------------------------U---------------US--------------US------------------------------US-SSSS---------SS---------------------------------
-------||||||||-###------------------tt----##-----------------------------#------------K-----------------------------S----------------------------------------------------#---------------------
-------||||||||-###------------------tt---##----TT-----#---------------B---------------------------------------------S----------------------------------------------------#---------------------
-------||||||||-###k------k-k--------tt---##k---TT----kk---kkkk--gkkg--b-----ggg---k--gk----k------kgggg--k-----------------k------ggggg-----------k-gg---k-k--------k-k-##-------gggggg----k-k-
XXXXXXXXXXXXXXXXXXXXXXXXXXXXXXXXXXXXXXXXXXXXXXXXXXXXXXXXXXXXXXXXXXXXXXXXXXXXXXXXXXXXXXXXXXXXXXXXXXXXXXXXXXXXXXXXXXXXXXXXXXXXXXXXXXXXXXXXXXXXXXXXXXXXXXXXXXXXXXXXXXXXXXXXXXXXXXXXXXXXXXXXXXXXXXXX
XXXXXXXXXXXXXXXXXXXXXXXXXXXXXXXXXXXXXXXXXXXXXXXXXXXXXXXXXXXXXXXXXXXXXXXXXXXXXXXXXXXXXXXXXXXXXXXXXXXXXXXXXXXXXXXXXXXXXXXXXXXXXXXXXXXXXXXXXXXXXXXXXXXXXXXXXXXXXXXXXXXXXXXXXXXXXXXXXXXXXXXXXXXXXXXX
