------------------------------------------------------------------------------------------------------------------------------------------------------------------------------------------------
------------------------------------------------------------------------------------------------------------------------------------------------------------------------------------------------
------------------------------------------------------------------------------------------------------------------------------------------------------------------------------------------------
--------------------------------SSSSSSS------------------------------------------------------------------------------------------------------------------------------------------S--------------
------------------------------------------------------------------------------------------------------------------------------------------------------------------------------------------------
------------------------------------------------------------------------------------------------------------------------------------------------------------------------------------------------
--------%%%%%%%%----QQQQQ----------------------S------oo------------QQQ----------------SSS-------------ooo-----oS---Q-SSoS-----o-------ooo-----o---o----oo-----o-----QSQQS--------------So------
---------||||||-------------------------------------------------------------------%%%-----------------------------------------------------------------------------------------------------------
---------||||||--------------------------------------------------------------o-----|-----------------------------------------oo-----------------------------------------------------------------
---------||||||--------------------------------------------------------------------|-----------------------------------------------------------------------------------g------------------------
------%%%%%%%%%%-##-QS@SQ----Q-----------------------------------------------@-----|--------------####Q-Q--------------------@S--##--------------##----------U----##-SQQQ---SSS-----------------
-------||||||||--#--------------------tt-------------------------------------------|tt-----------####----------------------------##------------------------------###----------------------------
-------||||||||--#--------------------tt--------------tt---------------------------|tt----------#####----------------------------##-----------------------------####----------------------------
-------||||||||--#-k--gg--------#-----tt---k-g-g------tt----k------kgggg--k-k-k----|tt-----#---######k-----kk-----gk-g------k---###---kk---kk------k-k------k---####--k--------------g----------
XXXXXXXXXXXXXXXXXXXXXXXXXXXXXXXXXXXXXXXXXXXXXXXXXXXXXXXXXXXXXXXXXXXXXXXXXXXXXXXXXXXXXXXXXXXXX--XXXXXXXXXXXXXXXXXXXXXXXXXXXXXXXXXXXXXXXXXXXXXXXXXXXXXXXXXXXXXXXXXXXXXXXXXXXXXXXXXXXXXXXXXXXXXXXXX
XXXXXXXXXXXXXXXXXXXXXXXXXXXXXXXXXXXXXXXXXXXXXXXXXXXXXXXXXXXXXXXXXXXXXXXXXXXXXXXXXXXXXXXXXXXXX-XXXXXXXXXXXXXXXXXXXXXXXXXXXXXXXXXXXXXXXXXXXXXXXXXXXXXXXXXXXXXXXXXXXXXXXXXXXXXXXXXXXXXXXXXXXXXXXXXX
