----------------------------------------------S-------------------------------------------------------------------------------------------------------------------------------------------------
------------------------------------------------------------------------------------------------------------------------------------------------------------------------------------------------
------------------------------------------------------------------------------------------------------------------------------------------------------------------------------------------------
-------------------------------------------------SSSSSS-----------------------------------------------------------------------------------------------------------------------------------------
------------------------------------------------------------------------------------------------------------------------------------------------------------------------------------------------
------------------------------------------------------------------------------------------------------------------------------------------------------------------------------------------------
--------%%%%%%%%---------------oSSSSSSSSSSSSSSSS--------------------QQQQQ------o-oo---SSSSS---SS-------oo----o-----------------------QQQoS-----o---------------------QQQQo---------------------o
---------||||||---------------------------------------------------------------------------------------------------------------------------------------------------------------------------------
---------||||||---------------S-----------------------------------------------------------------------------------------------------------------------------------------------------------------
---------||||||--------------------o--------------------------------------------ooo----------------------------------------------------g--------------------------------------------------------
------%%%%%%%%%%----------------S--SSSSS-----SSS----------------#####--------U--------------SSSo######Q#Q---SSS-------------------#--S@QQS--SSS-----------------######QQQ---SQS--------------U--
-------||||||||--------------------------------------------------###----------------------------####------------------tt---------------------------------TT-----####-------------------------#--
-------||||||||--------------------------------------------------##-----------------------------####------------------tt----------##---------------------TT-----###--------------------------#--
-------||||||||---kkggg-----k-k------gy-----------k----------gkg-##k--gg----kkkg--gggy---------g###k--------k---------tt-----ggg--#k--------k-----gggg---TT---y-###---------k-----gy---k----##--
XXXXXXXXXXXXXXXXXXXXXXXXXXXXXXXXXXXXXXXXXXXXXXXXXXXXXXXXXXXXXXXXXXXXXXXXXXXXXXXXXXXXXXXXXXXXXXXXXXXX-XXXXXXXXXXXXXXXXXXXXXXXXXXX-XXX-XXXXXXXXXXXXXXXXXXXXXXXXXXXXXXXXXXXXXXXXXXXXXXXXXXXXXXXXXXX
XXXXXXXXXXXXXXXXXXXXXXXXXXXXXXXXXXXXXXXXXXXXXXXXXXXXXXXXXXXXXXXXXXXXXXXXXXXXXXXXXXXXXXXXXXXXXXXXXXXX-XXXXXXXXXXXXXXXXXXXXXXXXXXX-XXX-XXXXXXXXXXXXXXXXXXXXXXXXXXXXXXX-XXXXXXXXXXXXXXXXXXXXXXXXXXX
