------------------------------------------------------------------------------------------------------------------------------------------------------------------------------------------------
------------------------------------------------------------------------------------------------------------------------------------------------------------------------------------------------
------------------------------------------------------------------------------------------------------------------------------------------------------------------------------------------------
------------------------------------------------------------------------------------------------------------------------------------------------SSSSSSS-----------------------------------------
------------------------------------------------------------------------------------------------------------------------------------------------------------------------------------------------
------------------------------------------------------------------------------------------------------------------------------------------------------------------------------------------------
--------%%%%%%%%%------------------------------o-----------------------------------------------U--------------------QQQQ-----------------------U--------------------QQQ---------S@S@SSQ------U--
---------||||||-|--------------#----------------------------------------------------------------------------------------------------------------------------------------------------------------
---------||||||-|-------------##---------------------------------------------o-----------------------------------------------oo--------------oK-------------------------------o---------------o-
---------||||||-|------------###------------------------------------------------oo-----------------------------------------------------------------------------------------------g--------------
------%%%%%%%%%%|------------###---------------------------------------------@S----------------------------------------------@S--------------@S------------------------------US-SSQ-SSSS-----USS
-------||||||||-|------------###---------------------------------------tt------------------------------tt---------------------------------K-----------------------------------------------------
-------||||||||-|----------#####------------------------------TT-------tt------------------------------tt-----TT---------------------------------------tt---------------------------------------
-------||||||||-|------g---#####---------------g--gg---k----k-TT--gggg-tt---kkkg--ggg-----k----g-gy----tt---k-TT--ggggy---k-------ggggg---k---k--------tt---k-k----k-ky---k-k------k-ky---k-k---
XXXXXXXXXXXXXXXX%%%XXXXXXXXXXXXXXXXXXXXXXXXXXXXXXXXXXXXXXXXXXXXXXXXXXXXXXXXXXXXXXXXXXXXXXXXXXXXXXXXXXXXXXXXXXXXXXXXXXXXXXXXXXXXXXXXXXXXXXXXXXXXXXXXXXXXXXXXXXXXXXXXXXXXXXXXXXXXXXXXXXXXXXXXXXXXX
XXXXXXXXXXXXXXXXX|--XXXXXXXXXXXoXXXXXXXXXXXXXXXXXXXXXXXXXXXXXXXXXXXXXXXXXXXXXXXXXXXXXXXXXXXXXXXXXXXXXXXXXXXXXXXXXXXXXXXXXXXXXXXXXXXXXXXXXXXXXXXXXXXXXXXXXXXXXXXXXXXXXXXXXXXXXXXXXXXXXXXXXXXXXXXX
