------------------------------------------------------------------------------------------------------------------------------------------------------------------------------------------------
------------------------------------------------------------------------------------------------------------------------------------------------------------------------------------------------
------------------------------------------------------------------------------------------------------------------------------------------------------------------------------------------------
-----------------SSS---o------------------------------------------------------------------------------------------------------------------------SSSSSSSSSSS----S--------------------------------
------------------------------------------------------------------------------oo----------------------------------------------------------------------------------------------------------------
------------------------------------------------------------------------------------------------------------------------------------------------------------------------------------------------
--------%%%%%%%%----------------------------------------------------Q-----------------------------------------------Q----------oS--S@SSS-SS--S@S---------------------------------2-UQQQQoS---U--
---------||||||--------o---o--------------------------------------------------------------------------------------------------------------------------------------------------------------------
---------||||||-------%%%-%%%----------------------------------------------------------------------------------------------------------------oo-----------------------------------------------o-
---------||||||--------|---|--------------------------------------------------------------------------------------------------------------------------------------------------------------------
------%%%%%%%%%%-------|---|-----------------o-------------------------------US-------------------------------------------------------------S@S----------------------------------QQ----S-----US-
-------||||||||--------|---|-------------TT---------------K-------------------------------#-----------------------------###----------------------------------------------TT---------------------
-------||||||||--------|---|-------------TT---------------b-------------------------------#-------------------TT-------####----------------------------#-----------------TT---------------------
-------||||||||--------#---o------kkgggg-TT---k--gyggg-b--k--ggg--gggggg----k-kk--gg-ggg-##-------k----k--k---TT--gg---####-k-----ggggy---k-------b----#-----g-g--k------TT---ko--gk--k---k-k---
XXXXXXXXXXXXXXXXXXXXXXXXXXXXX-XXXXXXXXXXXXXXXXXXXXXXXXXXXXXXXXXXXXXXXXXXXXXXXXXXXXXXXXXXXXXXXXXXXXXXXXXXXXXXXXXXXXXXXXXXXXXXXXXXXXXXXXXXXXXXXXXXXXXXXXXXXXXXXXXXXXXXXXXXXXXXXXXXXXXXXXXXXXXXXXXX
XXXXXXXXXXXXXXXXX-XXXXXXXXXX-XXXXXXXXXXXXXXXXXXXXXXXXXXXXXXXXXXXXXXXXXXXXXXXXXXXXXXXXXXXXXXXXXXXXXXXXXXXXXXXXXXXXXXXXXXXXXXXXXXXXXXXXXXXXXXXXXXXXXXXXXXXXXXXXXXXXXXXXXXXXXXXXXXXXXXXXXXXXXXXXXXX
