------------------------------------------------------------------------------------------------------------------------------------------------------------------------------------------------
------------------------------------------------------------------------------------------------------------------------------------------------------------------------------------------------
------------------------------------------------------------------------------------------------------------------------------------------------------------------------------------------------
--------------------------------------------------------------------------------------------------------------------------------------------------SSSSSSSS--------------------------------------
------------------------------------------------------------------------------------------------------------------------------------------------------------------------------------------------
------------------------------------------------------------------------------------------------------------------------------------------------------------------------------------------------
--------%%%%%%%%SSSSQSSSSSSSSSSS-ooo---oo------------------------SSoSSS--------SSSSSSSSS-----SSS--------------------QQQQQS-------------------------------------S----QS---------USSSS@SSSSSS--SSS
---------||||||---------------------------------------------------------------------------------------------------------------------------------------------------------------------------------
---------||||||-----------------------------------------------S---------------------------------------------------------------o----------------------------------------------oo-----------------
---------||||||-------------------------------------------------o--------------ooooo-------------------------------------------------------------oo--------------o---------------------o--------
------%%%%%%%%%%#---QS-S-----SSS---------------------------------------------SSSSSSSS--------SSS-----------------#Q----------US----------------------------------2----------S@S-SSQS----S---S@SS
-------||||||||---------------------------B---------------------------------------------------------------B-----------------------------------K---K-------#-------------------------------------
-------||||||||----------------------t----b---------------------------------------------------------------b----------------------------------------------T#-------------------------------------
-------||||||||----k--g-----k------kggyg--b-k-k----kgg------kkk----k-g----k--------ygg----k-k------k-ggg--k---k----k-ky------------k-k------kkk---k-----#T#-------gggggg--k---k---ggggy---k-----
XXXXXXXXXXXXXXXXXXXXXXXXXXXXXXXXXXXXXXXXXXXXXXXXXXXXXXXXXXXXXXXXXXXXXXXXXXXXXXXXXXXXXXXXXXXXXXXXXXXXXXXXXXXXXXXXXXXXXXXXXXXXXXXXXXXXXXXXXXXXXXXXXXXXXXXXXXXXXXXXXXXXXXXXXXXXXXXXXXXXXXXXXXXXXXXX
XXXXXXXXXXXXXXXXXXXXXXXXXXXXXXXXXXXXXXXXXXXXXXXXXXXXXXXXXXXXXXXXXXXXXXXXXXXXXXXXXXXXXXXXXXXXXXXXXXXXXXXXXXXXXXXXXXXXXXXXXXXXXXXXXXXXXXXXXXXXXXXXXXXXXXXXXXXXXXXXXXXXXXXXXXXXXXXXXXXXXXXXXXXXXXXX
