------------------------------------------------------------------------------------------------------------------------------------------------------------------------------------------------
------------------------------------------------------------------------------------------------------------------------------------------------------------------------------------------------
------------------------------------------------------------------------------------------------------------------------------------------------------------------------------------------------
----------------------------------------------------------------SSSSSSSS----------------------------------------SSSSSSS-----------------------------------------SSSSSSSSSS-----S----------------
--------------------------------------------------------------o-------------------------------------------------------------------------------------------------SS------------------------------
----------------------------------------------------------------------------------------------------------------------------------------------------------------SS------------------------------
--------%%%%%%%%--------SS-------------------------SQS-------SS--------------------SQSS------------------------o---------------U-------------------SQS--QS---S@S--------------So----------------
---------||||||---------------------------------------------------------------------------------------------------------------------------------------------------------------------------------
---------||||||----------------------------------------------Ko----------------------------------------------oK-----------------------------------------------o---------------------------------
---------||||||---------------------------------------------------------------------------------o-o----------------------------------------------g----------------------------------------------
------%%%%%%%%%%-------------S----------------------U--------US-----------------QQQQ-----------S-------------US----------------------------------#Q----------US---------------------------------
-------||||||||-----------------------tt-----------------------------------------------------------K-----TT---------------#-------------------TT------------------------------------------#-----
-------||||||||-----------------------tt-----------------------------tt----------------------------------TT----------B------------------------TT------------------------------------------#-----
-------||||||||----------------ky-----tt----kkkg---kgggg--k-k--------tt-----kk------g-k-k---------gggggg-TT---k--okk-b-k-------g--gggggg#---k-TT--ggggy---k-------k----k----kgkg-----k----k---kg
XXXXXXXXXXXXXXXXXXXX-XXXXXXXXXXXXXXXXXXXXXXXXXXXXXXXXXXXXXXXXXXXXXXXXXXXXXXXXXXXXXXXXXXXXXX-XXXXXXXXXXXXXXXXXXXXXXXXXXXXXXXXXXXXXXXXXXXXXXXXXXXXXXXXXXXXXXXXXXXXXXXXXXXXXXXXXXXX-XXXXXXXXXXXXXXX
XXXXXXXXXXXXXXXXXXXX--XXXXXXXXXXXXXXXXXXXXXXXXXXXXXXXXXXXXXXXXXXXXXXXXXXXXXXXXXXXXXXXXXXXXX-XXXXXXXXXXXXXXXXXXXXXXXXXXXXXXXXXXXXXXXXXXXXXXXXXXXXXXXXXXXXXXXXXXXXXXXXXXXXXXXXXXXXXXXXXXXXXXXXXXXX
