------------------------------------------------------------------------------------------------------------------------------------------------------------------------------------------------
------------------------------------------------------------------------------------------------------------------------------------------------------------------------------------------------
------------------------------------------------------------------------------------------------------------------------------------------------------------------------------------------------
------------------------------------------------SSSSSSSS---------------------------------------------------------S----------------------------------------------SSSSSSSSSS----------------------
------------------------------------------------------------------------------oo---------------------------------------------------------------------------------------------------------------o
-------------------------------o------------------------------------------------------------------------------------------------Q---------------------------------------------------------------
--------%%%%%%%%SSSSSSSSSSS--SSS-----------------------------------SQQQ-------------Q-----------ooooSSS------SSo--------------------QQQS-S---SSS------------------------------------QQ--------o-
---------||||||---------------------------------------------------------------------------------------------------------------------------------------------------------------------------------
---------||||||------------------------------oo-------------------------------o------------------------------ooo------------------------------o-------------------------------------------------
---------||||||-oooo-------------------------------------------------------------o--------------oo-----------------------------------------------o----------------------------------------------
------%%%%%%%%%%SSSSSSSS----SSSS-------------@S------------------------------US--S-----------US--------------US------------------QQQ---------US--------------oS---------------------------------
-------||||||||-------------------------------------------------------------------------------------------T----------------------------------------------TT------------t-----------------##-----
-------||||||||--------------------------------------t---------------------------------------------------TT-------B------B----B--------------------------TT------------t----------------###-----
-------||||||||----k-ggg--k-k-----kkgggg----k-k------ttt------kg--gggggg--k-k-----gggggg--k-k------kgggg-#T-----kkt----k-b----gg---k--k-----k-----gggggg-TT---k---b----t----kkkg--gggggg###-----
XXXXXXXXXXXXXXXXXXXXXXXXXXXXXXXXXXXXXXXXXXXXXXXXXXXXXXXXXXXXXXXXXXXXXXXXXXXXXXXXXXXXXXXXXXXXXXXXXXXXXXXXXXXXXXXXXXXXXXXXXXXXXXXXXXXXXXXXXXX-XXXXXXXXXXXXXXXXXXXXXXXXXXXXXXXXXXXXXXXXXXXXXXXXXXXX
XXXXXXXXXXXXXXXXXXXXXXXXXXXXXXXXXXXXXXXXXXXXXXXXXXXXXXXXXXXXXXXXXXXXXXXXXXXXXXXXXXXXXXXXXXXXXXXXXXXXXXXXXXXXXXXXXXXXXXXXXXXXXXXXXXXXXXXXXXX-XXXXXXXXXXXXXXXXXXXXXXXXXXXXXXXXXXXXXXXXXXXXXXXXXXXX
