------------------------------------------------------------------------------------------------------------------------------------------------------------------------------------------------
---------------------------------------------------K--------------------------------------------------------------------------------------------------------------------------------------------
--------------------------------------------------------------------------------tt----------------------------------------------t-------------------------------t-------------------------------
--------------------------------------------------------------------------------tt----------------------------------------------t-----------------#-------------t-------------------------------
-------------------------------------------------------------------g------------tt----------------------------------------------t----------------##k##----------t-------------------------------
----------------------------------------------------------------%%%%------------tt----------------------------------------------t-------------------------------t-------------------------------
--------%%%%%%%%---------------Q---------------------------------||---U------------------------o--------------------------------SS------------------------------SS-----------------------------o
---------||||||-------------------------o-----------------o-----%||------------------#--------------------------------------------------------------------o-------------------------------------
---------||||||-------------------------S-----------------------|||-----------------------------------------------------------------------------------------------------------------------------
---------||||||-------------------------SS----------------------|||-----------------------------------------------------------------------------------------------------------------------------
------%%%%%%%%%%--2-----------------tt--S-----#---S-------------QQQ-------------QQ--tt----------------------------2-----------------------------------------------------------------------------
-------||||||||-----tt--------------tt--------#-----K--TT-------------------TT------tt------------------------------------------TT--------------T---------------TT------------------tt----------
-------||||||||-----tt--------------tt--------#--------TT-------------------TT------ttt-----------------------------tt----------TT----tt--------T---------------TT----tt------------tt----------
-------||||||||-g---tt--y-----------tt-----##-#-g-g----TT-----g-ggg------g--TT-kggg-ttt-------g-----------------K---tt--------#-TT----tt------ggT---y----------kTT----tt------ggg---tt-----b----
XXXXXXXXXXXXXXXXXXXXXXXXXXXXXXXXXXXXXXXXXXXXXXXXXXXXXXXXXXXXXXXXXXXXXXXXXXXXXXXXXXXXXXXXXXXXXXXXXXXXXXXXXXXXXXXXXXXXXXXXXXXXXXXXXXXXXXXXXXXXXXXXXXXXXXXXXXXXXXXXXXXXXXXXXXXXXXXXXXXXXXXXXXXXXXXX
XXXXXXXXXXXXXXXXXXXXXXXXXXXXXXXXXXXXXXXXXXXXXXXXXXXXXXXXXXXXXXXXXXXXXXXXXXXXXXXXXXXXXXXXXXXXXXXXXXXXXXXXXXXXXXXXXXXXXXXXXXXXXXXXXXXXXXXXXXXXXXXXXXXXXXXXXXXXXXXXXXXXXXXXXXXXXXXXXXXXXXXXXXXXXXXX
