------------------------------------------------------------------------------------------------------------------------------------------------------------------------------------------------
------------------------------------------------------------------------------------------------------------------------------------------------------------------------------------------------
------------------------------------------------------------------------------------------------------------------------------------------------------------------------------------------------
------------------------------------------------------------------------------------------------------------------------------------------------SSSSSSS-----------------------------------------
------------------------------------------------------------------------------------------------------------------------------------------------------------------------------------------------
--------------------------------------------------------------------------------------------------------------------------------------------------------------------------------o---------------
--------%%%%%%%%--------------------------------------SS----------------------------QQQQQ------------------------ooo--SSSS-----S----QQQ---------------------------------------------QQQ---------
---------||||||---------------------------------------------------------------------------------------------------------------------------------------------------------------------------------
---------||||||------------------------------------------------------------------------------------------------------------------------------Ko-----------------------------------------------o-
---------||||||------------------oo-------------------------------------------------------------------------------------------------------------------------------------------------------------
------%%%%%%%%%%#----2------------------------S------------------------------US--------------U-----------------------------------------------US----------------------------------2Q----------US-
-------||||||||-------------------------------K----------------------------------------------------------TT---TT----tt----------------------------------------TT---------##---------------------
-------||||||||-----------K------------------------------------------------------------------------------TT---TT----tt---##-----------------------------------TT-----B---##---------------------
-------||||||||--------k--b--k----ggggg---k-k-------gg#-#-----------gg----k-------gyogg-----k-----gggg---TT---TT----tt--###--------kgggg--k-k-k-------k-----k-TT--kggg---##----g--ggggy---k-k---
XXXXXXXXXXXXXXXXXXXXXXXXXXXXXXXXXXXXXXXXXXXXXXXXXXXXXXXXXXXXXXXXXXXXXXXXXXXXXXXXXXXXXXXXXXXXXXXXXXXXXXXXXXXXXXXXXXXXXXXXXXXXXXXXXXXXXXXXXXXXXXXXXXXXXXXXXXXXXXXXXXXXXXXXXXXXXXXXXXXXXXXXXXXXXXXX
XXXXXXXXXXXXXXXXXXXXXXXXXXXXXXXXXXXXXXXXXXXXXXXXXXXXXXXXXXXXXXXXXXXXXXXXXXXXXXXXXXXXXXXXXXXXXXXXXXXXXXXXXXXXXXXXXXXXXXXXXXXXXXXXXXXXXXXXXXXXXXXXXXXXXXXXXXXXXXXXXXXXXXXXXXXXXXXXXXXXXXXXXXXXXXXX
