------------------------------------------------------------------------------------------------------------------------------------------------------------------------------------------------
------------------------------------------------------------------------------------------------------------------------------------------------------------------------------------------------
------------------------------------------------------------------------------------------------------------------------------------------------------------------------------------------------
------------------------------------------------------------------------------------------------------------------------------------------------------------------------------------------------
--------------------------------------------------------------oo--------------------------------------------------------------------------------------------------------------------------------
------------------------------------------------------------------------------------------------------------------------------------------------------------------------------------------------
--------%%%%%%%%---------------o-----------------S--QSSS-S-----o--------------------QS---------S-----------------ooo----o------o----------------SSSSSSSS------------Q-----------@SSS@SSS--------
---------||||||---------------------------------------------------------------------------------------------------------------------------------------------------------------------------------
---------||||||----------------------------------------------oo-------------------------------o------------------------------oo-----------------------------------------------------------------
---------||||||--o----------------------------------------------------------------------------------------------o----------------------------------------------o--------------------------------
------%%%%%%%%%%---------------------------------------------@S------------------------------US------------------------------US--------------------SS------------------------U--SSQQS--------SS-
-------||||||||----------------------------------------------------------------------------------------K------K---------------------------------------------------------------------------------
-------||||||||---------#-#-#---------tt-------------------------------TT-----------------------------------------------------------------------------------------------------------------------
-------||||||||---gggg#######---------tt----kkkg--gggggg--k---k--------TT----g----gggggg--k-------ggggk---kkkkk----kgy-------------k-kkk--k-k--------ggg--k-------gggggg----k-k---ggggy---k-k---
XXXXXXXXXXXXXXXXXXXXXXXXXXXXXXXXXXXXXXXXXXXXXXXXXXXXXXXXXXXXXXXXXXXXXXXXXXXXXXXXXXXXXXXXXXXXXXXXXXXXXXXXXXXXXXXXXXXXXXXXXXXXXXXXXXXXXXXXXXXXXXXXXXXXXXXXXXXXXXXXXXXXXXXXXXXXXXXXXXXXXXXXXXXXXXXX
XXXXXXXXXXXXXXXXXXXXXXXXXXXXXXXXXXXXXXXXXXXXXXXXXXXXXXXXXXXXXXXXXXXXXXXXXXXXXXXXXXXXXXXXXXXXXXXXXXXXXXXXXXXXXXXXXXXXXXXXXXXXXXXXXXXXXXXXXXXXXXXXXXXXXXXXXXXXXXXXXXXXXXXXXXXXXXXXXXXXXXXXXXXXXXXX
