------------------------------------------------------------------------------------------------------------------------------------------------------------------------------------------------
------------------------------------------------------------------------------------------------------------------------------------------------------------------------------------------------
------------------------------------------------------------------------------------------------------------------------------------------------------------------------------------------------
----------------------------------------------------------------SSSSSSSS--------SSSSS----------------------------SS-------SS--------------------------------------------------------------------
----------------------------------------------------------------------------------------------------------------------------------------------o-------------------------------------------------
--------------------------------o--o------------------------------------------------------------------------------------------------------------------------------------------------------------
--------%%%%%%%%---------------------Q----------------------------------------------------------SSS@SSS------S@S----------------Q---QSSSoS---S@S----------------SSoSSSSS-----SSS----------------
---------||||||---------------------------------------------------------------------------------------------------------------------------------------------------------------------------------
---------||||||-----------------------------------------------------------------------------------------------o---------------------------------------------------------------------------------
---------||||||--------------------------oor----------------------------------------------------o------------------------------------------------------------------------------o----------------
------%%%%%%%%%%---SSSS---------QQQQSS---S%%SS--------tt-----o--------tt---------------------o--S-----------S@SS------------------Q----------US-----------------SSSSS---------S-----------------
-------||||||||---------------------------||----------tt--------------tt---------------tt--------------------------------TT------------------------------TT-------------------------------------
-------||||||||---------TT----------------||----------tt--------------tt---------------tt--------------------------------TT--------------------------B---TT-------------------------------------
-------||||||||---------TT----------------||----------tt----gggg#-----tt-----ggg--gk---tt---kggg---kgggg--k-------kk-k-k-TT---k---ggggy---k-------kkkb---TT---k------ky---k-k-----g----k----k-kg
XXXXXXXXXXXXXXXXXXXXXXXXXXXXXXXXXXXXXXXXXXXXXXXXXXXXXXXXXXXXXXXXXXXXXXXXXXXXXXXXXXXXXXXXXXXXXXXXXXXXXXXXXXXXXXXXXXXXXXXXXXXXXXXXXXXXXXXXXXXXXXXXXXXXXXXXXXXXXXXXXXXXXXXXXXXXXXXXXXXXXXXXXXXXXXXX
XXXXXXXXXXXXXXXXXXXXXXXXXXXXXXXXXXXXXXXXXXXXXXXXXXXXXXXXXXXXXXXXXXX-XXXXXXXXXXXXXXXXXXXXXXXXXXXXXXXXXXXXXXXXXXXXXXXXXXXXXXXXXXXXXXXXXXXXXXXXXXXXXXXXXXXXXXXXXXXXXXXXXXXXXXXXXXXXXXXXXXXXXXXXXXXX
