------------------------------------------------------------------------------------------------------------------------------------------------------------------------------------------------
------------------------------------------------------------------------------------------------------------------------------------------------------------------------------------------------
------------------------------------------------------------------------------------------------------------------------------------------------------------------------------------------------
----------------------------------------------------------------------------------------------------------------SSSS----------------------------SSS---------------------------------------------
---------------------------------------------------------------o--------------------------------------------------------------------------------------------------------------------------------
------------------------------------------------------------------------------------------------------------------------------------------------------------------------------------------------
--------%%%%%%%%---------------------QQo------------QQQ---------------S--------o--------------------Q-SSSSS----o--------o----o-o--------So--------------oo-ooo-o-oo------------o------QQo-------
---------||||||----------------------------------------------------------------#---------------------------------------------------S%%K---------------------------------------------------------
---------||||||--------------------------------------------------------------###-----------------------------oo--------------S------||---------------------SSSS------------------------------o--
---------||||||--------------------------------------------------o-----------###--------------------------------------------SS------||------------------S--SSSS-o-------------------------------
------%%%%%%%%%%-----2-------US--------------o------------------#------------###--#-------------------------S@S---####o-----SS------||-----------###--Q-----SSS--------------U----##-#QSQ---SSS-
-------||||||||---------------------------------------------------------#---###----------------------------------###----------------|tt---------####----------------------------###-------------
-------||||||||-----------------------tt-------------------------------##--####---------------------------------####----------------|tt---------####----------------------------###-------------
-------||||||||--------k----kkk----k--tt-----g-g---yggg------g-g----ggg##--####--#---kkk---kkkk---gggg----------####-k-----kk-------|tt-------######-------kk------k-##y--k---k-###--------kk---
XXXXXXXXXXXXXXXXXXXXXXXXXXXXXXXXXXXXXXXXXXXXXXXXXXXXXXXXXXXXXXXXXXXXXXXXXXXXXXXXXXXXXXXXXXXXXXXXXXXXXXXXXXXXXXXXXXXXXXXXXXXXXXXXXXXXXXXXXXXXXXXXXXXXXXXXXXXXXXXXXXXXXXXXXXXXXXXXXXXX-XXXXXXXXXXX
XXXXXXXXXXXXXXXXXXXXXXXXXXXXXXXXXXXXXXXXXXXXXXXXXXXXXXXXXXXXXXXXXXXXXXXXXXXXXXXXXXXXXXXXXXXXXXXXXXXXXXXXXXXXXXXXXXXXXXXXXXXXXXXXXXXXXXXXXXXXXXXXXXXXXXXXXXXXXXXXXXXXXXXXXXXXXXXXXXXX-XXXXXXXXXXX
