------------------------------------------------------------------------------------------------------------------------------------------------------------------------------------------------
---------------------------------------------------------------------------------------------------------------------------------K--------------------------------------------------------------
------------------------------------------------------------------------------------------------------------------------------------------------------------------------------------------------
------------------------------------------------------------------------------------------------SSSSSSSSSSSS------------------------------------SSSSSSS-----------------------------------------
------------------------------------------------------------------------------o-----------------------------------------------------------------------------------------------oo----------------
-------------------------------------------------------------------------------------------------------------------o----------------------------------------------------------------------------
--------%%%%%%%%------SQQ----------------------o-----------------ooS@SSSSS---SSSSSoS@S---------#-------------------SQQQQ---------ooo----------o#--------------------QQQQ------@-SSS@QSQ---------
---------||||||------------o--------------------------------------------------------------------------------------------------------------------------------------------------------------------
---------||||||------------------------------------------------------------------------------K---------------SSS-------------Ko--------------ooo------------------------------o--------------oo-
---------||||||--------k--SSSSS---------------------------------o---------------------------------------------------------------oo--------------------------------------------------------------
------%%%%%%%%%%------SQQS-----------------------------t------------Q--------USS---------------------------------------------US-S------------@S------------------------------US-SSQ--S------S@S-
-------||||||||----#-----------------------------------t----------------------------------------------------------------------------------------------------------------------------------------
-------||||||||----#-----------------B----#----------------------------------------------------------t--------TT--------------------------T----------t------------------------------------------
-------||||||||----#---------------kkg----#------------k---kkkk----k------k--------kgggg--k-k--------t------k-TT---k-ky---k-k------gggk---T----------tty------k----kogy---k-k-----ggggy---k-k---
XXXXXXXXXXXXXXXXXXXXX-XXXXXXXXXXXXXXXXXXXXXXXXXXXXXXXXXXXXXXXXXXXXXXXXXXXXXXXXXXXXXXXXXXXXXXXXXXXXXXXXXXXXXXXXXXXXXXXXXXXXXXXXXXXXXXXXXXXXXXXXXXXXXXXXXXXXXXXXXXXXXXXXXXXXXXXXXXXXXXXXXXXXXXXXXX
XXXXXXXXXXXXXXXXXXXXX-XXXXXXXXXXXXXXXXXXXXXXXXXXXXXXXXXXXXXXXXXXXXXXXXXXXXXXXXXXXXXXXXXXXXXXXXXXXXXXXXXXXXXXXXXXXXXXXXXXXXXXXXXXXXXXXXXXXXXXXXXXXXXXXXXXXXXXXXXXXXXXXXXXXXXXXXXXXXXXXXXXXXXXXXXX
