------------------------------------------------------------------------------------------------------------------------------------------------------------------------------------------------
------------------------------------------------------------------------------------------------------------------------------------------------------------------------------------------------
------------------------------------------------------------------------------------------------------------------------------------------------------------------------------------------------
---------------------------------SSSS------------------------------------------------------------------------------SSSSS------------------------SSSSSSSSSSS-------------------------------------
------------------------------------------------------------------------------------------------------------------------------------------------------------------------------------------------
------------------------------------------------------------------------------------------------------------------------------------------------------------------------------------------------
--------%%%%%%%%----QQQQQ------------------------o----SSoS-----S--------o------o-------oo------o-------SSS-----S-------oo-------------QQQ------o--------------------QQQQQ------o-------QQ-SS----
---------||||||---------------------------------------K-----------------------------------------------------------------------------------------------------------------------------------------
---------||||||---------------o-----------------------------------------------------------------------------------------------------------------------------------------------------------------
---------||||||--------------------------------------------------------------------------------------------------------------------------------------------------------g---------------k--------
------%%%%%%%%%%-###---------US--------------o-------------------###---#-----##---#--------------------------S----#####----------###-#Q#Q---SQ------------------#########---SSS--------QQ---S@S-
-------||||||||--##---------------------------------o-----------####---#----##---##------------------------------##-#-----------####-----------------------------###----------------------------
-------||||||||--##------------------tt-----------###-----------####---#---###--###-----------------------------#####-----------####-----------------tt-------g--###----------------------------
-------||||||||--##k-kkk----k--------tt-----k-k-#-###-----------####-###---###--###----k---kk--------------k----#####k------k---####-k------k--------tt------#######------k-k--------------kk---
XXXXXXXXXXXXXXXXXXXXXXXXXXXXXXXXXXXXXXXXXXXXXXXXXXXXXXXXXXXXXXXXXXXXXXXXXXXXXXXXXXXXXXXXXXXXXXXXXXXXXXXXXXXXXXXXXXXXXXXXXXXXXXXXXXXXXXXXXXXXXXXXXXXXXXXXXXXXXXXXXXXXXXXXXXXXXXXXXXXXXXXXXXXXXXXX
XXXXXXXXXXXXXXXXXXXXXXXXXXXXXXXXXXXXXXXXXXXXXXXXXXXXXXXXXXXXXXXXXXXXXXXXXXXXXXXXXXXXXXXXXXXXXXXXXXXXXXXXXXXXXXXXXXXXXXXXXXXXXXXXXXXXXXXXXXXXXXXXXXXXXXXXXXXXXXXXXXXXXXXXXXXXXXXXXXXX-XXXXXXXXXXX
