------------------------------------------------------------------------------------------------------------------------------------------------------------------------------------------------
------------------------------------------------------------------------------------------------------------------------------------------------------------------------------------------------
------------------------------------------------------------------------------------------------------------------------------------------------------------------------------------------------
----------------------------------------------------------------------------------------------------------------------------------------------------------------SSSSSSSS------------------------
----------------------------------------------------------------------------------------------------------------------------------------------------------------------------------------------o-
------------------o-----------------------------------------------------------------------------------------------------------------------------------------------------------------------------
--------%%%%%%%%--%-----------------------------Soo--SQSoS---SSS---------------U-oo--------------SSSQSSoo-----SS----------------Q--S@SSS-------SSSSS@SS-------SS-----------------oo-QQ--------@S
---------||||||---|-----------------------------------------------------------------------------------------------------------------------------------------------------------------------------
---------||||||---|-------------------------------------------------------------------------------------------oo--------------------------------------------------------------------------------
---------||||||---|------------------------------------o---------oo--------------o--------------o-----------------o------------------------------g----------------------------------------------
------%%%%%%%%%%--|------------------------------S--S-SSS--------------------o------------#------S--Q--------US-------------------QQ---------US-SSSS---------US-------------------Q------##-----
-------||||||||---|-------------------------------------------------------B--------------##-----------------------K------TT-------------------------------------------------------------###-----
-------||||||||---|-------------------------------------------------------b-------------###------------------------------TT---TT-------------------------------------tt----------------####-----
-------||||||||---g----k---gk-----gg---k----kkkg----gg------------gggggg-g#---------ggg####-k------k-ggg--k-k-----y------TT---TT---ggg------k------kgggg--k-k--------tt-----kkk-----ggg####-----
XXXXXXXXXXXXXXXXXXXXXXXXXXXXXXXXXXXXXXXXXXXXXXXXXXXXXXXXXXXXXXXXXXXXXXXXXXXXXXXXXXXXXXXXXXXXXXXXXXXXXXXXXXXXXXXXXXXXXXXXXXXXXXXXXXXXXXXXXXXXXXXXXXXXXXXXXXXXXXXXXXXXXXXXXXXXXXXXXXXXXXXXXXXXXXXX
XXXXXXXXXXXXXXXXXXXXXXXXXXXXXXXXXXXXXXXXXXXXXXXXXXXXXXXXXXXXXXXXXXXXXXXXXXXXXXXXXXXXXXXXXXXXXXXXXXXXXXXXXXXXXXXXXXXXXXXXXXXXXXXXXXXXXXXXXXXXXXXXXXXXXXXXXXXXXXXXXXXXXXXXXXXXXXXXXXXXXXXXXXX-XXXX
