-----------------------K------------------------------------------------------------------------------------------------------------------------------------------------------------------------
-----------------------o------------------------------------------------------------------------------------------------------------------------------------------------------------------------
----------------------%%%-----------------------------------------------------------------------------------------------------------------------------------------------------------------------
-----------------------|------------------------------------------------------------------------------------------------------------------------------------------------------------------------
-----------------------|----------------------------------------------------------------------------------------------------------------------------------------------------------------------oo
-----------------------|-------o----------------------------------------------------------------------------------------------------------------------------------------------------------------
--------%%%%%%%%-------|-------%-----QQQ-----------------------U--------------------QQQQQ----------S@QQ--------o------------------------------o#----Q------------------------------SQQQQ--------
---------||||||--------|-------|----------------------------------------------------------------------------------------------------------------------------------------------------------------
---------||||||--------|-------|------------------------------S------------------------------oo---------------o---------------------------------------------------------------------------------
---------||||||--------|-------|----------------------------------------------------------------------------------------------------------------------------------------------------------------
------%%%%%%%%%%-------|-%%%%--|-------------US-----------------------------#----#----------SUS--------------US----------------------------------------------US-------------------Q----------US-
-------||||||||--------|--||--oo--------------------------------------------#---------------------------------------------K--------------#----------------K---------------#---------------------
-------||||||||--------|--||-%%%----------------------------------------TT--#-----------------------------------------------------------###-----------------------------------------------------
-------||||||||-----r--|--||--|---ggggggk---k-kk--kkggg---k---k---g-----TT--#--g---k-ky---k-k-----gggggg--k-k-----kk-k-k------kg---k---####-------gggggg--g---k---y---ok------k---gggggg--k-k---
XXXXXXXXXXXXXXXX%%%%%%%%%-||--|-XXXXXXXXXXXXXXXXXXXXXXXXXXXXXXXXXXXXXXXXXXXXXXXXXXXXXXXXXXXXXXXXXXXXXXXXXXXXXXXXXXXXXXXXXXXXXXXXXXXXXXXXXXX-XXXXXXXXXXXXXXXXXXXXXXXXXXXXXXXXXXXXXXXXXXXXXXXXXXXX
XXXXXXXXXXXXXXXX-|||||||--||--|-XXXXXXXXXXXXXXXXXXXXXXXXXXXXXXXXXXXXXXXXXXXXXXXXXXXXXXXXXXXXXXXXXXXXXXXXXXXXXXXXXXXXXXXXXXXXXXXXXXXXXXXXXXX-XXXXXXXXXXXXXXXXXXXXXXXXXXXXXXXXXXXXXXXXXXXXXXXXXXXX
