------------------------------------------------------------------------------------------------------------------------------------------------------------------------------------------------
------------------------------------------------------------------------------------------------------------------------------------------------------------------------------------------------
------------------------------------------------------------------------------------------------------------------------------------------------------------------------------------------------
--------------------------------SSSSSSS---------------------------------------------------------SSSSSSSS-SS-------------------------------------------------------------------------------------
------------------------------------------------------------------------------------------------------------------------------------------------------------------------------------------------
------------------------------------------------------------------------------------------------------------------------------------------------------------------------------------------------
--------%%%%%%%%-ooo----oo-----S--------------------QQQQQS----------------------------------------------o--------------QQ----------------o------------QQo------o-ooo----oS-----o-------oo----o--
---------||||||---------------------------------------------------------------------------------------------------------------------------------------------------------------------------------
---------||||||--------------------------------------------------------------------------------------------------------------S---------------------------------------------------------------S--
---------||||||-----------------------------------g----g---------------------------------------------------------------g-----S----------------------------------oo---------------------o---SSS--
------%%%%%%%%%%SSQQQ--------SS-----------------######QQQ---SQS------------------##----------SS-------------------###-Q#Q---SS------------------######Q-Q---SQS--------------U----####Q#Q---SS--
-------||||||||---------------------------------####-----------------------------##----K-------------------------###----------------------------####-----------------------------###------------
-------||||||||-----------------------tt--------####-----------------------------##------------------------------##-----------------------------####----------------------------####------------
-------||||||||----k------k-----------tt------gg###k--k----kk------k-ggg------k--##--kok----k------k-g-k----k-k--##k-------kk------k-----------g###--------kk------kgg----------####-------kk---
XXXXXXXXXXXXXXXXXXXXXXXXXXXXXXXXXXXXXXXXXXXXXXXXXXXXXXXXXXXXXXXXXXXXXXXXXXXXXXXXXXXXXXXXXXXXXXXXXXXXXXXXXXXXXXXXXXXXXXXXXXXXXXXXXXXXXXXXXXXXXXXXXXXX-XXXXXXXXXXXXXXXXXXXXXXXXXXXXXXXXXXXXXXXXXXX
XXXXXXXXXXXXXXXXXXXXXXXXXXXXXXXXXXXXXXXXXXXXXXXXXXXXXXXXXXXXXXXXXXXXXXXXXXXXXXXXXXXXXXXXXXXXXXXXXXXXXXXXXXXXXXXXXXXXXXXXXXXXXXXXXXXXXXXXXXXXXXXXXXXX-XXXXXXXXXXXXXXXXXXXXXXXXXXXXXXX-XXXXXXXXXXX
