------------------------------------------------------------------------------------------------------------------------------------------------------------------------------------------------
-----------------------------------------------------------------------------------------------------------------K------------------------------------------------------------------------------
------------------------------------------------------------------------------------------------------------------------------------------------------------------------------------------------
----------------SSSSSSSSSSSSSSSSSSSS------------------------------------------------------------SS----------------------------------------------------------------------------------------------
----------------S-------------------------------------------------------------------------------------------------------------------------------------------------------------------------------
---------------------------o---S----------------------------------------------------------------------------------------------------------------------------------------------------------------
--------%%%%%%%%----------SSS-SS-------------------------------U------------------------------------------------SS--QQQo-----U-#SSSSSS-------------------------U----QQQ---------SSSSSSS---------
---------||||||---------------------------------------------------------------------------------------------------------------------------------------------------------------------------------
---------||||||-------------------------------------------------------------------------------o------------------------------Ko-----------------------------------------------o--------------o--
---------||||||---------------------------------------------------------------------------------------------------------------------------------------------------------------------------------
------%%%%%%%%%%TT---2-------------------------------------------##--------------------------US------------------------------US--------------@S-------------------Q----------US--------------@S-
-------||||||||-TT-----tt--------------------------------TT------##----K------------------------------------------------------------------K---------------------------------------------------K-
-------||||||||-TT-----tt---------B------B---------------TT------##-------------------------------B---tt---------------------------------------------B---TT-------------------------------------
-------||||||||-TT-----tt----gg---b------b----gg--kggg---TT----g-##k---y----k-k---g---gg--k-k-----b---tt---#---g---k-kgg--k-------ggggg---k-k-k---kk-b---TT---kg--gggggg----k-----ggggg---k-k---
XXXXXXXXXXXXXXXXXXXXXXXXXXXXXXXXXXXXXXXXXXXXXXXXXXXXXXXXXXXXXXXXXXXXXXXXXXXXXXXXXXXXXXXXXXXXXXXXXXXXXXXXXXXXXXXXXXXXXXXXXXXXXXXXXXXXXXXXXXXXXXXXXXXXXXXXXXXXXXXXXXXXXXXXXXXXXXXXXXXXXXXXXXXXXXXX
XXXXXXXXXXXXXXXXXXXXXXXXXXXXXXXXXXXXXXXXXXXXXXXXXXXXXXXXXXXXXXXXXXXXXXXXXXXXXXXXXXXXXXXXXXXXXXXXXXXXXXXXXXXXXXXXXXXXXXXXXXXXXXXXXXXXXXXXXXXXXXXXXXXXXXXXXXXXXXXXXXXXXXXXXXXXXXXXXXXXXXXXXXXXXXXX
