------------------------------------------------------------------------------------------------------------------------------------------------------------------------------------------------
------------------------------------------------------------------------------------------------------------------------------------------------------------------------------------------------
------------------------------------------------------------------------------------------------------------------------------------------------------------------------------------------------
----------------SSSSSS----------------------------------------------------------------------------------------------------------------------------------------------------------SSSS------------
------------------------------------------------------------------------------------------------------------------------------------------------------------------------------------------------
----------------------------------------------------------------------------o-------------------------------------------------------------------------------------------------------------------
--------%%%%%%%%-------------o---------SSS---------------------------QQ---------------------------SQQSQQ-------------QS-----------------o--------------QQ------o------SSSo-------------oo----o--
---------||||||--------------S--oooo--oo-------------------------------------ooo--------------------------------------------------------------------------------------K-------------------------
---------||||||--------------S--%------------------------------------------------------------------------------------------------------------------------------------------------------------S--
---------||||||-----------------|----------------------------------------------------------------------g-------o----------------------------------------------------------------------k-S-SSSS--
------%%%%%%%%%%----------------|--------------------------------SS--------------------------oo--#Q-#--S-----US----------------------------------####-----------------------------#-###---------
-------||||||||-----------------|----------------------------------------------------------------------------------------#------#-##-------------###---K-------------------------###------------
-------||||||||-#---------------|-----------------------------------------------------------------------------------------------#####-----------####----------------------------#####-----------
-------||||||||-##---------kkk--|----------------------------o-o-----------------------k-----k-----k-ky---k-k-------ggk-k----k--#####----------####k--oy----kkkg---k----------ko####-k-----kkgg-
XXXXXXXXXXXXXXXXXXX-XXXXXXXXXXXXXXXXXXXXXXXX-%%%-XXXX--------X--XXXXXXXXXXXXXXXXXXXXXXXXXXXXXXXXXXXXXXXXXXXXXXXXXXXXXXXXXXXXXXXXXXXXXXXXXXXXXXXXXXXXXXXXXXXXXXXXXXXXXXXXXXXXXXXXXXXXXXXXXXXXXXXX
XXXXXXXXXXXXXXXXXXX-XXXXXXXXXXXXXXXXXXXXXX-X--|--XXXX----------XXXXXXXXXXXXXXXXXXXXXXXXXXXXXXXXXXXXXXXXXXXXXXXXXXXXXXXXXXXXXXXXXXXXXXXXXXXXXXXXXXXXXXXXXXXXXXXXXXXXXXXXXXXXXXXXXXXXXXXXXXXXXXXXX
