------------------------------------------------------------------------------------------------------------------------------------------------------------------------------------------------
------------------------------------------------------------------------------------------------------------------------------------------------------------------------------------------------
------------------------------------------------------------------------------------------------------------------------------------------------------------------------------------------------
------------------------------------------------SSSSSSSS----------------------------------------------------------------------------------------SS----------------------------------------------
------------------------------------------------------------------------------------------------------------------------------oo-------------------------------2--------------------------------
------------------------------------------------------------------------------------------------------------------------------------------------------------------------------------------------
--------%%%%%%%%--------------------QQQ--------o-------------------SQQQ------STT---------------U--------------------QQ----------S--------------U-------------------------------oS--SQQQSSS------
---------||||||---------------------------------------------------------------------------------------------------------------------------------------------------------------------------------
---------||||||------------------------------oo-----------------------------------------------o----------------------------------------------ooo---------------------------------------------oo-
---------||||||-----------------------------------------------------------------ooo----------------------------------------------------------B----o------------------------------g--------------
------%%%%%%%%%%-----------------------------@S-------t-----------QQ-------------------------US----------------------------------2-----------@S----------------------------------#Q-Q-------S@S-
-------||||||||----------T----T----------------------ttt--------------------------------------------------B-------------------------------T-------T-----TT----------------#---------------------
-------||||||||----------TT--------------------------ttt----------------#----------------------------------------------------------------TT------TB-----Tt---------------##---------------------
-------||||||||------ggg-TT-kkkT--gggggg--k-k-k------ttt---kkkk----k--k-#-k-k-----gggg----k--------k-kgg------k---gggggg--k-k-----gkggk---T-----TTb----ktt--k-kg--kkgggg###-------gkogy---k-k---
XXXXXXXXXXXXXXXXXXXXXXXXXXXXXXXXXXXXXXXXXXXXXXXXXXXXXXXXXXXXXXXXXXXXXXXXXXX-XXXXXXXXXXXXXXXXXXXXXXXXXXXXXXXXXXXXXXXXXXXXXXXXXXXXXXXXXXXXXXXXXXXXXXXXXXXXXXXXXXXXXXXXXXXXXXXXXXXXXXXXXXXXXXXXXXXX
XXXXXXXXXXXXXXXXXXXXXXXXXXXXXXXXXXXXXXXXXXXXXXXXXXXXXXXXXXXXXXXXXXXXXXXXXXX-XXXXXXXXXXXXXXXXXXXXXXXXXXXXXXXXXXXXXXXXXXXXXXXXXXXXXXXXXXXXXXXXXXXXXXXXXXXXXXXXXXXXXXXXXXXXXXXXXXXXXXXXXXXXXXXXXXXX
