------------------------------------------------------------------------------------------------------------------------------------------------------------------------------------------------
------------------------------------------------------------------------------------------------------------------------------------------------------------------------------------------------
------------------------------------------------------------------------------------------------------------------K--------2--------------------------------------------------------------------
------------------------------------------------------------------------------------------------------------------------------------------------------------------------------------------------
---------------------------------------------------------------------------S--------------------------------------------------------------------------------------------------------------------
------------------------------------------------------------------------------------------------------------------------------K-%%-----------------------------U-------------------------------U
--------%%%%%%%%---------------------------------------SSSS----%-------SSSSS-----------------------QS---------@%---QS---------@%||---------------------SS---------------SS-S---S-------@SS-----%
---------||||||-o------------------------S---------------------|-----------------------------------------------|---------------|||-------------------------------------------------------------|
---------||||||-S------------------------S--------------SS-----|-------SSSS-------------SS--------------SSS----|--------SSS----|||----------------------S------#-------SSSS--------------------|
---------||||||-S----------------------SSSS--------------------|------------------------SSS--------------------|---------------|||------SS-------------------2#------------------------------2-|
------%%%%%%%%%%--TT---TT---------------SS--------S----SSS-----|--S-----S-----Q---------------#-----S----------|---S-----------|||-----SSS----#---2-----S----##---S---------------2----SSS---##|
-------||||||||---TT---TT--------------------------------------|--------------------tt--------#--K--K----------|-K--K----------|||--tt-------##-------------###--K--------------------------###|
-------||||||||---TT-#-TT--------------------------------------|--------------------tt--------#----------------|----------#----|||--tt------###-----------#####------------B---------------####|
-------||||||||---TT-#-TT-----------------kg------------k---y--|K------------#------tt-----y#-#---------y------|----------#----|K|--tt----#####-K-------U-######--K--------b----K-------k-#####|
XXXXXXXXXXXXXXXXXXXXXXXXXXXXXXXXXXXXXXXXXXXXXXXXXXXXXXXXXXXXXXXXXXXXXXXXXXXXXXXXXXXXXXXXXXXXXXXXXXXXXXXXXXXXXXXXXXXXXXXXXXXXXXXXXXXXXXXXXXXXXXX-XXXXXXXXXXXXXXXXXXXXXXXXXXXXXXXXXXXXXXXXXXXXXXX|
XXXXXXXXXXXXXXXXXXXXXXXXXXXXXXXXXXXXXXXXXXXXXXXXXXXXXXXXXXXXXXXXXXXXXXXXXXXXXXXXXXXXXXXXXXXXXXXXXXXXXXXXXXXXXXXXXXXXXXXXXXXXXXUXXXXXXXXXXXXXXXXXXXXXXXXXXXXXXXXXXXXXXXXXXXXXXXXXXXXXXXXXXXXXXXXX
