------------------------------------------------------------------------------------------------------------------------------------------------------------------------------------------------
------------------------------------------------------------------------------------------------------------------------------------------------------------------------------------------------
------------------------------------------------------------------------------------------------------------------------------------------------------------------------------------------------
----------------------------------------------------------------------------------------------------------------SS------------------------------------------------------------------------------
------------------------------------------------------------------------------------------------------------------------------------------------------------------------------------------------
------------------------------------------------------------------------------------------------------------------------------------------------------------------------------------------------
--------%%%%%%%%-%%--------o--------QQQooo-----U-------------------------------------QQQQ------o----QQSSSSS----U--------o----o---o----SSSS-----o-------Qoo---------------------------QQQQ-------
---------||||||--||-----------------------------------------------------------------------------------------------------------------S%K--------#------------------------------------------------
---------||||||--||--------------------------oo--------------------------------------------------------------oo----------------------|--------------------------------------------------------o-
---------||||||--||---------------------------------------------------------------#------------------------------------g--------oo---|----------------------------------------------------------
------%%%%%%%%%%-||---------------#----------US------------#--------------------####------------------------S@S---######Q------------|--------##-###--Q------US-------------###-######QQQ---SQS-
-------||||||||--||---------------#----K-----------------###-------------TT-----####-----------------------------##------------------|---#---###-###----------------------#-#-#-###-------------
-------||||||||--||-------------------------------------####-------------TT-----####-----------------------------##------------------|---#-#####-##----------------------######-###-------------
-------||||||||--||----k-----ggg--#k-kogk---k--------g######------kk-g---TT----####----k---kkk----gggg----k-k----##k-k------k--------|--###########k--------k------------######-###k--------k---
XXXXXXXXXXXXXXXXoXXXXXXXXXXXXXXXXXXXXXXXXXXXXXXX-XXXXXXXXXX-----XXXXXXXXXXXXXXXXXXXXXXXXXXXXXXXXXXXXXXXXXXXXXXXXXXXXXXXXXXXXXXXXXXXXXXXXXXXXXXXXXXXXXXXXXXXXXXXXXXXXXXXXXXXXXXXXXXXX-XXXXXXXXXXX
XXXXXXXXXXXXXXXX--XXXXXXXXXXXXXXXXXXXXXXXXXXXXXX-XXXXXXXXXX-----XXXXXXXXXXXXXXXXXXXXXXXXXXXXXXXXXXXXXXXXXXXXXXXXXXXX-XXXXXXXXXXXXXXXXXXXXXXXXXXXXXXXXXXXXXXXXXXXXXXXXXXXXXXXXXXXXXXX-XXXXXXXXXXX
