----------------------------------S-------------------------------------------------------------------------------------------------------------------------------------------------------------
----------------------------------S------------------------------------------------------------------------------K------------------------------------------------------------------------------
------------------------------------------------------------------------------------------------------------------------------------------------------------------------------------------------
--------------------------------SSSSSSSS-------S------------------------------------------------------------------------------------------------SSSS--------------------------------------------
--------------------------------S---------------------------------------------------------------------------------------------oo----------------------------------------------oo----------------
------------------------------------------ooo----------------------------------o----------------------------------------------------------------------------------------------------------------
--------%%%%%%%%--------------------------SS-----------oo------oSSSSSSS------SSS--------------------------------SoooSS-------S-----------------o-------------------S@QQ-------------------------
---------||||||--oo-----------------------------------------------------------------------------------------------------------------------------------------------------------------------------
---------||||||-%%%-------------S----------------------------oS--------------------------------------------------------------U------------------------------------------------------------------
---------||||||--|------------------------------------------oS--ooooo------------o----------------------------------------------ooo----------------------------------------------o--------------
------%%%%%%%%%%-|------------------------------------------SSS-SSSSS--------USS----------------------------------------------------------------------------------Q-Q--------US-----------------
-------||||||||--|--------#------------t------T--------------------K-----TT---------------#-#-----------------T-----------T---------------#------------t---------------------------------TT-----
-------||||||||--|-------##-----T------t-----TTT-------------------------TT---------------#-------------------T----------TT---------------#------------tt--------------------------------TT-----
-------||||||||--|-------##----oT-----tt----kkTT--gk-k----k-k------k-gg--TT--------kgggg--#-k-----kk-gg-----kkk----gggy-----k-----gggggg-##----g-------tt-----#----k-ggg--k-k------gggg--TT-----
XXXXXXXXXXXXXXXXXXXXXXXXXXXX----XXXXXXXXXXXXXXXXXXXXXXXXXXXXXXXXXXXXXXXXXXXXXXXXXXXXXXXXXXXXXXXXXXXXXXXXXXXXXXXXXXXXXXXXXXXXXXXXXXXXXXXXXXXXXXXXXXXXXXXXXXXXXXXXXXXXXXXXXXXXXXXXXXXXXXXXXXXXXXXX
XXXXXXXXXXXXXXXXXXXXXXXXXXXX----XXXXXXXXXXXXXXXXXXXXXXXXXXXXXXXXXXXXXXXXXXXXXXXXXXXXXXXXXXXXXXXXXXXXXXXXXXXXXXXXXXXXXXXXXXXXXXXXXXXXXXXXXXXXXXXXXXXXXXXXXXXXXXXXXXXXXXXXXXXXXXXXXXXXXXXXXXXXXXXX
