------------------------------------------------------------------------------------------------------------------------------------------------------------------------------------------------
------------------------------------------------------------------------------------------------------------------------------------------------------------------------------------------------
------------------------------------------------------------------------------------------------------------------------------------------------------------------------------------------------
----------------SSSSS-----------SSSSSS------------------------------------------------------------------------------------------SSSSSSSSSSSS----------------------------------------------------
------------------------------------------------------------------------------------------------------------------------------oo---------------------------------------------U------------------
-------------------------------------------------------------------------------------------------------------------------------------------------------------------o----------------------------
--------%%%%%%%%---------------------------------------------------------------o--------------------------------S--SQ---------@T--------------So--------S-----SS%--SQSo-------------------------
---------||||||----------------#--------------------------------------------------------------------------------------------------------------------------------|-------------------------------
---------||||||---------------##----------------------------------------------------------------------------------------------o----------------------------#----|------------K------------------
---------||||||-------------#-##--------------------------------ooo----------------------------------------------------------------------------------------#----|------------2---oo-------------
------%%%%%%%%%%-----------#####--------------------------------------------SoS------------------#---------------------------US---------------------------##----|---U---------------------------
-------||||||||------------#####------------------------------K-----------K--------T-----TT--------------------------------------------t-----------------####---|-------------K---K------TT-----
-------||||||||--------t--######------------------------------------------b-------TT----oTT----T-------------------------------------t-t----------------#####---|------------------------TT-----
-------||||||||--------t--######-------k-----kgg--kkgg------kkk---kggg----b----g--T-----TTT---oT---k-kkk----kkk----kggg---k-k--------tty----k-k----kggg#####k---|--ggggg--k-k------k-ggg-TT---k-
XXXXXXXXXXXXXXXXXXXXXXXXXXXXXXXXXXXXXXXXXXXXXXXXXXXXXXXXXXXXXXXXXXXXXXXXXXXXXXXXXXXXXXXXXXXXXXXXXXXXXXXXXXXXXXXXXXXXXXXXXXXXXXXXXXXXXXXXXXXXXXXXXXXXXXXXXXXXXXXXXXXXXXXXXXXXXXXXXXXXXXXXXXXXXXXX
XXXXXXXXXXXXXXXXXXXXXXXXXXXXXXX-XXXXXXXXXXXXXXXXXXXXXXXXXXXXXXXXXXXXXXXXXXXXXXXXXXXXXXXXXXXXX-XXXXXXXXXXXXXXXXXXXXXXXXXXXXXXXXXXXXXXXXXXXXXXXXXXXXXXXXXXXXXXXXXXXXXXXXXXXXXXXXXXXXXXXXXXXXXXXXXX
