------------------------------------------------------------------------------------------------------------------------------------------------------------------------------------------------
------------------------------------------------------------------------------------------------------------------------------------------------------------------------------------------------
------------------------------------------------------------------------------------------------------------------------------------------------------------------------------------------------
------------------------------------------------------------------------------------------------------------------------------------------------SS--------------SSSSSSSSSS----------------------
------------------------------------------------------------------------------------------------------------------------------------------------------------------------------------------------
------------------------------------------------------------------------------------------------------------------------------------------------------------------------------------------------
--------%%%%%%%%--------------------Q-----------------SSSS--------------oo-----------QQQQ----------o----oS-----o-------Qo------o--------oo---------o---ooo-----o---------------------QQQQ-------
---------||||||-------------------------------------%%%-----------------------------------------------------------------------------------------------------------------------------------------
---------||||||--------------------------------------|-------------------------------------------------------ooo---------------------------------------------S--------------------------------o-
---------||||||--------------------------------------|------------------------------------------o--------------------------------------------------g-----------------------------------g--------
------%%%%%%%%%%-----------------------------o-------|-------S--------------------#-----Q---SSS--------------@S--#######Q---SU-------------------###---------SS-----------------######QSQ---SSS-
-------||||||||-------tt--------------------------#--|---------------------------##------------------------------###-----------------------------###----------------------------###-------------
-------||||||||-------tt------------------------###--|------------#--------------##-----------------------------###------------------------------##---------------------------U-###-------------
-------||||||||-#-----tt---kkk-----k--------k--g###--k-----k-----##---------gggg##-----k---k---g--kggy----------###---kk---kk-----gy-k----------###--kk----kk-----k--g-k------gg###k-------kk---
XXXXXXXXXXXXXXXXXXXXXXXXXXXXXXXXXXXXXXXXXXXXXXXXXXXXXXXXXXXXXXXXXXXXXXXXXXXXXXXXXXX---XXXXXXXXXXXXXXXXXXXXXXXXXXXXXXXXXXXXXXXXXXXXXXXXXXXXXXXXXXXXXXXXXXXXXXXXXXXXXXXXXXXXXXXXXXXXXX-XXXXXXXXXXX
XXXXXXXXXXXXXXXXXXXXXXXXXXXXXXXXXXXXXXXXXXXXXXXXXXXXXXXXXXXXXXXXXXXXXXXXXXXXXXXXXXX---XXXXXXXXXXXXXXXXXXXXXXXXXXXXXXXXXXXXXXXXXXXXXXXXXXXXXXXXXXXXXXXXXXXXXXXXXXXXXXXXXXXXXXXXXXXXXX-XXXXXXXXXXX
