--------------------------------------------------------------------------------------------------------------------------------------------------------------------------------------S---------
------------------------------------------------------------------------------------------------------------------------------------------------------------------------------------------------
------------------------------------------------------------------------------------------------------------------------------------------------------------------------------------------------
----------------------------------------------------------------------------------------------------------------SSSS----------------------------------------------------------------------------
------------------------------------------------------------------------------------------------------------------------------------------------------------------------------------------------
------------------------------------------------------------------------------------------------------------------------------------------------------------------------------------------------
--------%%%%%%%%---o-----------o--%--------------------------------------------------Q----------SSSS@SQSo----SSS--------------------------------S--SQQQ-----------------------------------------
---------||||||-------------------|-------------------------------------------------------------------------------------------------------------------------------------------------------------
---------||||||-------------------|---------------------------o-----------------------------------------------------------------------------------------------o---------------------------------
---------||||||-------------------|--------------------------------------------------------------------------------------------------------------g---------------oo-----------------------------
------%%%%%%%%%%--#SSSS------U----|--2-----------------------@S----------------------------------#--SS-------SS------2---------------------------SQ----------US-----------#---------------------
-------||||||||----------TK-------|-------------------------------------------T------------------------------------------TT------------U------T--------------------------T#------------t------T-
-------||||||||----------TT-------|-------------------------------------------TT-----------------------------------------TT------------Tt-----TT-------------------------TT------------t-----TTT
-------||||||||--#-------TT-----T-|----k----kkkg--ggggg----gy-----gggg-t----kkTT---yggg-----k------k-ggg--k-k-----b----k-TT-k-T---g----tt---k-TT---kggy---k-k--------kg--T#-----------kt----kkTT
XXXXXXXXXXXXXXXXXXXXXXXXXXXXXXXXXXXXXXXXXXXXXXXXXXXXXXXXXXXXXXXXXXXXXXXXXXXXXXXXXXXXXXXXXXXXXXXXXXXXXXXXXXXXXXXXXXXXXXXXXXXXXXXXXXXXXXXXXXXXXXXXXXXXXXXXXXXXXXXXXXXXXXXXXXXXXXXXXXXXXXXXXXXXXXXX
XXXXXXXXXXXXXXXXXXXXXXXXXXXXXXXXXXXXXXXXXXXXXXXXXXXXXXXXXXXXXXXXXXXXXXXXXXXXXXXXXXXXXXXXXXXXXXXXXXXXXXXXXXXXXXXXXXXXXXXXXXXXXXXXXXXXXXXXXXXXXXXXXXXXXXXXXXXXXXXXXXXXXXXXXXXXXXXXXXXXXXXXXXXXXXXX
