------------------------------------------------------------------------------------------------------------------------------------------------------------------------------------------------
------------------------------------------------------------------------------------------------------------------------------------------------------------------------------------------------
------------------------------------------------------------------------------------------------------------------------------------------------------------------------------------------------
--------------------------------SSSSSSSS----------------------------------------SSSSSSSSSSSSSSSSSSSSSSS-------------------------SSSSSSSSSSSSSSSSSSSSSSSSS---------------------------------------
---------------------------------------------------------------------------------------------------------------------------------S--------------------------------------------o-----------------
-------------------------ooooo------------------------------------------------------------------------------------------------------------------------------------------------------------------
--------%%%%%%%%----------------------------------SS------------SS------------------------------ooor--tSSSo---SSS--SQS---S---S@S------------------------------------Q---------@T---------S-----U
---------||||||--#------------oo-----------------------------------------------------------------%%%%%%-------S---------------------------------------------------------------------------------
---------||||||----------------------------------------------SoS----------------------------------||||-----y--S---------------o-----------------------------------------------o--------------o--
---------||||||-------------------------------------------------oo------------------------------o-||||-----#-----g------------------------------------------------------------------------------
------%%%%%%%%%%----------------------t----------------------SSS---------------------------#------||||----##----SSQ----------US----------------------------#-----------------SS--------------US-
-------||||||||--------tt------------tt---------------------------------------TT----------##------||tt---###-----------------------------B----------------##-----------------------K------K-----
-------||||||||--------tt------------tt---------------------------------------TT---------###------||tt--####-----------------------------B----TT-----t---###------------------------------------
-------||||||||-T------tt---#-------tttk----k-ko---kgg----k-k-----kgggg---k-k-TT------t-####------||tt--####-------gggy---k-k---k-k----k-b----TT-----t---###---#---kk---#---------kk----------k-
XXXXXXXXXXXXXXXXXXXXXXXXXXXXXXXXXXXXXXXXXXXXXXXXXXXXXXXXXXXXXXXXXXXXXXXXXXXXXXXXXXXXXXXXXXXXX-XX-XXXXXXXXXXXX--XXXXXXXXXXXXXXXXXXXXXXXXXXXXXXXXXXXXXXXXXXXXXX-XXXXXXXXXXXXX-XXXXXXXXXXXXXXXXXXXX
XXXXXXXXXXXXXXXXXXXXXXXXXXXXXXXXXXXXXXXXXXXXXXXXXXXXXXXXXXXXXXXXXXXXXXXXXXXXXXXXXXXXXXXXXXXXX-XXXXXXXXXXXXXXX--XXXXXXXXXXXXXXXXXXXXXXXXXXXXXXXXXXXXXXXXXXXXXX-XXXXXXXXXXXXX-XXXXXXXXXXXXXXXXXXXX
