------------------K-----------------------------------------------------------------------------------------------------------------------------------------------------------------------------
------------------------------------------------------------------------------------------------------------------------------------------------------------------------------------------------
------------------------------------------------------------------------------------------------------------------------------------------------------------------------------------------------
-----------------#---------------SSSSS-------SSS-----------------SSS------SSSSSSSSSSSSSSSSSSSSSSSSSSS----SSSSSSS----------SSSSSS---S------SSSSSS----------SS--SS--SSS-----SSSSSS---SS-----SSSSSS
-------------------k--------------------------------------------------------------------------S------SSS-SSS-SS------------S---------SSS-----------------------------S-----S-SS------------S----
-----------------###--------------------------------------------------------------------------S-----SSSS-SSS-SS----------------------SS--S------------------------------------SS----------------
--------%%%%%%%%-------------------------------------------o-U2S-----------o-@S---------------S----S---------SSS-------------SSS--------------SS--------------SS--------------SS--------------SS
---------||||||--------------------------------------------SS-S---K--------S------SSS--------SS--------S-S-S-S---------SS--S-S---------S-SSS-------------S-------------SSS-S-SS--------S---S-SS-
---------||||||------------------------SSSSS------2-------SSSSS-----------SS----ooSSS-S---SS-----------S---SSS---------SS-SS-S-S-------SSSSS-S---------SSSS--S---------SSS-SSSSS-------SSSSSSSSS
---------||||||---------------------------------------------------1-------------SSSSS-S-------S-ooSoSSSSSooSSSSSooooSSSSSSSSSSSSo-ooSSSSSSSSSSSSo--oSSSSSSS--SSSo-ooSSSSSSSSSSSSo-ooSSSSSSSSSSSS
------%%%%%%%%%%----TT--------------------So----%-----%-SSS-----%-----%---------S---------------%%%%%%%%%%---------%%%%-S-----S----%%%%-S-----S----%%%%-S----------%%%%-SS----S----%%%%-SS------
-------||||||||-----TT--------------------SS----|-----|---------|-----|--------------------------||||||||--K--------||-----K--------||--------------||-------K------||-----K--------||-----K----
-------||||||||-----TT------TT------------S-----|-----|--%%%%%%-S-----|-%%%%%%--SSS-------%%----SSS|||||S-----------||--SS----------||---S----------||----------SS--||-SSS------SSS-||-SSS------
-------||||||||-----TT------TT------------------|-----|---||||--------|--||||-------------||-------|||||---r--------||--------------||--------------||--------------||--------------||----------
XXXXXXXXXXXXXXXXXXXXXXXXXXXXXXXX------XX------XX%-%%%-|-%%%%%%--%-%%%%%%%%%%%---%-%%%%%-%%%%%---%-%%%%%%%%%2----%-%%%%--%%---------%%%--------------||----------%-%%%%-------------%||----------
XXXXXXXXXXXXXXXXXXXXXXXXXXXXXXXX------XX----XXXXg-g|g-|-g|g|g---ggg|g|g|ggggg---g--|g|g-g|g|g---g--|||||g|------g--||---||U---------|---------o-----||--------o-g--||--------------|||----------
