------------------------------------------------------------------------------------------------------------------------------------------------------------------------------------------------
------------------------------------------------------------------------------------------------------------------------------------------------------------------------------------------------
------------------------------------------------------------------------------------------------------------------------------------------------------------------------------------------------
------------------------------------------------------------------------------------------------------------------------------------------------------------------------------------------------
------------------------------------------------------------------------------------------------------------------------------------------------------------------------------------------------
------------------------------------------------------------oooo--------------------------------------------------------------------------------------------------------------------------------
--------%%%%%%%%-------------------------------o----------SSSSSS-----------------------------------------SS----U-------------------------------o----Q----------#------------------------oo-----S
---------||||||---------------------------------S--------------------------------------------------------------------#--------------------------------------------------------------------------
---------||||||----------------------------------------------------------------------------------------------oS-----TT-----------------------------------------S--------------------------------
---------||||||---------------------------------------------------------------------------oo------------------------##--------------------------------------------------------------------------
------%%%%%%%%%%------------------------------------------SS---------------------Soo-------------------------@S----------------#----------------------------------------------------------------
-------||||||||--------TT---------------------------------------------------------------------------------------T-------------##----------#------------------------------TT----------t----------
-------||||||||---T----TT-----------------#--##---------t--------------t----------------------------------------T------TTT---###----------#------------------------------TT---------tt-----#----
-------||||||||---Tk---TT----g-g---gg--------###T------Tt---------t----t-------g------------------kggg----k-k---T------TTTT--###--kk-kgg--#--------kgg----k-k-----gggg---TT---------tt----##---#
XXXXXXXXXXXXXXXXXXXXXXXXXXXXXXXXXXXXXXXXXXXXXXXXXXXXXXXXXXXX-XSSX%XXXXXXXXXXXXXXXXXXXXXXX----XXXXXXXXXXXXXXXXXXXXXXXXXXXXXXXXXXXXXXXXXXXXXXXXXXXXXXXXXXXXXXXXXXXXXXXXXXXXXXXXXXXXXXXXXXXXXXXXXXX
XXXXXXXXXXXXXXXXXXXXXXXXXXXXXXXXXXXXXXXXXXXXXXXXXXXXXXXXXXXX----XXXXXXXXXXXXXXXXXXXXXXXXX----XXXXXXXXXXXXXXXXXXXXXXXXXXXXXXXXXXXXXXXXXXXXXXXXXXXXXXXXXXXXXXXXXXXXXXXXXXXXXXXXXXXXXXXXXXXXXXXXXXX
