--------------------------------------------------------------------------------------------------------------------------------------------------------------------------------
--------------------------------------------------------------------------------------------------------------------------------------------------------------------------------
--------------------------------------------------------------------------------------------------------------------------------------------------------------------------------
--------------------------------------------------------------------------------------------------------------------------------------------------------------------------------
---------------------------------------------------------------------------------------------------k----------------------------------------------------------------------------
--------------------------------------------------------------------------------------------------------------------------------------------------------------------------------
---------------------------------------------------------------------------------------@---------------------------------------S------------------------------------------------
-------------------------ooo--------------o-------------oo----------------------------------------------------------------------------------------------------------------------
--------------------------------------------------------S-----------------------------------------------------------------------------------------------------------------------
-------r------SS---------S------------------------------SS------------------------------------------------------------------------------SS--------------------------------------
---%%%%%%%---%%---------------------------------------------------S-------------Q-------QQQQ------@---------------S---------------------S---------2-----------------------------
----|||||----||-------------------------------------tt-----------K----------------------------------tt-------#----------------------tt--------------------------TT--------------
----|||||%%%%%|-----tt-----------------TT-----------tt--------------tt------------------------------tt------##-------------B--------tt--------------tt-----B----TT--TT----------
----|||||-|||-|-----tt--------------y--TT--gg-g-K---tt------------K-tt----------gg--------------K---tt-----####-K----------bg---K---tt-----#----K---tt-----b-#--TT--TT----------
%-%%%%|||%%%%%|-XXXXXXXXXXXXXXXXXXXXXXXXXXXXXXXXXXXXXXXXXXXXXXXXXXXXXXXXXXXXXXXXXXXXXXXXXXXXXXXXXXXXXXXXXXXXXXXXXXXXXXXXXXXXXXXXXXXXXXXXXXXXXXXXXXXXXXXXXXXXXXXXXXXXXXXXXXXXXXXX
g-g|g-|||-g|g-|-XXXXXXXXXXXXXXXXXXXXXXXXXXXXXXXXXXXXXXXXXXXXXXXXXXXXXXXXXXXXXXXXXXXXXXXXXXXXXXXXXXXXXXXXXXXXXXXXXXXXXXXXXXXXXXXXXXXXXXXXXXXXXXXXXXXXXXXXXXXXXXXXXXXXXXXXXXXXXXXX
