------------------------------------------------------------------------------------------------------------------------------------------------------------------------------------------------
------------------------------------------------------------------------------------------------------------------------------------------------------------------------------------------------
------------------------------------------------------------------------------------------------------------------------------------------------------------------------------------------------
-----------------------------------------------------------------------------------------------------------------SSSS------------------------------------------------------------SS-------------
--------------------------------------------------------------------------------------------------------------o---------------------------------------------------------------------------------
---------------------------oo-------------------------------------oo---------------------------------------------------------------o------------------------------------------------------------
--------%%%%%%%%----------%%%------------------------QQQ--------%%%%-------------ooo---oo------o---UQ---------------------------SSSSQ---------------------------Q---QS--------@S----------------
---------||||||------------|-------------------------------------||-----------------------------------------------------------------------------------------------------------------------------
---------||||||------------|-------------------------------------||------------------------------------------Uo------------------------------U--------------------------------o-----------------
---------||||||------------|-------------------------------------||-------------o-------------------------------------------------------------------------------o-------------------------------
------%%%%%%%%%%------%%%%%%%S-------------------------------U---||----------o-------------------------------US-------------------Q----------SS------------------------------US----S-2----------
-------||||||||--------|||||--------------K----------------------||---------------------------------------K---------------------------------------------------------------------TT--------------
-------||||||||--------|||||--------------b----------------------||----B--------------------------------------------------------------------------------------------------------TT-----B--------
-------||||||||--------|||||------gggggg--b-k-k----k--ok----kkk--|gy---b----k-kg----gy------------kggggg--U----------k-k----kkkg---gggy---k-k--------k------kkk---ggggy---k-----TT----kk----kkk-
XXXXXXXXXXXXXXXX-%%%%%%%||X|-%%-XXXXXXXXXXXXXXXXXXXXXXXXXXXXXXXXXXXXXXXXXXXXXXXXXXXXXXXXXXXXXXXXXXXXXXXXXXXXXXXXXXXXXXXXXXXXXXXXXXXXXXXXXXXXXXXXXXXXXXXXXXXXXXXXXXXXXXXXXXXXXXXXXXXXXXXXXXXXXXXX
XXXXXXXXXXXXXXXX--|||||-||-|-||-XXXXXXXXXXXXXXXXXXXXXXXXXXXXXXXXXXXXXXXXXXXXXXXXXXXXXXXXXXXXXXXXXXXXXXXXXXXXXXXXXXXXXXXXXXXXXXXXXXXXXXXXXXXXXXXXXXXXXXXXXXXXXXXXXXXXXXXXXXXXXXXXXXXXXXXXXXXXXXXX
