------------------------------------------------------------------------------------------------------------------------------------------------------------------------------------------------
--------------------------S---------------------------------------------------------------------------------------------------------------------------------------------------------------------
------------------------------------------------------------------------------------------------------------------------------------------------------------------------------------------------
----------------SS---ooo-oSo-SSS----------------SSSSSSSS---------------------------------------------------------SSSSS--------------------------------------------------------------------------
---------------------%%%-------S--------------------------------------------------------------------------------------------------------------o-------------------------------------------------
----------------------|-------------------------------------------------------------------------------------------------------------------------------------------------------------------------
--------%%%%%%%%------|---oooo---------Q-----------------SSSS---SSSSQS-------------------------U----Q----------U----------------QSo@QSSSSS---S@S----------------@SoS@S--------------------------
---------||||||-------|-------------------------------------------------------------------------------------------------------------------------------------------------------------------------
---------||||||-------|---SSSS-S----------------------------------------------o-------------------------------oo------------------------------oo------------------------------o-----------------
---------||||||-------So--SSSSS-------------------------------------------------------------------------------------------------o---------------------------------------------------------------
------%%%%%%%%%%----------SSSSS--------------o--------tt--------------------S@S------------------------------US------------------------------US-----------------SSQ----------US-----------------
-------||||||||---------------------------------------tt-----Tt---------------------------K---------------K----------------------------------------------@----K---------------------------K-----
-------||||||||---------------------------------%-----tt-----TT------------------------------------------------------t-----------------------------------T----TT--------------------------b-----
-------||||||||-------------------kk-k-k----kkk-|-----tt---k-gTg---kgggg--k-------kkoy--------k----ggggg--b----------t------k-k----gggy---k-------yg-gggtt--k-TT--ggggy---k-k-----kk-gg-----kkkT
XXXXXXXXXXXXXXXX-----%-----X----XXXXXXXXXXXXXXXXXXXXXXXXXXXXXXXXXXXXXXXXXXXXXXXXXXXXXXXXXXXXXXXXXXXXXXXXXXXXXXXXXXXXXXXXXXXXXXXXXXXXXXXXXXXXXXXXXXXXXXXXXXXXXXXXXXXXXXXXXXXXXXXXXXXXXXXXXXXXXXXX
XXXXXXXXXXXXXXXX-----|---------XXXXXXXXXXXXXXXXXXXXXXXXXXXXXXXXXXXXXXXXXXXXXXXXXXXXXXXXXXXXXXXXXXXXXXXXXXXXXXXXXXXXXXXXXXXXXXXXXXXXXXXXXXXXXXXXXXXXXXXXXXXXXXXXXXXXXXXXXXXXXXXXXXXXXXXXXXXXXXXXX
