------------------------------------------------------------------------------------------------------------------------------------------------------------------------------------------------
------------------------------------------------------------------------------------------------------------------------------------------------------------------------------------------------
------------------------------------------------------------------------------------------------------------------------------------------------------------------------------------------------
--------------------------------SSSSSSSS--------SSSSSSSSSS------SSSS-----------------------------------------------S-SSSSSS--------------------------------------SSSSSS-------------------------
------------------------------------------------------------------------------------------------------------------------------------------------------------------------------------------------
---------------------------------------------------------------------------------------------------------------------------------------------------------------------------------ooo------------
--------%%%%%%%%-------------------------------------------oo-----------------------------------SSoSSSSS-----SSS--o---------------ooS--------SSS--ooS---------So-o--------------%%--------------
---------||||||-----------------------------------------------------------------------------------------------------------------------------------------------------------------||--------------
---------||||||-----------------------------------------------------------------------------------------------------------------------------------------------------------------||--------------
---------||||||----------------------------------------o--------------------------------------------------------o---------------o---------------o-------------------------------||--------------
------%%%%%%%%%%-----2----------------------------------------------------------------------------------------------------------S-----------------------------------------------||--------------
-------||||||||---------TTT----------------------------K------------------K---------------K---------------------------------------------------------------#--------------TT-----||--------------
-------||||||||---------TTT----------tt----------------------TT---------------------------b--------------------------B-----------------------------------##--------------TT-----||-----TT-----TT
-------||||||||---g-----TTT----g-g---tt-----k-k---y--------k-TT---k--b--------gg------gg------ko----ggg-#-k--------k-b------k-k-----gggg###--------k--gg###-----------kk-TT---k-||ggg--TT---k-TT
XXXXXXXXXXXXXXXXXXXXXXXXXXXXXXXXXXXXXXXXXXXXXXXXXXXXXXXXXXXXXXXXXXXXXXXXXXXXXXXXXXXXXXXXXXXXXXXXXXXXXXXXXXXXXXXXXXXXXXXXXXXXXXXXXXXXXXXXXXXXXXXXXXXXXXXXXXXXXXXXXXXXXXXXXXXXXXXXXXXXXXXXXXXXXXXX
XXXXXXXXXXXXXXXXXXXXXXXXXXXXXXXXXXXXXXXXXXXXXXXXXXXXXXXXXXXXXXXXXXXXXXXXXXXXXXXXXXXXXXXXXXXXXXXXXXXXXXXXXXXXXXXXXXXXXXXXXXXXXXXXXXXXXXXXXXXXXXXXXXXXXXXXXXXXXXXXXXXXXXXXXXXXXXXXXXXXXXXXXXXXXXXX
