------------------------------------------------------------------------------------------------------------------------------------------------------------------------------------------------
-----------------K------------------------------------------------------------------------------------------------------------------------------------------------------------------------------
------------------------------------------------------------------------------------------------------------------------------------------------------------------------------------------------
------------------------------------------------SSSSSSSS--------SSSSSSSS-SS---------------------SSSSSSSSSSSSSS--SSSSSSSSS---------------------------------------SSSSSSSS------------------------
----------------------------------------------------------------------------------------------o-------------------------------------------------------------------------------------------------
------------------------------------------------------------------------------------------------------------------------------------------------------------------------------------------------
--------%%%%%%%%--------------------QQQQQS-----o--------------------------------SSS@QSSSSS---SSS-----------------------------------QQQ--o----S@S@S-S@SQ-----------------------------Q---------oS
---------||||||---------------------------------------------------------------------------------------------------------------------------------------------------------------------------------
---------||||||------------------------------ooo-------------------------------------------------------------------------------------------------------------Uo----------------------------#----
---------||||||------g---------------------------------------------------------------------------oo------------------------------------------------------------------------------o---------#----
------%%%%%%%%%%S-SSSSSS-SS-----####-QQQQ---SSS---------------------------------QQQ-Q--------USS--------------------------------#-Q-------------SS-----------@S----------------------------#----
-------||||||||-S---------------####---------------------------------------------------------------------TT---K--------------------------------------------------------------------------##-----
-------||||||||-S---------------####--------------B-----------TT-----B-----------------------------------TT---------------#-------------##----------------------------------------------####----
-------||||||||-S---------g--#--####-kk----kk-----b----k-#----TT-----b-k------k----kggy---k----------gg--TT-k------k--k---#----g---k--k###k-------gggggg--k-k----------------ggg---kggg#####----
XXXXXXXXXXXXXXXXXXXXXXXXXXXXXXXXXXXXXXXXXXXXXXXXXXXXXXXXXXXXXXXXXXXXXXXXXXXXXXXXXXXXXXXXXXXXXXXXXXXXXXXXXXXXXXXXXXXXXXXXXXXXXXXXXXXXXXXXXXX-XXXXXXXXXXXXXXXXXXXXXXXXXXXXXXXXXXXXXXXXXXXXXXXXXXXX
XXXXXXXXXXXXXXXXXXXXXXXXXXXXXXXXXXXXXXXXXXXXXXXXXXXXXXXXXXXXXXXXXXXXXXXXXXXXXXXXXXXXXXXXXXXXXXXXXXXXXXXXXXXXXXXXXXXXXXXXXXXXXXXXXXXXXXXXXXX-XXXXXXXXXXXXXXXXXXXXXXXXXXXXXXXXXXXXXXXXXXXXXXXXXXXX
