------------------------------------------------------------------------------------------------------------------------------------------------------------------------------------------------
-------------------------------------------------------------------------------------------------K----------------------------------------------------------------------------------------------
------------------------------------------------------------------------------------------------------------------------------------------------------------------------------------------------
----------------------------------------------------------------SSS----------------------------------------------------------------------------------------------SS-----------------------------
------------------------------------------------------------------------------------------------------------------------------------------------------------------------------------------------
------------------------------------------------------------------------------------------------------------------------------------------------------------------------------------------------
--------%%%%%%%%-----------------------------------------------o---------------o--SQQSSS-----S---------------------------------o%---Q------------SSSoS--------------------------SSSSQSQ---------
---------||||||-S-------------oo------------------------------------------------------------------------------------------------|---------------------------------------------------------------
---------||||||-----#------------------------o----------------S--------------------------------------------------------------oS-|----------------------------K-------------------------------oo-
---------||||||-----#-----------------------------------------------------------------------------------------------------------|---------------------------------------------------------------
------%%%%%%%%%%---------------#-------------@----------------------------------Q-QQ---------US-----SS-------U---------------U--SSQ----------@S----------------------2----------SSQ----------@S-
-------||||||||---------------##----------K---------------K---K------------------------------------------TT---------------------------------------------------K---------------------------------
-------||||||||---------------##-------------------------------------------------------------------------TT-------------------------------------------------------------TT----------------------
-------||||||||--------#--g-####--kkokkk--k-k-k---gk-kg-----k-k--------k-----g-g---g--k---k-k------kgg---TT-------gk-gg---k-k-----gggggg----k------kgggg--k-k-----#-----TT--------ggggy---k-k---
XXXXXXXXXXXXXXXXXXXXXXXXXXXXXXXXXXXXXXXXXXXXXXXXXXXXXXXXXXXXXXXXXXXXXXXXXXXXXXXXXXXXXXXXXXX-XXXXXXXXXXXXXXXXXXXXXXXXXXXXXXXXXXXXXXXXXXXXXXXXXXXXXXXXXXXXXXXXXXXXXXXXXXXXXXXXXXXXXXXXXXXXXXXXXXXX
XXXXXXXXXXXXXXXXXXXXXXXXXXXXXXXXXXXXXXXXXXXXXXXXXXXXXXXXXXXXXXXXXXXXXXXXXXXXXXXXXXXXXXXXXXX-XXXXXXXXXXXXXXXXXXXXXXXXXXXXXXXXXXXXXXXXXXXXXXXXXXXXXXXXXXXXXXXXXXXXXXXXXXXXXXXXXXXXXXXXXXXXXXXXXXXX
