------------------------------------------------------------------------------------------------------------------------------------------------------------------------------------------------
------------------------------------------------------------------------------------------------------------------------------------------------------------------------------------------------
------------------------------------------------------------------------------------------------------------------------------------------------------------------------------------------------
--------------------------------------------------------------------------------------------------------------------------------------------------------------------------------SSSSSS----------
------------------------------------------------------------------------------------------------------------------------------------------------------------------------------------------------
---------------------------------------------------o------------------------------------------------------------------------------------------------------------Q-------------------------------
--------%%%%%%%%-----------------%-----------------SQQQ------------------------U---------------U-----------------S-SQQQQ--------------------------------------------QQQ-------------------------
---------||||||------------------|--------------------------------------------------------------------------------------------------------------------------------------------------------------
---------||||||------------------|--------------------------------------------------------------------------------------------o-----------------------------------------------------------------
---------||||||------------------|-----------------------------------------------o-------------------------------g------------------------------------------------------------------------------
------%%%%%%%%%%SS-----------@S--|---------------------------U---------------oo----------------------------------2Q----------US----------------------------------SQS---------U--TT--------------
-------||||||||------------------|----------------------------------------K---------------K--------------TT----------------------------------------------TT---------------------TT-----tt-----K-
-------||||||||------------------|-----------------------------------------------------------------------TT---------------------------------------B------TT---------------------TT-----tt-------
-------||||||||----kgg-----------|kk---k----kkkg---ggggg--k-k-----gggg-b--k---kg--ggggg-----k-k---gggggg-TT---k---ggggy---k-k-----------------kg--bgggg--TT---k------ky---k-k---TT-----tt---k---
XXXXXXXXXXXXXXXXXXXXXXXXXXXXXXXXXXXXXXXXXXXXXXXXXXXXXXXXXXXXXXXXXXXXXXXXXXXXXXXXXXXXXXXXXXXXXXXXXXXXXXXXXXXXXXXXXXXXXXXXXXXXXXXXXXXXXXXXXXXXXXXXXXXXXXXXXXXXXXXXXXXXXXXXXXXXXXXXXXXXXXXXXXXXXXXX
XXXXXXXXXXXXXXXXXXXXXXXXXXXXXXXXXXXXXXXXXXXXXXXXXXXXXXXXXXXXXXXXXXXXXXXXXXXXXXXXXXXXXXXXXXXXXXXXXXXXXXXXXXXXXXXXXXXXXXXXXXXXXXXXXXXXXXXXXXXXXXXXXXXXXXXXXXXXXXXXXXXXXXXXXXXXXXXXXXXXXXXXXXXXXXXX
