-----------------------K------------------------------------------------------------------------------------------------------------------------------------------------------------------------
-----------------------o------------------------------------------------------------------------------------------------------------------------------------------------------------------------
-----------------------S------------------------------------------------------------------------------------------------------------------------------------------------------------------------
--------------------------------SSSSSSSSSS---S--------------------------------------------------------------------------------------------------SSSSSSSS--------SSS-----------------------------
-----------------------------------------------------------------------------------------------------------------------------------------------------------------------------------------------o
--------------------------------------------------------------------------@---------------------------------------------------------------------------------------------------------------------
--------%%%%%%%%------------------------o----------------------------SSS-----S---SSoo------------------------------------------o----Q---------SS------------------------------------QQQ---------
---------||||||---o-o--o-----------------------------------------------------K------------------------------------------------------------------------------------------------------------------
---------||||||--%%%%%%%%---------------------------------------------------------------------o-------------------------------------------------------------------------------------------------
---------||||||---||||||---o--------------------------------------------------------------------------------------------------------------------------------------------------------------------
------%%%%%%%%%%--||||||--%%----%%-------------------------------SQoS--USS-------------------@S-----------#---------------------------------------------------------------##--------------------
-------||||||||---||||||--||----||-----------------------B-------------##--------------------------------##---------------K--------------#-------------t------K----------###--------------------
-------||||||||---||||||--||-Ko-||---t------------B-----tt----TT------###-------------------------------###---------------b-------------##-------#-----t-----------------###--TT----------------
-------||||||||---||||||--||----||---t-----ggg----b----ktt----TT------#-k----------kgg----k-k-------ggg#####------kggggg--b---------gg#-#-k------T-----t----kkk---k-----####--TT---kgggg--kkkkk-
XXXXXXXXXXXXXXXX--||||||--%%%%%%XXXXXXXXXXXXXXXXXXXXXXXXXXXXXXXX-XXXXXXXX----XXXXXXXXXXXXXXXXXXXXXXXXXXXXXXXXXXXXXXXXXXXXXXXXXXXXXXXXXXXXXXXXXXXXXXXXXXXXXXXXXXXXXXXXXXXXXXXXXXXXXXXXXXXXXXXXXXX
XXXXXXXXXXXXXXXX--||||||---||||-XXXXXXXXXXXXXXXXXXXXXXXXXXXXXXXX-XXXXXXXX----XXXXXXXXXXXXXXXXXXXXXXXXXXXXXXXXXXXXXXXXXXXXXXXXXXXXXXXXXXXXXXXXXXXXXXXXXXXXXXXXXXXXXXXXXXXXXXXX-XXXXXXXXXXXXXXXXXX
