------------------------------------------------------------------------------------------------------------------------------------------------------------------------------------------------
------------------------------------------------------------------------------------------------------------------------------------------------------------------------------------------------
------------------------------------------------------------------------------------------------------------------------------------------------------------------------------------------------
-------------------------------------------------SS---SS------------------------------------------------------------------------SSS---SS--------------------------------------------------------
------------------------------------------------------------------------------------------------------------------------------------------------------------------------------------------------
------------------------------------------------------------------------------------------------------------------------------------------------------------------------------------------------
--------%%%%%%%%---------------U-------Q-------o--------------------QQQQQS-----------------------o----SQo---------------o------o-------oo--------------------------Q----o--------oo------S-----o
---------||||||---------------------------------------------------------------------------------------------------------------------------------------------------------------------------------
---------||||||--------------o---------------S-------------------------------------------------------------------------------------------------------------------------------KS--------------oS-
---------||||||----------------------------------------------------------------------------------------o--------------------------gg-------------------------------g-ggg------------------------
------%%%%%%%%%%-------------@S-#-#--#S##---SS---------#---------###-SQQQ---SQS-----------------------QQQ---SU---------------U----###-##Q------------------------#######Q----SS--------------@--
-------||||||||-----------------###--------------------#---------###--------------------------------------------------------------##-----------------------------###----------------------------
-------||||||||--------K--------#####------------------#---------##--------------------------------------------------------------###----------------------------###-----------------------------
-------||||||||---gy---k--k-----#####k----k-k---k------#------g--##k--------k-----#---------k--------k------k-----gk-gg-----k---###k--k----kk-----g-----------g-###k------k-k-----gggy----k-k---
XXXXXXXXXXXXXXXXXXXXXXXXXXXXXXXXXXXXXXXXXXXXXXXXXXXXXXXXXXXXXXXXXXXXXXXXXXXXXXXXXXXXXXXXXXXXXXXXXXXXXXXXXXXXXXXXXXXXXXXXXXXXXXXXXXXXXXXXXXXXXXXXXXXXXXXXXXXXXXXXXXXXXXXXXXXXXXXXXXXXXXXXXXXXXXXX
XXXXXXXXXXXXXXXXXXXXXXXXXXXXXXXXXXXXXXXXXXXXXXXXXXXXXXXXXXXXXXXXXXXXXXXXXXXXXXXXXXXXXXXXXXXXXXXXXXXXXXXXXXXXXXXXXXXXXXXXXXXXXXXXXXXXXXXXXXXXXXXXXXXXXXXXXXXXXXXXXXXXXXXXXXXXXXXXXXXXXXXXXXXXXXXX
