------------------------------------------------------------------------------------------------------------------------------------------------------------------------------------------------
------------------------------------------------------------------------------------------------------------------------------------------------------------------------------------------------
------------------------------------------------------------------------------------------------------------------------------------------------------------------------------------------------
------------------------------------------------SSSSSSSSSSS--S----------------------SSSSSS----------------------SSSSSSSS----------------------------------------SSSSSSSS------------------------
--------------------------------------------------------------------------------------------------------------------------------------------------------------oo-------------------------------o
------------------------------------------------------------------------------------------------------------------------------------------------------------------------------------------------
--------%%%%%%%%-------------------------------U------SSSSSSSSSS-----------------ooo-----------o--------------So--------------------------------SSSS@SS-------@---------------------------------
---------||||||-S-------------------------------------------------------------------------------------------------------------------------------------------------------------------------------
---------||||||-------------------------------S---------------------------------------------------------------o-----------------------------------------------o---------------------------------
---------||||||---------------------------------o-------------------------------o---------------------------------------------------------------g-----------------------------------------------
------%%%%%%%%%%--------------------------------S-------------SS-------------@--------------------------------S---------------------------------#-------------S---------------------------------
-------||||||||-------------------------------------------------------------------------------------------K-------------------------------#-----------------------------------------------------
-------||||||||--------tt-----------------------------------------------------------tt--------------------#----------S-------------------##-----------------------------------------------------
-------||||||||--------tt----g-g--kk-k------kggg----g-----#-------gggggg----kkkg----tt------k------kgg----#--------------------#------gg###--------kgggg--k----------g-k------gg--gggggg----kkk-
XXXXXXXXXXXXXXXXXXXXXXXXXXXXXXXXXXXXXXXXXXXXXXXXXXXXXXXXXXXXXXXXXXXXXXXXXXXXXXXXXXXXXXXXXXXXXXXXXXXXXXXXXXXXXXXXXXXXXXXXXXXXXXXXXXXXXXXXXXXXXXXXXXXXXXXXXXXXXXXXXXXXXXXXXXXXXXXXXXXXXXXXXXXXXXXX
XXXXXXXXXXXXXXXXXXXXXXXXXXXXXXXXXXXXXXXXXXXXXXXXXXXXXXXXXXXXXXXXXXXXXXXXXXXXXXXXXXXXXXXXXXXXXXXXXXXXXXXXXXXXXXXXXXXXXXXXXXXXXXXXXXXXXXXXXXXXXXXXXXXXXXXXXXXXXXXXXXXXXXXXXXXXXXXXXXXXXXXXXXXXXXXX
