------------------------------------------------------------------------------------------------------------------------------------------------------------------------------------------------
------------------------------------------------------------------------------------------------------------------------------------------------------------------------------------------------
------------------------------------------------------------------------------------------------------------------------------------------------------------------------------------------------
------------------------------------------------SSS-----------------------------------------------------------------------------SSSSSSSSSSSSSSSS--------------------------------SSSSSSSSSSSSSSSS
--------------------------------------------------------------------------------------------------------------------------------------------------------------------------------SS---SS---------
-----------------------------------------------------------------------------------------------------------------------------------------------S------------------------------------------------
--------%%%%%%%%---------------------------------------------------SQSSS-------S--------------------Q----------o-----------------------------SSS----------------SSSSQSQS-----------------------o
---------||||||--o--------##--------------------------------------------------------------------------------------------------------------------------------------------------------------------
---------||||||----------###--------o-----------------------------------------------------------------------------------------------------------------------------------------------------------
---------||||||----------###--------#------------------------------------------o--------------------------------------------------------------------------------------------------o-------------
------%%%%%%%%%%---------###---------2---------------------------------U-----USS-----------------------------U-------2------------------------------------------@SQ----SSS--S@S-----------------
-------||||||||---TT----###----------------------------SS------------------------------------------------------------------------------K--------------------------------------------------------
-------||||||||---TT--######-----------tt------------------------------------------------TT-----------------------------------------------------------------------------------------------------
-------||||||||---TT--######-----------tt----kk---kk--------kggg---kgg----k-------b----k-TT---gg---kggg---k-k-----kk-ggy----kkk------k-k---gk-----kkggg---g---kg--ggggy---k-k---%-g----k-g----k-
XXXXXXXXXXXXXXXXXXXXXXXXXXX-XXXXXXXXXXXXXXXXXXXXXXXXXXXXXXXXXXXXXXXXXXXXXXXXXXXXXXXXXXXXXXXXXXXXXXXXXXXXXXXXXXXXXXXXXXXXXXXXXXXXXXXXXXXXXXXXXXXXXXXXXXXXXXXXXXXXXXXXXXXXXXXXXXXXXXXXXXXXXXXXXXXX
XXXXXXXXXXXXXXXXXXXXXXXXXXX--XXXXXXXXXXXXXXXXXXXXXXXXXXXXXXXXXXXXXXXXXXXXXXXXXXXXXXXXXXXXXXXXXXXXXXXXXXXXXXXXXXXXXXXXXXXXXXXXXXXXXXXXXXXXXXXXXXXXXXXXXXXXXXXXXXXXXXXXXXXXXXXXXXXXXXXXXXXXXXXXXXX
