------------------------------------------------------------------------------------------------------------------------------------------------------------------------------------------------
------------------------------------------------------------------------------------------------------------------------------------------------------------------------------------------------
------------------------------------------------------------------------------------------------------------------------------------------------------------------------------------------------
------------------------------------------------------------------------------------------------------------------------------------------------SSSSSS--------------------------SSSSS-----------
------------------------------------------------------------------------------------------------------------------------------------------------------------------------------------------------
------------------------------------------------------------------------------------------------------------------------------------------------------------------------------------------------
--------%%%%%%%%--------------SS---------------------------------%%-----------------QQ---------U--------------------Q-----------SSSSSSQ-----------------------------QQ-------------------------o
---------||||||--------------------------------------------------||-----------------------------------------------------------------------------------------------------------------------------
---------||||||--------------------------------------------------||--------------------------oo-------------------------------o----------------------------------------------oo-----------------
---------||||||-----o--------------------------------------------||--------------@--------------------------------------------------------------------------------------------------------------
------%%%%%%%%%%----S--------------------------------------------||----------o---2----------S@S------------------##----------US--SQ-USSS-----@S------------------2---------SS@S-----------------
-------||||||||---------------------------#---------------K------||----t------------------K-----------------------------------------------------------------------------------------------------
-------||||||||----------------------B----#----------------------||----t--------------------------------------TT--------------------------------------------------------------------------------
-------||||||||-----------#-k--------go--##-------gk---#----k----||----t-----g-g--gggggg--k-------kk---k------kT---k--gg--k-------ggggy---k-k-----b----k------kT--gggggg--k-----T----kkk----k---
XXXXXXXXXXXXXXXXXXXXXXXXXXXXXXXXXXXXXXXXXXXXXXXXXXXXXXXXXXXXXXXXXXXXXXXXXXXXXXXXXXXXXXXXXXXXXXXXXXXXXXXXXXXXXXXXXXXXXXXXXXXXXXXXXXXXXXXXXXXXXXXXXXXXXXXXXXXXXXXXXXXXXXXXXXXXXXXXXXXXXXXXXXXXXXXX
XXXXXXXXXXXXXXXXXXXXXXXXXXXXXXXXXXXXXXXXXXXXXXXXXXXXXXXXXXXXXXXXXXX-XXXXXXXXXXXXXXXXXXXXXXXXXXXXXXXXXXXXXXXXXXXXXXXXXXXXXXXXXXXXXXXXXXXXXXXXXXXXXXXXXXXXXXXXXXXXXXXXXXXXXXXXXXXXXXXXXXXXXXXXXXXX
