------------------------------------------------------------------------------------------------------------------------------------------------------------------------------------------------
------------------------------------------------------------------------------------------------------------------------------------------------------------------------------------------------
------------------------------------------------------------------------------------------------------------------------------------------------------------------------------------------------
----------------------------------------------------------------------------------------------------------------------------------------------------------------SSSSSSSS-SSS--------------------
------------------------------------------------------------------------------------------------------------------------------------------------------------------------------------------------
------------------------------------------------------------------------------------------------------------------------------------------------------------------------------------------------
--------%%%%%%%%--o-----oo-----S-------oo---------------oo-----o--------oo------------QQQS------------SSS----SSS-------oo------o-------QQ--------oo---SSSSS----S-----------------------oo------o
---------||||||---------------------------------------------------------------------------------------------------------------------------------------oo----------------------------------------
---------||||||---------------------------------------------------------------------------------------------------------------------------------------------------------------------------------
---------||||||---------------------------------oo-------------------------------------k--------------------------g-------------------------S---------------------------------------ggg---------
------%%%%%%%%%%------------------#-------------S-----------------#---o------o----##--QQQ---SQ-------------------###--Q------SS--------#---------------------S----#---------------######--------
-------||||||||------------------##---tt-------------------------##-------------####-----------------------------###--------------#------------------------------##-------------TT####----------
-------||||||||------#----------###---tt------------------------####------------####-----------------------------##-------------###----------K-------------------##-------------TT##------------
-------||||||||---gg-#----------###---tt---kk------kgy---------g####------------####-------k--------g--------k--###k--kk---kk---###--------k-k------gy-----------##--------kkkg-TT----------g---
XXXXXXXXXXXXXXXXXXXXXXXXXXXXXXXXXXXXXXXXXXXXXXXXXXXXXXXXXXXXXXXXXXXXXXXXXXXXXXXXXXXXXXXXXXXXXXXXXXXXXXXXXXXXXXXXXXXXXXXXXXXXXXXXXXXXXXXXXXXXXXXXXXXXXXXXXXXXXXXXXXXXXXXXXXXXXXXXXXXX-XXXXXXXXXXX
XXXXXXXXXXXXXXXXXXXXXXXXXXXXXXXXXXXXXXXXXXXXXXXXXXXXXXXXXXXXXXXXXXXXXXXXXXXXXXXXXXXX-XXXXXXXXXXXXXXXXXXXXXXXXXXXXXXXXXXXXXXXXXXXXXXXXXXXXXXXXXXXXXXXXXXXXXXXXXXXXXXXXXXXXXXXXXXXXXXXXXXXXXXXXXXX
