--------------------------------------------------------------------------------------------------------------------------------------------------------------------------------
---------------------------------------------K----------------------------------------------------------------------------------------------------------------------------------
--------------------------------------------------------------------------------------------------------------------------------------------------------------------------------
-----------------------------------------------------------S------------------------------@-------------------------------SSSS-S-------------------------------S----------------
-----------------------------------------------------------------------------------------------------------------------------K--------------------------------------------------
--------------------------------------------------------------------------------------------------------------------------------------------------------------------------------
-----------------------------------------------------------S--SS--------------SS--------------SS--------------S%-----------S-SSS--------------SS--------------SS-----------S--S%
--o-------------------------------------------U---K------------------------------------------------------------o----------S-----------------------------------------------S----|
-----#--------------------------------------------------S--------------SSSSS-SSS--------SSSS-----------SSSS---SS-------SSS-------------SSSS--SSS-------SS-----S--------SSS-----|
-----#------------oo------SS------g----SSS----1----o--Sr--o-------ooSS--SSSS--SSo-SoSSS--------S---o--------------------SSS---S----oS---SSS---S-K-------SS---------------------|
------------------------------#---%-%%-%%%%-----%%%%%%%%%%----------%-----------%%%%%%%------------@%------------%%%%%%-SS---------@%---S-----------%---S---------------S-----K|
T----------------K------------#---|-||--||-------||||||||--------K--|-----S------|||||--------------|----U--------||||---U----------|----U----------|----U---------------U-----|
T--------TT----T--------------#---|-||--||------S||||||||%%%-----SS-|-----%-----S|||||---%%%--------|---SS%-------||||---%%%%%%-----|---S%%%--------|----%%%%%-----------%%%%--|
T--------TT----T--------------#-K-|-||--||-y-----||||||||-|---------|-----|------|||||----|---------|-----|-------||||----||||------|-----|---------|-----|||-------------||---|
XXXXXXXXXXXXXXXX-----------2XXXX--|-||--XXXXXXX-%|%%%%%%%%%%--------|-----|---X-%|%%%%----|---------|-----|--XX-%-%%%|----||||------|-----|---------|-----|||---%---------||-XX|
XXXXXXXXXXXXXXXX----------XXXXXX--|-|X--XXXXXXX-g|-|||||gg|---------|-----|---X-g|-||-----|---------|-----|--XX-g--|-|----||||------|-----|---X-----|-----|||-X-g---------||-XX|
