------------------------------------------------------------------------------------------------------------------------------------------------------------------------------------------------
------------------------------------------------------------------------------------------------------------------------------------------------------------------------------------------------
------------------------------------------------------------------------------------------------------------------------------------------------------------------------------------------------
------------------------------------------------------------------------------------------------------------------------------------------------SSSS--------------------------------------------
-----------------------------------------------------------------------------------------------------------------------------------------------------------------------------U-o----------------
------------------------------------------------------------------o-----------------------------------------------------------------------------------------------------------------------------
--------%%%%%%%%S------------------------------------------------%%%-----------U---------------U------------------SUQQQQ-------#---UQ----------U----------------%-%SSS--------------------------
---------||||||---------------------------------------------------|---------------------------------------------------------------------------------------------|-|-----------------------------
---------||||||---------------------------------------------------|----------------------------------------------------------S---------------oo-----------------|-|----------U---------------K--
---------||||||---------------------------------------------------|--------------o------------------------------------------------------------------------------|-|-----------------------------
------%%%%%%%%%%-SSoSSSS-S---------###----------------------------|----------U---------------oS------------------------------US-------------S@S-----------------|-|----------U2--------------U--
-------||||||||---------------K----------TT--------------TT-------|-----------------------------------------------------------------------K---------------------|-|-----------K-----------------
-------||||||||--------------------------TT-------TT-----TT-------|-----------------------------------------------------------------------------------tt--------|-|-----------------------------
-------||||||||----k-k----U-k------------TT---#---TT-----TT------g|---------kkkg--ggg--k-------g--ggggok----kk-----k-ky---k-k------ggggg--k-------k---tt------kg|-gggggg--k-k------k-kgy--k-kkk-
XXXXXXXXXXXXXXXXXXXXXXXXXXXXXXXXXXXXXXXXXXXXXXXXXXXXXXXXXXXXXX--XXXXXXXXXXXXXXXXXXXXXXXXXXXXXXXXXXXXXXXXXXXXXXXXXXXXXXXXXXXXXXXXXXXXXXXXXXXXXXXXXXXXXXXXXXXXXXXXXXXXXXXXXXXXXXXXXXXXXXXXXXXXXXXX
XXXXXXXXXXXXXXXXXXXXXXXXXXXXXXXXXXXXXXXXXXXXXXXXXXXXXXXXXXXXXX--XXXXXXXXXXXXXXXXXXXXXXXXXXXXXXXXXXXXXXXXXXXXXXXXXXXXXXXXXXXXXXXXXXXXXXXXXXXXXXXXXXXXXXXXXXXXXXXXXXXXXXXXXXXXXXXXXXXXXXXXXXXXXXXX
