------------------------------------------------------------------------------------------------------------------------------------------------------------------------------------------------
------------------------------------------------------------------------------------------------------------------------------------------------------------------------------------------------
------------------------------------------------------------------------------------------------------------------------------------------------------------------------------------------------
---------------------------------SSSSSSS--------SSSSSS------------------------------------------S-----SS-SS-----SSSS--------------------------------------------SS------------------------------
------------------------------------------------------------------------------------------------------------------------------------------------------------------------------------------------
------------------------------------------------------------------------------------------------------------------------------------------------------------------------------------------------
--------%%%%%%%%--------------------------------------%%%%S------------------------------------------------------------------------------------------------------------oo-----------------------
---------||||||----------------------------------------||--------o---ooo---o--------------------------------------------------------------------------------------------------------------------
---------||||||------------##--------------------------||-----------------%%%-------------------------------#-----------------------------------------------------------------------------------
---------||||||-----------###--------------------------||------------------|----o----------#---------------##-----------------------------------------------------------------------------------
------%%%%%%%%%%---------####--------------------------||------------------|---------------#--------------###----------------------------------------------------------------o------------------
-------||||||||--##------####-----------##------------t||------------------|---------------#-------------####----------------------------------#---------------o-#----tt-----------------TT-----
-------||||||||--##-----#####----------###----TT-----tt||------------------|---#-----t---###------------####---------------------------###-----#-----------------#----tt----------B------TT-----
-------||||||||-#####-#######-----b--#####-##kTT-----tt||--------------o--t|---#-----t---###-----------#####---------b--------gg------####-----#-------##------kTT---ktk----kkk---b------TT---gg
XXXXXXXXXXXXXXXXXXXXXXXXXXXXXXXXXXXXXXXXXXXXXXXX---XXXXXXXXXXXXXX%X%XXXX%XXXXXXX-XXXXXXXXXXXXX-XXXXXXXXXXXXXX---XXXXXXXXXXXXXXXX--XXXXXXXX---%%-XXXXXXXXXXXXXXXXXXXXXXXXXXXXXXXXXXXXXXXXXXXXXXXX
XXXXXXXXXXXXXXXXXXXXXXXXXXXXXXXXXXXXXXXXXXXXXXXX---XXXXXXXXXXXXXXXXXXXXXXXXXXXXXXXXXXXXXXXXXXX--XXXXXXXXXXXXX--XXXXXXXXXXXXXXXXX--XXXXXXXX---||-XXXXXXXXXXX-XXXXXXXXXXXXXXXXXXXXXXXXXXXXXXXXXXXX
