------------------------------------------------------------------------------------------------------------------------------------------------------------------------------------------------
------------------------------------------------------------------------------------------------------------------------------------------------------------------------------------------------
------------------------------------------------------------------------------------------------------------------------------------------------------------------------------------------------
---------------------------------S-----------------------------------------------------------------------------------------------SS-----------------------------------------------K-------------
--------------------------------------------------------------------------------------------------------------oo---------------o----------------------------------------------------------------
------------------------oo---------------------------------------o------------------------------------------------------------------------------------------------------------------------------
--------%%%%%%%%-----------------------------------SQSQQS----SSS------------------------------------QQQS------------Q----------o---------------------oS---------SQSSQSQSQ----U------------------
---------||||||---------------------------------------------------------------------------------------------------------------------------------------------------------------------------------
---------||||||---------------------------------------------------------------------------------------------------------------------------------------------------------------------------------
---------||||||--------------------------------------------------------------------------------------------------------------------------------------------------g----------------o-------------
------%%%%%%%%%%--TT-----------------------------------SS---SUS------2-------------------------------------------------------------------------------------------SQ----S-----USS----------------
-------||||||||---TT----TT----------------------------------------------TT---------------TT---------------------------------------------TT------------------------------------------------------
-------||||||||---TT----TT------------tt--------------------------------TT----U----------TT---------------------------------------------TT----------------------------------------------TT------
-------||||||||---TT----TT--------k---tt-----gkg--gggggg--k-k----ggg-g--TT----yg--kggggg-TT---k---gggggg----k-k----kgggg--k-k-----g-----TT----gg---kggk-----kkk----k-ky---k-k----gg-----TT--k-yg
XXXXXXXXXXXXXXXXXXXX--XXXXXXXXXXXXXXXXXXXXXXXXXXXXXXXXXXXXXXXXXXXXXXXXXXXXXXXXXXXXXXXXXXXXXXXXXXXXXXXXXXXXXXXXXXXXXXXXXXXXXXXXXXXXXXXXXXXXXXXXXXXXXXXXXXXXXXXXXXXXXXXXXXXXXXXXXXXXXXXXXXXXXXXXXX
XXXXXXXXXXXXXXXXXXXXXXXXXXXXXX-XXXXXXXXXXXXXXXXXXXXXXXXXXXXXXXXXXXXXXXXXXXXXXXXXXXXXXXXXXXXXXXXXXXXXXXXXXXXXXXXXXXXXXXXXXXXXXXXXXXXXXXXXXXXXXXXXXXXXXXXXXXXXXXXXXXXXXXXXXXXXXXXXXXXXXXXXXXXXXXXX
