--------------------------------------------------------------------------------------------------------------------------------------------------------------------------------
--------------------------------------------------------------------------------------------------------------------------------------------------------------------------------
----------U---------------------------------------------------------------------------------------------------------------------------------------o-----------------------------
---------------------------SSSS-------------------------------------------------------------------------------------------------------------------------------------------------
--------------------------------------------------------------------------------------------------------------------------------------------------------------------------------
-----------------------------------------------------------------------------------------------------------------------------------------------U--------------------------------
QSSQQSSSSSSS---%--------------------------------------------------------SSSSSS-----------------%--------SS-------------SS--------------@S------%---------------@--------S-------
---------------|---------SS--------------------------------------------------------------------U-----------------------------------------------@--------------------------------
---------------|--------SS------------------------------SS-----------------------------SSS-----Q--------SS-------------------------------------------------------------SSSS-----
---------------|--------SSSS-----------SSS---------o----SS---------------------------------------------------##------------------------------R---------------------------SS-----
----------SS@--|------------------S----SSS--------SS--------------S---------------SSS--SS--------------------##--US----SSS--------2----SSS---##------------------SSS----SS------
---------------|---------------------------------------------#-------------------------------#---K--K-------###-----------------------------###--K------------------------------
---------------|--------------------------------------------##-------------tt---------------##------------#####----------------------------####------------B--------------------
-----k-------gg|K----------y----K-------------------------#-##--K----------t------------U-####----K-------######--------g-K-----K---------#####-k-K--------b------------y--g----
XXXXXXXXXXXXXXX|XXXXXXXXXXXXXXXXR----XX-XXXX--X-XXXXXXXXXXXXXXXXXXXXXXXXXXXXXXXXXX---XXXXXXXXXXXXXXXXXXXXXXXXXXXXXXXXXXXXXXXXXXXXXXXXXXXXXXXXXXXXXXXXXXXXXXXXXXXXXXXXXXXXXXXXXXX
XXXXXXXXXXXXXXXXXXXXXXXXXXXXXXXXX----XX-XXXXX-X-XXXXXXXXXXXXXXXXXXXXXXXXXXXXXXXXXX---XXXXXXXXXXXXXXXXXXXXXXXXXXXXXXXXXXXXXXXXXXXXXXXXXXXXXXXXXXXXXXXXXXXXXXXXXXXXXXXXXXXXXXXXXXX
