------------------------------------------------------------------------------------------------------------------------------------------------------------------------------------------------
------------------------------------------------------------------------------------------------------------------------------------------------------------------------------------------------
------------------------------------------------------------------------------------------------------------------------------------------------------------------------------------------------
--------------------------------------------------------------------------------SSSSSSSS----------------------------------------SSSS--S---------------------------------------------------------
------------------------------------------------------------------------------------------------------------------------------------------------------------------------------------------------
------------------------------------------------------------------------------------------------------------------------------------------------------------------------------------------------
--------%%%%%%%%------SSSSS-----------SSS--------------------------------------U----------------------QQQ---------------o------o--------oo-------------------------QQQQQQS---------------------U
---------||||||---------------------%%%---------------------------------------------------------------------------------------------------------------------------------------------------------
---------||||||----------------------|---------------------------------------oo----------------------------------------------##-----------------------------------------------o-----------------
---------||||||----------------------|---------------------------------------------------------------ggg---------o----------###---------S------------------------------g------------------------
------%%%%%%%%%%------QQQ---SoS------|------------#--2----------------------S@S-----------------########-----Q--------------###---##----------------------------######@QQ---SQS-----------------
-------||||||||----------------------|-----------------------------------------------tt---------###-------------------------###--##-----------------------------####----------------------#-----
-------||||||||----------------------tt------#-----------TT--------------------------tt-------TT###-----------------------####--###-------------------tt--------###----------------------##-----
-------||||||||---oy-----------------tt------#----g----y-TT---ko--gk---k----k--g-----tt-------TT###k--------k-k----k----######--###--------kkkkg------tt------#-###k------k-k-----kk-k---##---g-
XXXXXXXXXXXXXXXXXXXXXXXXXXXXXXXXXXXXXXXXXXXXXXXXXXXXXXXXXXXXXXXXXXXXXXXXXXXXXXXXXXXXXXXXXXXXXXXXXXXXXXXXXXXXXXXXXXXXXXXXXXXXXXX-XXX-XXXXXXXXXXXXXXXXXXXXXXXXXXXXXXXXXXXXXXXXXXXXXXXXXXXXXXXXXXXX
XXXXXXXXXXXXXXXXXXXXXXXXXXXXXXXXXXXXXXXXXXXXXXXXXXXXXXXXXXXXXXXXXXXXXXXXXXXXXXXXXXXXXXXXXXXXXXXXXXXXXXXXXXXXXXXXXXXXXXXXXXXXXXX-XXX-XXXXXXXXXXXXXXXXXXXXXXXXXXXXXXXXXXXXXXXXXXXXXXXXXXXXXXXXXXXX
