------------------------------------------------------------------------------------------------------------------------------S-----------------------------------------------------------------
------------------------------------------------------------------------------------------------------------------------------------------------------------------------------------------------
----------------------------------------------------------------------------------------------------------------tt--------------tt------------------------------t-------------------------------
----------------------------------------------------------------------------------------------------------------tt--------------tt------------------------------t-------------------------------
-----------------SS---------------------------------------------------------------------------------------------tt--------------tt------------------------------tt------------------------------
-----------------S----o------o----------------------------------------------------------------------------------tt--------------tt------------------------------tt------------------------------
--------%%%%%%%%-----------------------------------------------o---------------oSS-------------o-------------------------------o---------------o------------------------------------------------
---------||||||---S---------SS--------------------------ooo-----%--------ooo-----------------------------------------------------------------------------o--------------------------------------
---------||||||----------------------------------------%%%%%%%--|-------------------------------------------------------------------------------------------------------------------------------
---------||||||--K-----------SoS---g--------------------|||||---|---------------------------------------------------ttt-------------------------------------------------------------------------
------%%%%%%%%%%-------------%%%---SS---2---------------|||||---QQ------------------QQ--------------------------QQ--ttt---------Q-Q------------t------------------------------------------------
-------||||||||---------------|---------------------tt--|||||---------------TT-------------------------T------------ttt--------t-----tt--------t-------TT-------T-------------------------------
-------||||||||---------------|--------------#------tt--|||tt---------------TT--------tt------------tt-TT--tt-------ttt--------t-----tt--------t-------TT--B----T-------------------------------
-------||||||||------------o--|-K------------##-----tt--|||tt-----g---------TT--------tt-----ggg----tt-TT--tt----g-#ttt--------t-----tt--------t-------TT--b----T----------------g------------g-
XXXXXXXXXXXXXXXXX---------%---|-X----XXXXXXXXXXXXXXXXXXXXXXXXXX-XXXXXXXXXXXXXXXXXXXXXXXXXXXXXXXXXXXXXXXXXXXXXXXXXXXXXXXXXXXXXXXXXXXXXXXXXXXXXXXXXXXXXXXXXXXXXXXXXXXXXXXXXXXXXXXXXXXXXXXXXXXXXXXX
XXXXXXXXXXXXXXXXX---------|---|------XXXXXXXXXXXXXXXXXXXXXXXXXX-XXXXXXXXXXXXXXXXXXXXXXXXXXXXXXXXXXXXXXXXXXXXXXXXXXXXXXXXXXXXXXXXXXXXXXXXXXXXXXXXXXXXXXXXXXXXXXXXXXXXXXXXXXXXXXXXXXXXXXXXXXXXXXXX
