------------------------------------------------------------------------------------------------------------------------------------------------------------------------------------------------
------------------------------------------------------------------------------------------------------------------------------------------------------------------------------------------------
------------------------------------------------------------------------------------------------------------------------------------------------------------------------------------------------
-----------------------------------------------------------------------------S------------SSSSSS---------------------------S--------------SSSSSS---------------------------S--------------------
------------------------------------------------------SSSS---------------------------S--------K------------S---------------S---------SS----S-------------------------------S------------------o-
------------------------------------------------%%%--SSS--------------------------------------------------------------------------------------S-------------------------------------------------
--------%%%%%%%%---------QQ-------------SSSS-----|------SS-------------------------------SSS---S------SSSSSS-SSS---SSSSSSSSS--S%-----SSSSSSS--SS---SSSSSSSSSSSSS---SSSSUSSSS--S%----------------
---------||||||--------------------------S-------|----------------------SSSSS------------SSS-------------SSS-----------S-SS----|-------SSSSS-----------------------------SS----|----------------
---------||||||-------------------------SSS------|------S---------------SSSS-----------SSSSS-----------SSSSS-----------SSSS----|-------SSSSS-----------SSSS------------SSSS----|-------SSSSS----
---------||||||-------------------o----SSS-------|ooSSSSSSSSSSSS--S----SSSSSSSSS---SS--------------------SS---------------S----|---oSS---S---------------S---------------------|---------SS-----
------%%%%%%%%%%-----------------------SSS-------|-SS-SSSS----##---------S----S---SSS----------S-SSS----SSS----S--SSS--SSSS--SSS-SSSSSSSSSS--S----S-----------SQ-SSS---SSSS----|--SS------------
-------||||||||----------------------------------|------S-----#------------------K---------------K---------------K-------------------------------K-----------------------------|-K--------------
-------||||||||-T---------%%%--------------------|S-S--SS-----#---------------#--S-------------------------------------------------------------------------B-------------------|-S--------------
-------||||||||-T-----g----|--g-----------K------|-------k--#-##------------kk#-----------ggg-----K-------K-y-----K---------------------y-------K-K--------b------------y---y--|----------------
XXXXXXXXXXXXXXXXXX--XXXXXXXXXXXXXXX--XXXXXXXXXXXX|------XXXXXXXXXXX--X-XXXXXXXXXXXXXXXXXXXXXXXXXXXXXXXXXXXXXXXXXXXXXXXXXXXXXXXXXXXXXXXXXXXXXXXXXXXXXXXXXXXXXXXXXXXXXXXXXXXXXXXX|XXXXXXXXXXXXXXXX
XXXXXXXXXXXXXXXXXX--XXXXXXXXXXXXXXX--XXXXXXXXXXXX|------XXXXXXXXXXX--X-XXXXXXXXXXXXXXXXXXXXXXXXXXXXXXXXXXXXXXXXXXXXXXXXXXXXXXXXXXXX-XXXXXXXXXXXXXXXXXXXXXXXXXXXXXXXXXXXXXXXXXXXXXXXXXXXXXXXXXXXX
