------------------------------------------------------------------------------------------------------------------------------------------------------------------------------------------------
-------------------------------------------------------------------------------------------------------------K----------------------------------------------------------------------------------
------------------------------------------------------------------------------------------------------------------------------------------------------------------------------------------------
-----------------------------------------------------------------------------------------------------K---SSS--------------SS----------------------------------------------@----------------S----
----------------------------------------------------------------------------------------------------------K-------------------------------------------------------------------------------------
-------------------------------------------------------------------------------------------------------------------------------U---------------U---------------U---------------U---------------U
--------%%%%%%%%------r------o-------------------------------------------------------------------------------------------------S---------------S--------------SS-----------1-SSS---S---------@SS
---------||||||-------%%S-----------------------------------------------------U---K---------------------------U---K-----o-----U---K-----------U---------------U---K-----------K---K-----------K-
---------||||||-------||------------------------------------------------K-------------%%%-------------------------------%----------------------------------------------SS--------------SS-------
---------||||||-------||-------o----------------------------------oo--S----1--@S--r----|------SS-------r---r--@S---r--Sr|-----@S------SrS-----@S------Sr--------------Sr--------------Sr--------
------%%%%%%%%%%------||-------%--%%%%%-------------------------%%%%%%%---------%%%%-%%%--------%%%%%%%%%%%%--%-%%%%%%%%%%%--%%-%%%%%%%%%%%-----%%%%%%%%%%%-----%%%%%%%%%%%-----%%%%%%%%%%%-----
-------||||||||-------||-------|---|||---------------------------|||||-----------||---|----------||||||||||---|--|||||||||---||--|||||||||-------|||||||||-------|||||||||-------|||||||||------
-------||||||||-------||--T----|---|||--------------------%%%%%--|||||-----------||---|----------||||||||||---|--||||||||%%%-||--||||||||%%%%----||||||||%%%%----||||||||%%%%%---||||||||%%%%---
-------||||||||-------|k-T-----|---|||---------------------|||---|||||-----------||---|----------||||||||||---|--||||||||-|--||--||||||||-||-----||||||||-||-----||||||||-|||----||||||||-||----
XXXXXXXXXXXXXXXXXXXXXXXXXXX----|---|||-----XXXX-X--------%%%%%%%%|%|%%--%%------%|%%%%%%%%-%%---%|%%%%%%%%|---|-%|%%%%%%%%%%%||-%|%%%%%%%%%%----%|%%%%%%%%||----%|%%%%%%%%%%%---%|%%%%%%%%%|----
XXXXXXXXXXXXXXXXXXXXXXXXXXX----|---|||-----XXXX-X---------|||||-g||||g--gg------gg-|||||g-ggg---g|-|||||g-g---|-g|-|||||g|ggg||-g|-|||||ggg-----g|-|||||g-||----g|-|||||ggggg---g|-|||||g|-|----
