------------------------------------------------------------------------------------------------------------------------------------------------------S-----------------------------------------
------------------------------------------------------------------------------------------------------------------------------------------------------------------------------------------------
------------------------------------------------------------------------------------------------------------------------------------------------------------------------------------------------
------------------------------------------------SS------------------------------SSSSSSSS--------------------------------------------------------------------------------------------------------
------------------------------------------------------------------------------------------------------------------------------------------------------------------------------------------------
------------------------------------------------------------------------------------------------------------------------------------------------------------------------------------------------
--------%%%%%%%%---------------o------ooo----S--------Soo--------------ooo-----o------SSo------o------SSS--------------QQ--------S-----ooo---SSS-------Qo---------------oS-----S-------oo-------
---------||||||-------------------------------------------------S---------------------------------------------------------------SS--------------------------------------------------------------
---------||||||---S-----------S-------------------------------------------------------------------------------------------------S---------------------------------------------------------------
---------||||||----------------------------------------------------------------------------------------------------g-ggg----SS--S----------------------g--SSSSS---------------------------------
------%%%%%%%%%%---------------------o-------o--------------------------##----------------------------------------#######-------------------------######Q------------o-------o----####QQQ---SQ--
-------||||||||-----------------------------------#----------------#--------------#--tt--------------------------#####----------------------------#####-------------------------####------------
-------||||||||----------#----------------------####--------------###-----------###--tt----------------------#--#####---------------------------#####---------------------------####------------
-------||||||||-----g---##------------k-----k---####--g----kkk--#####--------#--###--tt----kg-------###------#--####--------k---y----k------gg-g#####-k-----k--------k----------###--------kk---
XXXXXXXXXXXXXXXXXXXXXXXXXXX-XXXXXXXXXXXXXXXXXXXXXXXXXXXXXXXXXXXXXXXXXXXXXXXXXXXXXXXXXXXXXXXXXXXXXXXXXXXXXXXXXXXXXXX@XQXXXXXXXXXXXXXXXXXXXXXXXXXXXXXXXXXXXXXXXXXXXXXXXXXXXXXXXXXXXXXX-XXXXXXXXXXX
XXXXXXXXXXXXXXXXXXXXXXXXXXX-XXXXXXXXXXXXXXXXXXXXXXXXXXXXXXXXXXXXXXXXXXXXXXXXXXXXXXXXXXXXXXXXXXXXXXXXXXXXXXXXXXXXXXXX--XXXXXXXXXXXXXXXXXXXXXXXXXXXXXXXXXXXXXXXXXXXXXXXXXXXXXXXXXXXXXX-XXXXXXXXXXX
