------------------------------------------------------------------------------------------------------------------------------------------------------------------------------------------------
------------------------------------------------------------------------------------------------------------------------------------------------------------------------------------------------
------------------------------------------------------------------------------------------------------------------------------------------------------------------------------------------------
------------------------------------------------------------------------------------------------------------------------------------------------------------------------------------------------
------------------------------------------------------------------------------------------------------------------------------------------------------------------------------------------------
------------------------------------------------------------------------------------------------------------------------------------------------------------------------------------------------
--------%%%%%%%%-----QQQQS------------SSSSS---SS-------oo----------------o-----------SQSQS----@----------------U-------oo-------------------------------o------o---------o---------o---oo------o
---------||||||---------------------------------------------------------------------------------------------------------------------------------------------------------------------------------
---------||||||----------------------------------------------------------------------------------------------------------------------------------------------KS---------------------------------
---------||||||----------------------------------------------------------------------------------------------------------------------------------------------------------------------ggg--------
------%%%%%%%%%%--#--QQQQ---SQ----------S--------###----------------------------------QQQ-----------------------####-###Q----SS-------------------######-----SS-----------------#######SQ---SSSS
-------||||||||--##--------------------------###-###----------------------------####----------------------------###------------------------------###----------------------------####------------
-------||||||||-###--------------------------###-##-----------------------------#####---------------------------###-----------------------------###-----------------------------###-------------
-------||||||||-###k-kk----kk------gg-------########--k----kkkk-k-----g--------g#####-k-----------kk-k-g----k-kg###--------kk-----kg-----------g###k--k---kkk-----kg------#---g-###k------k-k---
XXXXXXXXXXXXXXXXXXXXXXXXXXXXXXXXXXXXXXXXXXXXXXXXXXXXXXXXXXXXXXXXXXXXXXXXXXXXXXXXXXXXXXXXXXXXXXXXXXXXXXXXXXXXXXXXXXXXXXXXXXXXXXXXXXXXXXXXXXXXXXXXXXXXXXXXXXXXXXXXXXXXXXXXXXXXXXXXXXXXXXXXXXXXXXXX
XXXXXXXXXXXXXXXXXXXXXXXXXXXXXXXXXXXXXXXXXXXXXXXXXXXXXXXXXXXXXXXXXXXXXXXXXXXXXXXXXXXXXXXXXXXXXXXXXXXXXXXXXXXXXXXXXXXX-XXXXXXXXXXXXXXXXXXXXXXXXXXXXXXXXXXXXXXXXXXXXXXXXXXXXXXXXXXXXXXXXXXXXXXXXXXX
