------------------------------------------------------------------------------------------------------------------------------------------------------------------------------------------------
-----------------------------------------------------------------------------------------------------------------K------------------------------------------------------------------------------
------------------------------------------------------------------------------------------------------------------------------------------------------------------------------------------------
--------------------------------SSSSSSS-----------------------------------------SSSSSSSSSSSSSSSS--------------------------------SSSSSSSSSSSSSSSS--------------------------------SSSSSSSSSSS-----
---------------------------------------------------------g-----------------------S----------------------------------------------SS---S------------------------oo--------------------------------
--------------------------------------------------------------------------------------------------------------------------------SS--------------------------------------------------------------
--------%%%%%%%%-@S@QSSSQ----S---------------------USSSSSS---S-----------------U---------------S---QQ---------oS-ooo----o------o-------------SSSSS-SQQQ-------S----------------o----------------
---------||||||---------------------------------------------------------------------------------------------------------------------------------------------------------------------------------
---------||||||-----------------------------------------------o---------------o----------------------------------------------ooo----------------------------------------------------------------
---------||||||--------g----------------------------------------------------------------------------------------o---------------o---o-----------------------------------------------------------
------%%%%%%%%%%----SSSS-----SSS------tt---------------------USS-------------US----------------------------------------------US-S-SSS-------------Q----------US---------------------------------
-------||||||||-----------------------tt----------------------------------K-------------------------------------------------------------------K----------------------------------------tt-------
-------||||||||-----------------------tt----------------------------------b------------------------------------------------------------------------------------------B-----------------tt-------
-------||||||||----k--k---k-----#-----tt----kkkg---k--------------gggg----b---k------g------k-y----k-kg-#-k--------kggy---k----------k-k-k--k-k----kggy---k-k------k-b---k--k-kg--g----tt---kgg-
XXXXXXXXXXXXXXXXXXXXXXXXXXX-XXXXXXXXXXXXXXXXXXXXXXXXXXXXXXX-XXXXXXXXXXXXXXXXXXXXXXXXXXXXXXXXXXXXXXXXXXXXXXX-XXXXXXXXXXXXXXXXXXXXXXXXXXXXXXXXXXXXXXXXXXXXXXXXXXXXXXXXXXXXXXXXXXXXXXXXXXXXXXXXXXXX
XXXXXXXXXXXXXXXXXXXXXXXXXXX-XXXXXXXXXXXXXXXXXXXXXXXXXXXXXXX-XXXXXXXXXXXXXXXXXXXXXXXXXXXXXXXXXXXXXXXXXXXXXXX-XXXXXXXXXXXXXXXXXXXXXXXXXXXXXXXXXXXXXXXXXXXXXXXXXXXXXXXXXXXXXXXXXXXXXXXXXXXXXXXXXXXX
