------------------------------------------------------------------------------------------------------------------------------------------------------------------------------------------------
------------------------------------------------------------------------------------------------------------------------------------------------------------------------------------------------
------------------------------------------------------------------------------------------------------------------------------------------------------------------------------------------------
------------------------------------------------SS-------------------------------------------------------------------------------------------------------------------------------S--------------
---------------------------------------------------------------------------------------------------------@--------------------------------------------------------------------------------------
------------------------------------------------------------------------------------------------------------------------------------------------------------------------------------------------
--------%%%%%%%%-------SSS------SooSSSSSSSS--SSS----------------S-SSSSSS--------------------------QQQSSSSS---SSS------------------------------------------------S---QQQ-------------------------
---------||||||---oo----------------------------------------------------------------------------------------------------------------------------------------------------------------------------
---------||||||--------------------------------------------------------------------------------------------------------------o-----------------------------#-----------------o------------------
---------||||||-----------------oooo-----------o-----------------------------------------------------------------o-----------------------------------------#------------------------------------
------%%%%%%%%%%----------------SS-----S------S-------------------------------------------------QQQQSSSSSS---USS-------------o------------#-#-------------#------QQ----------@S-----------------
-------||||||||--------------------------------------------------------@T----------------TT-----------------------K------TT---------------#-#------------###-----------------------------K------
-------||||||||--------------------------------------------------------TT------------B---TT------------------------------TT----------B---T#-------------####-----------------------------B------
-------||||||||--------------------gggg---#------ok----k-----ggg-----gkTT---------k--b---TT---kg---k--k---k-------yggg---TT---gg--kgkb---T#---#---y----#####k-----ggggy---k-k----ob----k-t---gkg
XXXXXXXXXXXXXXXX--XXXXXXXX------XXXXXXXXXXXXXXXXXXXXXXXXXXXXXXXXXXXXXXXXXXXXXXXXXXXXXXXXXXXXXXXXXXXXXXXXXXX-XXXXXXXXXXXXXXXXXXXXXXXXXXXXXXXXX-XXXXXXXXXXXXXXXXXXXXXXXXXXXXXXXXXXXXXXXXXXXXXXXXXX
XXXXXXXXXXXXXXXX--XXXXXXXX---X-XXXXXXXXXXXXXXXXXXXXXXXXXXXXXXXXXXXXXXXXXXXXXXXXXXXXXXXXXXXXXXXXXXXXXXXXXXXX-XXXXXXXXXXXXXXXXXXXXXXXXXXXXXXXXX-XXXXXXXXXXXXXXXXXXXXXXXXXXXXXXXXXXXXXXXXXXXXXXXXXX
