------------------------------------------------------------------------------------------------------------------------------------------------------------------------------------------------
------------------------------------------------------------------------------------------------------------------------------------------------------------------------------------------------
------------------------------------------------------------------------------------------------------------------------------------------------------------------------------------------------
------------------------------------------------------------------------------------------------------------------------------------------------SSSSSSSSSSSSS-----------------------------------
------------------------------------------------------------------------------------------------------------------------------------------------------------------------------------------------
------------------------------------------------------------------------------------------------------------------------------------------------------------------------------------------------
--------%%%%%%%%-----------------------------------S@SQQoS---------------------o----Q----------U----------------S-SSQSQQS-------------------------------------------QQQQQ-------SSSSQSSS-----SSS
---------||||||----------------o----------------------------------------------------------------------------------------------------------------------------------------------------------------
---------||||||----------------------------------------------oo--------------oo-----------------------------------------------------------------------------------------------------------------
---------||||||--------------------------------------------------------------------------------------------------g---------------------------------------------------------------------o--------
------%%%%%%%%%%-------#------------------------------------S@S-------------S@S--------------US------------------SQ-SSSSSS---USS---------------------------------------------oS-SSQSSSSSSS--S@SS
-------||||||||---------------------------------------------------------------------------K--------------TT------------------------------TT---K-------------------------------------------------
-------||||||||------------------------B--------------------------------------------------#-------B------TT---TT-------------------------TT--------------B----TT--------------------------------
-------||||||||-------------------kg---b-----ggg--gggggg--k-k-----kk-koy----k-----ggggg---#---k---b----k-TT---TT---k-k----k-k-----ggggg--TT-k----------k-b----TT--gggggg--k-k-----ggggy---k-k---
XXXXXXXXXXXXXXXXXXXXXXXXXXXXXXXXXXXXXXXXXXXXXXXXXXXXXXXXXXXXXXXXXXXXXXXXXXXXXXXXXXXXXXXXXXXXXXXXXXXXXXXXXXXXXXXXXXXXXXXXXXXXXXXXXXXXXXXXXXXXXXXXXXXXXXXXXXXXXXXXXXXXXXXXXXXXXXXXXXXXXXXXXXXXXXXX
XXXXXXXXXXXXXXXXXXXXXXXXXXXXXXXXXXXXXXXXXXXXXXXXXXXXXXXXXXXXXXXXXXXXXXXXXXXXXXXXXXXXXXXXXXXXXXXXXXXXXXXXXXXXXXXXXXXXXXXXXXXXXXXXXXXXXXXXXXXXXXXXXXXXXXXXXXXXXXXXXXXXXXXXXXXXXXXXXXXXXXXXXXXXXXXX
