------------------------------------------------------------------------------------------------------------------------------------------------------------------------------------------------
------------------------------------------------------------------------------------------------------------------------------------------------------------------------------------------------
---------------------------------------------------------------------------------------------------------------------------------------------------------------------------2--------------------
---------------------------------------------------------------------------------------------------------------------#--------------------------------------------------------------------------
-------------------------------------------------------------------k-----------------------------------------------k##--------------------------------------------------------------------------
------------------------------------------------------------------------------------------------------------------##----------------------------------------------------------------------------
--------%%%%%%%%--SSSSS--S----------------------------------S------------------------------------------------------------------------------------------------------Q---------------------S------
---------||||||----S---------------------ooo------------------------------------------------------------------------------oo--------------------------------------------------------------------
---------||||||---------------------------------------------------------SS----------------------------------------------------------------------------------------------------------------------
---------||||||--------------------------------------------------------SSSSS-------------------------------------------------------------------------------------------------1------------------
------%%%%%%%%%%---S------------QSQ--------------#----------------SS----------#-----------------------------------S-------------Q-------QQQ-------------------#----S--------------2-----------QQ
-------||||||||----------------y----------------------------------------------#-----K--TT------------------------------TT---------------------------tt-------##-----K---------------------------
-------||||||||-------B--------T-------------------------------T--------------#--------TT---------------------------tt-TT---------------------------tt------###----------------------------B----
-------||||||||-----g-b--------T--g-------k--------------g-----T--K---------###--------TT---y---------------TT--g---tt-TT---------------------------tt-----####----gR-------y---K----------b----
XXXXXXXXXXXXXXXXXXXXXXXXXXXXXXXXXXXXXXXXXXXXXXXXXXXXXXXXXXXXXXXXXXXXXXXXXXXXXXXXXXXXXXXXXXXXXXXXXXXXXXXXXXXXXXXXXXXXXXXXXXXXXXXXXXXXXXXXXXXXXXXXXXXXXXXXXXXXXXXXXXXXXXXXXXXXXXXXXXXXXXXXXXXXXXXX
XXXXXXXXXXXXXXXXXXXXXXXXXXXXXXXXXXXXXXXXXXXXXXXXXXXXXXXXXXXXXXXXXXXXXXXXXXXXXXXXXXXXXXXXXXXXXXXXXXXXXXXXXXXXXXXXXXXXXXXXXXXXXXXXXXXXXXXXXXXXXXXXXXXXXXXXXXXXXXXXXXXXXXXXXXXXXXXXXXXXXXXXXXXXXXXX
