------------------------------------------------------------------------------------------------------S-----------------------------------------------------------------------------------------
------------------------------------------------------------------------------------------------------S-----------------------------------------------S-----------------------------------------
------------------------------------------------------------------------------------------------------------------------------------------------------------------------------------------------
----------------SSSSSSSSSSSS----SSSSSSSS--------------------------------------------------------SSSS----------------------------SSSS--SS--------SSSSSSSSSSS-------------------------------------
------------------------------------------------------------------------------------------------------------------------------------------------------------------------------------------------
------------------------------------------------------------------------------------------------------------------------------------------------------------------------------------------------
--------%%%%%%%%---------------o----------------------SS------------Q-QQQS--------------oo-----o--------S--------SSSQS--------So--------oo-------------------------SQQQQ----------------o----o-o
---------||||||-----------------------------------------------------------------SS--------------------------------------------------------------------------------------------------------------
---------||||||-----------------------------------------------------------------S---------------------------------------------------------------------------------------------o--------------SS-
---------||||||--------------------------------------------------------g---------------------------------------------------------------------------------------------g--------------------------
------%%%%%%%%%%---------------------------------------------U---####SSQQ----Q-----------------------------------#-----------US-----------------------------------####SS-----SSS------------SS--
-------||||||||------------------#----tt--------------------------#--------------##------------------tt--------------------------##------------------tt----------##-----------------------------
-------||||||||--##-------------###---tt--------------2----------###------------###------------------tt--------------------------##------------------tt----------##-----------------------------
-------||||||||--##--k-----k----###---tt-----kgg---kk--------kk--##k--------k---###--------kk--------tt------g-----k--g---k-k----##---------k--g-----tt-------g--##-------k-k-----kkok------k---
XXXXXXXXXXXXXXXXXXXXXXXXXXXXXXXXXXX-XXXXXXXXXXXXXXXXXXXXXXXXXXXXXXXXXXXXXXXXXXXXXXXXXXXXXXXXXXXXXXXXXXXXXXXXXXXXXXXXXXXXXXXXXXXXXXXXXXXXXXXXXXXXXXXXXXXXXXXXXXXXXXXXXXXXXXXXXXXXXXXXXXXXXXXXXXXX
XXXXXXXXXXXXXXXXXXXXXXXXXXXXXXXXXXX-XXXXXXXXXXXXXXXXXXXXXXXXXXXXXXXXXXXXXXXXXXXXXXXXXXXXXXXXXXXXXXXXXXXXXXXXXXXXXXXXXXXXXXXXXXXXXXXXXXXXXXXXXXXXXXXXXXXXXXXXXXXXXXXXXXXXXXXXXXXXXXXXXXXXXXXXXXXX
