------------------------------------------------------------------------------------------------------------------------------------------------------------------------------------------------
------------------------------------------------------------------------------------------------------------------------------------------------------------------------------------------------
------------------------------------------------------------------------------------------------------------------------------------------------------------------------------------------------
----------------------------------------------------------------SSSS----------------------------------------------S------SSSS-----------------------------------SSSSSSSS------------------------
----------------------------------------------------------------------------------------------------------------------------------------------oo----------------------------------------------oo
--------------------------------------------------------------------------------------------------------------------------------Q---------------------------------------------------------------
--------%%%%%%%%-------SS--S------------------------QQQQQS------------------------------------------QS--------SS--------------------QQQ-------@-------------------------------------QQQ---------
---------||||||---------------------------------------------------------------------------------------------------------------------------------------------------------------------------------
---------||||||---------------------------------------------------------------------B------------------------oo----------------------------------------------o-------------------------------K--
---------||||||----------------------------------o----------------------------------b-----------o------------------------------------------------o----------------------------------------------
------%%%%%%%%%%------------SSSS-----------------------------U----#------------------------------------------@S------------------------------US----------TT--@-------------------------------U--
-------||||||||---------------------------------------------------------------------------T---------------B--------------TT-----------------------K------TT-------------------------------------
-------||||||||--------------------------------#-----------------------------------------TT--------------TT--------------TT------------------------------TT--------------B----TT----------------
-------||||||||------k-----k-----------------ggg--gy-ggg--k-k---------ty----kkkk--gg-----TT-------gggggg--T-------gk---k-TT---yg--ggggy-----k----gkk-ggk-TT---k---k----k-b----TT--gggggg--k-kkk-
XXXXXXXXXXXXXXXXXXXXXXXXXXXXXXXXXXXXXXXXXXXXXXXXXXXXXXXXXXXXXXXXXXXXXXXXXXXXXXXXXXXXXXXXXXXXXXXXXXXXXXXXXXXXXXXXXXXXXXXXXXXXXXXXXXXXXXXXXXXXXXXXXXXXXXXXXXXXXXXXXXXXXXXXXXXXXXXXXXXXXXXXXXXXXXXX
XXXXXXXXXXXXXXXXXXXXXXXXXXXXXXXXX-XXXXXXXXXXXXXXXXXXXXXXXXXXXXXXXXXXXXXXXXXXXXXXXXXXXXXXXXXXXXXXXXXXXXXXXXXXXXXXXXXXXXXXXXXXXXXXXXXXXXXXXXXXXXXXXXXXXXXXXXXXXXXXXXXXXXXXXXXXXXXXXXXXXXXXXXXXXXXX
