------------------------------------------------------------------------------------------------------------------------------------------------------------------------------------------------
------------------------------------------------------------------------------------------------------------------------------------------------------------------------------------------------
------------------------------------------------------------------------------------------------------------------------------------------------------------------------------------------------
------------------------------------------------SSSSSSS-----------------------------------------------------------------------------------------------------------------------------------------
------------------------------------------------------------------------------------------------------------------------------------------------------------------------------------------------
------------------------------------------------------------------------------------------------------------------------------------------------------------------------------------------------
--------%%%%%%%%-----------------------o-------o------------------------------------S----------S---------------o--------------------Q-------------------o------o---------------------QQ---------
---------||||||---------------------------------------------------------------------------------------------------------------------------------------------------------------------------------
---------||||||------------------------------------------------------------------------------------------------------------------------------oo-------------------------------------------------
---------||||||-----------------------------------------------------------------o---------------------------------------------------------------oo----------------------------------------------
------%%%%%%%%%%------------------------------------------------------------------------------S----------------------------------2---------SS@S--------------U------------#------------------o--
-------||||||||--------TT-----TT-----------------------tt----TT-----------------------------------------------K----------------------------------------------------------##---------------------
-------||||||||---TT---TT-----TT-----------------------tt----TT---------------------------------------------------------------------------------------------------------###---------------------
-------||||||||---TT---TT-----TT-----k------k-----y----tt----TT---gggggg--k-k-k----kgggg--k--------k-gg---k-k-----g---------k-k---kggg---------------g-y----k-----y-----###-------kk-ggg----kkk-
XXXXXXXXXXXXXXXXXXXXXXXXXXXXX-XXXXXXXXXXXXXXXXXXXXXXXXXXXXXXXXXXXXXXXXXXXXXXXXXXXXXXXXXXXXXXXXXXXXXXXXXXXXXXXXXXXXXXXXXXXXXXXXXXXXXXXXXXXXXXXXXXXXXXXXXXXXXXXXXXXXXXXXXXXXXXXXXXXXXXXXXXXXXXXXXX
XXXXXXXXXXXXXXXXXXXXXXXXXXXXX--XXXXXXXXXXXXXXXXXXXXXXXXXXXXXXXXXXXXXXXXXXXXXXXXXXXXXXXXXXXXXXXXXXXXXXXXXXXXXXXXXXXXXXXXXXXXXXXXXXXXXXXXXXXXXXXXXXXXXXXXXXXXXXXXXXXXXXXXXXXXXXXXXXXXXXXXXXXXXXXXX
