------------------------------------------------------------------------------------------------------------------------------------------------------------------------------------------------
------------------------------------------------------------------------------------------------------------------------------------------------------------------------------------------------
------------------------------------------------------------------------------------------------------------------------------------------------------------------------------------------------
--------------------------------SSSSSSSSSSSSSSSS------------------------------------------------------------------------------------------------------------------------------------------------
------------------------------------------------------------------------------------------------------------------------------------------------------------------------------------------------
------------------------------------------------------------------------------------------------------------------------------------------------------------------------------------------------
--------%%%%%%%%--------------------------------------ooo--------oo--SSSSS---S@S--------------------QQQQQ----------------o-----o--------o------o--------------------QQQooS-----o----------------
---------||||||---------------------------------------------------------------------------------------------------------------------------------------------------------------------------------
---------||||||------------------------------------------------------------------------------------------------------------------------------oo------------------------------oS-----------------
---------||||||-----------------------------------------------------------------------------------g--------------------------------------------------------------------------S------------------
------%%%%%%%%%%-------------------------------------------------SQS----------------------------########Q----Q----------------------SS@SQ---S@SS-----------------##---QQQ---SSS-----------------
-------||||||||----------TT------------------------------------------------------------tt-------#####-#---------------------------------------------------------####----------------------------
-------||||||||----------TT------------------------------------------------------------tt-------#####------------------------------------------------tt---------###-----------------------------
-------||||||||---gggg-k-TT----g--k------g----gg-------k----kkk-------#-k---------y----tt---kkkg#####kk-----k-----ggg##-----k------k------k-k--------tt-------g-###k--------k-----k--k--------gg
XXXXXXXXXXXXXXXXXXXXXXXXXXXXXXXXXXXXXXXXXXXXXXXXXXXXXXXXXXXXXXXXXXXXXXXXXX--XXXXXXXXXXXXXXXXXXXXXXXXXXXXXXXXXXXXXXXXXXXXXXXXXXXXXXXXXXXXXXXXXXXXXXXXXXXXXXXXXXXXXXXXXXXXXXXXXXXXXXXXXXXXXXXXXXXX
XXXXXXXXXXXXXXXXXXXXXXXXXXXXXXXXXXXXXXXXXXXXXXXXXXXXXXXXXXXXXXXXXXXXXXXXXX--XXXXXXXXXXXXXXXXXXXXXXXXXXXXXXXXXXXXXXXXXXXXXXXXXXXXXXXXXXXXXXXXXXXXXXXXXXXXXXXXXXXXXXXXXXXXXXXXXXXXXXXXXXXXXXXXXXXX
