------------------------------------------------------------------------------------------------------------------------------------------------------------------------------------------------
------------------------------------------------------------------------------------------------------------------------------------------------------------------------------------------------
------------------------------------------------------------------------------------------------------------------------------------------------------------------------------------------------
--------------------------------SSSS----------------------------------------------------------------------------SSSSSSSSSS----------------------------------------------------------------------
------------------------------------------------------------------------------------------------------------------------------------------------------------------------------------------------
------------------o--------------------------------------------o-oo---------------------------------------------------------------o-------------------------------------------------------------
--------%%%%%%%%--------------------------------SSSo----o----SSS-%%%---------------------------US--SQSQQ----------------------------------------SSS@SS------------------------------QQ----------
---------||||||---------------------------------------------------|-----------------------------------------------------------------------------------------------------------------------------
---------||||||------------------------------oo-------------------|--------------------------o---------------oo------------------------------K---------------oo---------------------------------
---------||||||---------------------------------o-----------------|------------------------------g-------------------------------------------K--------------------------------------------------
------%%%%%%%%%%------------------#--2-------US-S--SSSSS----S@SS--|--2-t-----o---------------U---SS--SS-----S@S------------------------------U---------------SS---------------------------------
-------||||||||-----------------###-------------------------------|----t------------------K------------------------------B--------------------------------K---------------K---------------------
-------||||||||-o--------------T###-------------------------------|--------------------------------------------------B---b----TT--#----------------------------------B--------------------------
-------||||||||----------------T###----k----kkk----k------k-----##|----k----kkk---kggg-g--k---k---gk-kgg--k-k-----b--b---bT---TT--#k------k-k------kgggg--T-------k--k-k------kg---ygggg--k-----
XXXXXXXXXXXXXXXX-X-------XXXX--XXXXXXXXXXXXXXXXXXXXXXXXXXXXXXXXXXXXXXXXXXXXXXXXXXXXXXXXXXXXXXXXXXXXXXXXXXXXXXXXXXXXXXXXXXXXXXXXXXXXXXXXXXXXXXXXXXXXXXXXXXXXXXXXXXXXXXXXXXXXXXXXXXXXXXXXXXXXXXXXX
XXXXXXXXXXXXXXXX-----X----XXX--XXXXXXXXXXXXXXXXXXXXXXXXXXXXXXXXXXXXXXXXXXXXXXXXXXXXXXXXXXXXXXXXXXXXXXXXXXXXXXXXXXXXXXXXXXXXXXXXXXXXXXXXXXXXXXXXXXXXXXXXXXXXXXXXXXXXXXXXXXXXXXXXXXXXXXXXXXXXXXXXX
