------------------------------------------------------------------------------------------------------------------------------------------------------------------------------------------------
------------------------------------------------------------------------------------------------------------------------------------------------------------------------------------------------
------------------------------------------------------------------------------------------------------------------------------------------------------------------------------------------------
------------------------------------------------SSSSSSSSSSSS----SSSSSSS-----------------------------------------SSSSSSS-----------------------------------------SSSSSSS-------------------------
----------------------------------------------------------------------------------------------------------------------------------------------o-----------------------------------------------oo
------------------------------------------------------------------------------------------------------------------------------------------------------------------------------------------------
--------%%%%%%%%---------------o----QSSS-------o------------oo---------o-------USSSSQSSS-S-----------------------------------------SQSQS-S---S@S------------------------------------QQQ---------
---------||||||---------------------------------------------------------------------------------------------------------------------------------------------------------------------------------
---------||||||------------------------------oo--------------SSS------------------------------------------------------------------------------o-------------------------------------------------
---------||||||--o--------------------------------------------------------------------------------------------------------------------------------o---------------------------------------------
------%%%%%%%%%%-SQ----------U---------------@S------------------------------o--SSQQ--------S@SS--------------------------------QQQQ--------S@S----------------------------------Q-----------US-
-------||||||||--------------#-----------------------------------------U---------------------------------TT---------------------------------------K------TT-------------------------------------
-------||||||||--------------#---------------------------------------------------------------------------TT----------B-----------------------------------TT-------------------------------------
-------||||||||---gy---k---###----ggggg---k-k--------g------kk----k----g----k-----gggg----k--------kgggg-TT---k---k--b-k------kg--kgggy-----------g--g-k-TT---yg-------y--#-k-k---gggggg--k-k---
XXXXXXXXXXXXXXXXXXXXXXXXXXXXXXXXXXXXXXXXXXXXXXXXXXXXXXXXXXXXXXXXXXXXXXXXXXXXXXXXXXXXXXXXXXXXXXXXXXXXXXXXXXXXXXXXXXXXXXXXXXXXXXXXXXXXXXXXXXXXXXXXXXXXXXXXXXXXXXXXXXXXXXXXXXXXXXXXXXXXXXXXXXXXXXXX
XXXXXXXXXXXXXXXXXXXXXXXXXXXXXXXXXXXXXXXXXXXXXXXXXXXXXXXXXXXXXXXXXXXXXXXXXXXXXXXXXXXXXXXXXXXXXXXXXXXXXXXXXXXXXXXXXXXXXXXXXXXXXXXXXXXXXXXXXXXXXXXXXXXXXXXXXXXXXXXXXXXXXXXXXXXXXXXXXXXXXXXXXXXXXXXX
