------------------------------------------------------------------------------------------------------------------------------------------------------------------------------------------------
-----------------------------------------------------------------S------------------------------------------------------------------------------------------------------------------------------
------------------------------------------------------------------------------------------------------------------------------------------------------------------------------------------------
----------------SSSSSSSS---SSSSS---------------------SSSSSSSSS--SSSSSSSSSSS--------------------------------------SSSSSSSSSSS-------------------------------------SSS----------------------------
----------------------------------------------------------------S------------------------o------------------------------------------------------------------------------------------------------
---------------------------------------------------------------------------o--------------------------------------------------------------------------------------------------------------------
--------%%%%%%%%----------------------SSS-------Soooo-SSS----SSS----------------@QoSQSSSoS---S@T-----------------oo-----------------Q---------o-S-SS@SQQ-------------------------oo-------------
---------||||||--%%-----------------------------------------------------------------------------------------------------------------------------------------------------------------------------
---------||||||--||---------SSS-------------------------------S---------------------------------------------------------------------------------------------------------------------------------
---------||||||--||--------SSSSS----------------oo------------oo-----------------------g--------------------------------------------------------------------------------------------------------
------%%%%%%%%%%S||--------SSS---------------U--S---t---------SS-----2----------QSQQS-SSS----US---------------------------------------------------Q-S---------S---------------------------------
-------||||||||--||--------S-------------------------------------------TT-----TT-------------------------TT---K-----------#-------------##-------------------------------TT---K-----------#-----
-------||||||||--||------S-So-----------------------t----#------T------TT------T-------------------------TT---U------t---##------------###-------------------------------TT---TT-----t---##-----
-------||||||||--||------SoSo-----gggkk----kk-------ty--###-----T------TT---k--T---k--k-----------kgggg--TT---kT----tt---##---------gg####---------kggy---k-k------k-gg--TT---TT----tt---##---ko
XXXXXXXXXXXXXXXXX|X---XXXX%%%X--XXXXXXXXXXXXXXXXXXXXXXXXXXXXXXXXXXXXXXXXXXXXXXXXXXXXXXXXXX--XXXXXXXXXXXXXXXXXXXXXXXXXXXXXXXXXXXXXXXXXXXXXXXXXXXXXXXXXXXXXXXXXXXXXXXXXXXXXXXXXXXXXXXXXXXXXXXXXXXX
XXXXXXXXXXXXXXXXX|X---XX-X-X-X-XXXXXXXXXXXXXXXXXXXXXXXXXXXXXXXXXXXXXXXXXXXXXXXXXXXXXXXXXXX--XXXXXXXXXXXXXXXXXXXXXXXXXXXXXXXXXXXXXXXXXXXXXXXXXXXXXXXXXXXXXXXXXXXXXXXXXXXXXXXXXXXXXXXXXXXXXXXXXXXX
