------------------------------------------------------------------------------------------------------------------------------------------------------------------------------------------------
------------------------------------------------------------------------------------------------------------------------------------------------------------------------------------------------
------------------------------------------------------------------------------------------------------------------------------------------------------------------------------------------------
------------------------------------------------SSSS--------------------------------------------------------------------------------------------SSSSSSS---------SSSSSSS-------------------------
------------------------------------------------------------------------------------------------------------------------------------------------------------------------------------------------
------------------------------------------------------------------------------------------------------------------------------------------------------------------------------------------------
--------%%%%%%%%--%----------U------QSSS--------------------------------o-------------SSSSS--Soo--------o------o------ooo------o---------S-----o-------------o-o-------------------SQS@SoS------
---------||||||---|---------------------------------------------SS----------------------------------------------SSSS%-%------------------------------------------#------------------------------
---------||||||---|----------o----------------------------------S---------------------------------------------------|-|----------------------oo-------------SS-------------------------------oo-
---------||||||---|-----------------------------------------------------S--S----------------------------------------|-|------------------------------------SSS----------------------------------
------%%%%%%%%%%#-#--2------S@S-------------------#----------------------------------------------##-----------------|-|----------------------@S---#---o-----SSS-----------------###-#SQQQ---S@SS
-------||||||||-#--------------------------------##---------------------------------------------###--------------###|-|--------------------------###-------------------------#---#--------------
-------||||||||-#--------------------------------##--------------###---------K------------------###-------------####|-|----K-K------------------####------------------#------#------------------
-------||||||||-#------k----kkk-----g-----------###---kk----kkk-####---k---k-g-g----gy----------###--g-k----kkk-####|-k----y-#----kggg----k----g####-------kkk--#---###----#-##----k------k-k---
XXXXXXXXXXXXXXXXXXX-XXXXXXXXXXXXXXXXXXXXXXXXXXXXXXXXXXXXXXXXXXXXXXXXXXXXXXXXXXXXXXXXXXXXXXXXXXXXXXXXXXXXXXXXXXXXXXXXXXXXXXXXXXXXXXXXXXXXXXXXXXXXXXXXXXXXXXXXXXXXXXXXXXXXXXXXXXXXXXXXXXXXXXXXXXXX
XXXXXXXXXXXXXXXXXXX-XXXXXXXXXXXXXXXXXXXXXXXXXXXXXXXXXXXXXXXXXXXXXXXXXXXXXXXXXXXXXXXXXXXXXXXXXXXXXXXXXXXXXXXXXXXXXXXXXXXXXXXXXXXXXXXXXXXXXXXXXXXXXXXXXXXXXXXXXXXXXXXXXXXXXXXXXXXXXXXXXXXXXXXXXXXX
