------------------------------------------------------------------------------------------------------------------------------------------------------------------------------------------------
------------------------------------------------------------------------------------------------------------------------------------------------------------------------------------------------
------------------------------------------------------------------------------------------------------------------------------------------------------------------------------------------------
---------------------------------#----------------------------------------------SSSSSSSSSSSSSSSS--------------------------------------------------------------------------------SSSSSSS---------
------------------------------------------------------------------------------------------------------------------------------------------------------------------------------------------------
------------------------------------------------------------------------------------------------------------------------------------------------------------------------------------------------
--------%%%%%%%%------------------------------------------------------------------------------------QQQo------------QQ-------U-U---------------U----------------SSS@QQSQo----U------------------
---------||||||--o-------------------------------#---------------#------------------------------------------------------------------------------------------------------------------------------
---------||||||--------------------------------------------------#-----------------------------------------------------------oo----------------------------------------------Uo-----------------
---------||||||--------------------------------------------------K------------------------------------------------------------------------------------------------------------------------------
------%%%%%%%%%%----------##---------------------------------------------------------------------------------U---2-----------US---------------------------------SSQ-U--------US-----------------
-------||||||||-----------##-------------TT--------------TT---------------B-------------------------------------------------------K-----------------------#----------------------------tt-------
-------||||||||---------####---#--B------TT--------------TT---------------b--------------------------------------------------------------TT--------------##----------------------------tt-------
-------||||||||---k---######---#--b------TT---#---kggg-g-TT---ko--gk--gg--b-k-k-k-#----k-----ggg-ggk---kk---k-----ggggy---k-------ggg----TT-------g---g-###--------k-ky---k-k----------tt---k-k-
XXXXXXXXXXXXXXXXXXXXXXXXXXXX---XXXXXXXXXXXXXXXXXXXXXXXXXXXXXXXXXXXXXXXXXXXXXXXXXXXXXXXXXXXXXXXXXXXXXXXXXXXXXXXXXXXXXXXXXXXXXXXXXXXXXXXXXXXXXXXXXXXXXXXXXXXXXXXXXXXXXXXXXXXXXXXXXXXXXXXXXXXXXXXXX
XXXXXXXXXXXXXXXXXXXXXXXXXXXX--XXXXXXXXXXXXXXXXXXXXXXXXXXXXXXXXXXXXXXXXXXXXXXXXXXXXXXXXXXXXXXXXXXXXXXXXXXXXXXXXXXXXXXXXXXXXXXXXXXXXXXXXXXXXXXXXXXXXXXXXXXXXXXXXXXXXXXXXXXXXXXXXXXXXXXXXXXXXXXXXXX
