--------------------------------------------------------------------------------------------------------------------------------------------------------------------------------
--------------------------------------------------------------------------------------------------------------------------------------------------------------------------------
-------------------------------------------------------------------------------------------2------------------------------------------------------------------------------------
SSSSSSSSSSSSSSSS----------------------------------------------------------------------------------------------------------------------------------------------------------------
----SSSS------------------------------------------------------------------------------------------------------------------------------------------------------------------------
--------------------------------------------------------------------------------------------------------------------------------------------------------------------------------
-----S-----------------------------------------------------------------@-------------------@-----------US---SS-S-------@-------------------------------@------------------------
-----------------------------------------------y-------------------------------------------------------------------------------------------------------------------------------y
------------------------SS--------------------##------------------------------------------------------------------------------------------------------------------------SS-----#
-------------------------SS------------------###--------------------------------------------------------------------------------------------------------S-----------------------
---------SSSSS------------------------------####QSS---------------2----SS------------------------SS----SSSSQQQ----2----@S----Q#-------------------2-----S--------------------#--
----------S--------------------------------#####--------------------tt--------------K-------------------------------tt-------##--K--K---------------------------------------###-
---#-----------#-------TT-----------------######-------TT-----------tt-------#--------------------------------------tt------###---------------------tt---------------------####-
---#---------k-#K------TT---------K------#######g------TT---g---K---tt-----#-#------------@-----g---------------K---tt----#####--------#--@-----K---tt-----#----K---------#####-
XXXXXXXXXXXXXXXXXXXXXXXXXXXXXXXXXXXXXXXXXXXXXXXXXXXXXXXXXXXXXXXXXXXXXXXXXXXXXXXXXXXXXXXXXXXXXXXXXXXXXXXXXXXXXXXXXXXXXXXXXXXXXXXXXXXXXXXXXXXXXXXXXXXXXXXXXXXXXXXXXXXXXXXXXXXXXXXX
XXXXXXXXXXXXXXXXXXXXXXXXXXXXXXXXXXXXXXXXXXXXXXXXXXXXXXXXXXXXXXXXXXXXXXXXXXXXXXXXXXXXXXXXXXXXXXXXXXXXXXXXXXXXXXXXXXXXXXXXXXXXXXXXXXXXXXXXXXXXXXXXXXXXXXXXXXXXXXXXXXXXXXXXXXXXXXXX
