------------------------------------------------------------------------------------------------------------------------------------------------------------------------------------------------
------------------------------------------------------------------------------------------------------------------------------------------------------------------------------------------------
------------------------------------------------------------------------------------------------------------------------------------------------------------------------------------------------
---------------------------------SSS-----------------------------------------------------------------------------SSSSSSSSSSSS---SSSSSSSSSS--------------------------------------SSSSSSSS--------
-----------------------o--------------------------------------------------------------------------------------------------------------------------------------o---------------------------------
------------------------------------------------------------------------------------------------------------------------------------------------------------------------------------------------
--------%%%%%%%%-------SS--------------SSS-----S------------------------------------------------SQSSQSQQQ----U---oo----------------------------oS--SQQQ------SS---------------------------------
---------||||||---------------------------------------------------------------------------------------------------------------------------------------------------------------------------------
---------||||||----------------------------------------------------------------------------------------------Ko---------------------------------------------------------------------------------
---------||||||------------------------------------------------------------------o---------------g----------------------------------------------------------------------------------------------
------%%%%%%%%%%-So-------------------t------o-------------------------------U-------------------#Q-Q--S-----US---------------------------------QQQQ---------USS--------------------------------
-------||||||||----------------------tt-------------------K---K--------B-------------------------------------------------TT----T----------------------------------------------K-----------------
-------||||||||----------------------tt--------------------------------B---------------------------------------------B---TT---TT-----t----#----------------------------------------------B----T-
-------||||||||---------------------ttt----kk------k-kok--k-k-----gggg-b----k-k----gggg-------k----k-kgg--k-k------kgt---TT---TT-----t----#--------gggy-----------ggggkk--k-kkk------ttk-b----TT
XXXXXXXXXXXXXXXXXXXXXXXXX----X--XXXXXXXXXXXXXXXXXXXXXXXXXXXXXXXXXXXXXXXXXXXXXXXXXXXXXXXXXXXXXXXXXXXXXXXXXXXXXXXXXXXXXXXXXXXXXXXXXXXXXXXXXXXXXXXXXXXXXXXXXXXXXXXXXXXXXXXXXXXXXXXXXXXXXXXXXXXXXXXX
XXXXXXXXXXXXXXXXXXXXXXXXX----X-XXXXXXXXXXXXXXXXXXXXXXXXXXXXXXXXXXXXXXXXXXXXXXXXXXXXXXXXXXXXXXXXXXXXXXXXXXXXXXXXXXXXXXXXXXXXXXXXXXXXXXXXXXXXXXXXXXXXXXXXXXXXXXXXXXXXXXXXXXXXXXXXXXXXXXXXXXXXXXXXX
