------------------------------------------------------------------------------------------------------------------------------------------------------------------------------------------------
-------------------------------------------------------------------------------------------------K----------------------------------------------------------------------------------------------
------------------------------------------------------------------------------------------------------------------------------------------------------------------------------------------------
------------------------------------------------------------------------------------------------------------------------------------------------------------------------------------------------
-------------------------------------------------------------------------------------------------------------------------------------------------------------------------------o----------------
------------------------------------------------------------------------------------------------------------------------------------------------------------------------------------------------
--------%%%%%%%%----------------S--SQS---------o-oo---ooo------o---------------U---------------USSSSSSS-------------Q------------oo------------S---SSSS---------S-oSQS-------------------------o
---------||||||---------------------------------------------------------------------------------------------------------------------------------------------------------------------------------
---------||||||-------------------------------o------------------------------Ko----------------------------------------------oo-----------------------------------------------------------------
---------||||||--------k--------o------------------------------------------------------------------------------o----------------oo-----------------------------o--------------------------------
------%%%%%%%%%%-------#--------#-Q----------US------------------------------US---------------------S------------2-----------@S---------------------S----------T-------------U------------------
-------||||||||-----------------------------------------------K-----------K--------------TT-----------------------------------------------K------------o------------------K---K-----------------
-------||||||||-----------------------------------------------------------b--------------TT------------------------------------------t----#-------------------------------T----------B----------
-------||||||||---#g--------------gggggg--k-k-------gkk----kkkk----ggggg--y---k---kk-k---TT---k-----ggg-----k-----gggggg--k-k-k-----tt---------g----ggkT----k------kgggg--b-k--------b------kkkg
XXXXXXXXXXXXXXXXXXXXXXXXXXXXXXXXXXXXXXXXXXXXXXXXXXXXXXXXXXXXXXXXXXXXXXXXXXXXXXXXXXXXXXXXXXXXXXXXXXXXXXXXXXXXXXXXXXXXXXXXXXXXXXXXXXXXXXXXXXXXXXXXXXXXXXXXXXXXXXXXXXXXXXXXXXXXXXXXXXXXXXXXXXXXXXXX
XXXXXXXXXXXXXXXXXXXXXXXXXXXXXXXXXXXXXXXXXXXXXXXXXXXXXXXXXXXXXXXXXXXXXXXXXXXXXXXXXXXXXXXXXXXXXXXXXXXXXXXXXXXXXXXXXXXXXXXXXXXXXXXXXXXXXXXXXXXXXXXXXXXXXXXXXXXXXXXXXXXXXXXXXXXXXXXXXXXXXXXXXXXXXXXX
