---------------------------------------------------------------------------------------------------------------------------------------Q--------------------------------------------------------
-----------------------------K------------------------------------------------------------------------------------------------------------------------------------------------------------------
------------------------------------------------------------------------------------------------tt--------------t-------------------------------------------------------------------------------
------------------------------------------------------------------------------------------------tt--------------t-------------------------------------------------------------------------------
------------------------------------------------------------------------------------------------tt--------------tt--------------t---------------------------------------------------------------
------------------------------------------------------------------------------------------------tt--------------tt------------------------------------------------------------------------------
--------%%%%%%%%-------------------------------U---------------------------------------------------------------oSS-------------o---------------o------------------------------------------------
---------||||||-------------------------oo--------------ooo---o-----------------------------------------oo------------------------------oo------------------------------------------------------
---------||||||----------------------------------------%--%%---------------------------------------------%%%------------------------------------------------------------------------------------
---------||||||--------r------@------------------------|--||---S---g--------------------------------------|---------------------g---ttt-------------------------------------------g-------------
------%%%%%%%%%%%%%%%%%%%%%----------------------%-----|--||-------Q-----------------t----------QQ--ttt---|-----QQ------------------ttt-------------------------Q---------------QQ--------------
-------||||||||--|||||||||----------tt-----------|-----|--||------------------------tt--------------ttt---|-----%-------------------ttt---------T-----------------------------------------------
-------||||||||--|||||||||----------tt-----------|-----|--||----------------##------ttt----tt-------ttt---|-----|----tt-------------ttt-----###-T-----------------------------------------------
-------||||||||--|||||||||------K---tt-----------|-----|--||----------------##--g---ttt----tt-#-----ttt---|-----T----tt-------g-----ttt----##-#-T------------------------------g----------------
XXXXXXXXXXXXXXXX%|%%%%||||------XXXXXXXXXXXXXXX--|-----|--|X--X-XXXXXXXXXXXXXXXXXXXXXXXXXXXXXXXXXXXXXXXXXXXXXXXXXXXXXXXXXXXXXXXX-XXXXXXXXXXXXXXXXXXXXXXXXXXXXXXXXXXXXXXXXXXXXXXXXXXXXXXXXXXXXXXX
XXXXXXXXXXXXXXXXg|-||-||||------XXXXXXXXXXXXXXX--|-----|--|XXXX-XXXXXXXXXXXXXXXXXXXXXXXXXXXXXXXXXXXXXXXXXXXXXXXXXXXXXXXXXXXXXXXXXXXXXXXXXXXXXXXXXXXXXXXXXXXXXXXXXXXXXXXXXXXXXXXXXXXXXXXXXXXXXXXX
