------------------------------------------------------------------------------------------------------------------------------------------------------------------------------------------------
------------------------------------------------------------------------------------------------------------------------------------------------------------------------------------------------
------------------------------------------------------------------------------------------------------------------------------------------------------------------------------------------------
----------------------------------------------------------------SSS--------------------------------------------------------------S--------------------------------------------------------------
------------------------------------------------------------------------------------------------------------------------------------------------------------------------------------------------
------------------------------------------------------------------------------------------------------------------------------------------------------------------------------------------------
--------%%%%%%%%-oo--SSSoS---S@S---------------------QQoo---------------------------QQQQQ--------------o--------------SSSS---S@---------------------QQQQQ------o------SSSS---SSS-------Qo-------
---------||||||---------------------------------------------------------------------------------------------------------------------------------------------------------------------------------
---------||||||---------------------------------------------------------------------------------------------------------------------------------------------------------------------------------
---------||||||-----------------------------------gg-g-----------------------------------------------------------------k-------------------------ggg---g----------------------------------------
------%%%%%%%%%%S--S----#-----------------------######QQQ----US-----------------###----------US--------#---------SQS--SQQS----------------------########Q----SS------------------#######Q----U--
-------||||||||---------#----#------------#-----####-----------------------------##--------------##----K----------------------------------------#####-#--------------------------###---K--------
-------||||||||--------###---#------------#---TT####-----------------tt--------------------------##--------------------------#-----------K----TT####-----------------------------##-------------
-------||||||||-------####---#-----gggg---#---TT###k--------k--------tt-------##---k-gk-----k----##--kkk---kk-k-------------------g-----------TT####-kk---kgk-------g-k------gg--##k------k-k---
XXXXXXXXXXXXXXXXXXXXXXXXXX--XXXXXXXXXXXXXXXXXXXXXXXXXXXXXXXXXXXXXXXXXXXXXXXXXXXXXXXXXXXXXXXXXXXXXXXXXXXXXXXXXXXXXXXXXXXXXXXXXXXXXXXXXXXXXXXXXXXXXXXXXXXXXXXXXXXXXXXXXXXXXXXXXXXXXXXXXXXXXXXXXXXX
XXXXXXXXXXXXXXXXXXXXXXXXXX--XXXXXXXXXXXXXXXXXXXXXXXXXXXXXXXXXXXXXXXXXXXXXXXXXXXXXXXXXXXXXXXXXXXXXXXXXXXXXXXXXXXXXXXXXXXXXXXXXXXXXXXXXXXXXXXXXXXXXXXXXXXXXXXXXXXXXXXXXXXXXXXXXXXXXXXXXXXXXXXXXXXX
