------------------------------------------------------------------------------------------------------------------------------------------------------------------------------------------------
------------------S-----------------------------------------------------------------------------------------------------------------------------------------------------------------------------
------------------------------------------------------------------------------------------------------------------------------------------------------------------------------------------------
----------------SSS----------SSS--------------------------------SSS-----------------------------SS----------------------------------------------SSSSSSSSSSSSSS--SSSSSSS-------------------------
----------------------------------------------------------------------------------------------------------------------------------------------oo----------------------------------------------oo
------------------------------------------------------------------------------------------------------------------------------------------------------------------------------------------------
--------%%%%%%%%-%%-------oo-------------------@------------------------------------QQQ-------@-------------------------------------QS--------S-------------------------------------QQQQQ-----@S
---------||||||--||-----------------------------------------------------------------------------------------------------------------------------------------------------------------------------
---------||||||--||-------SS------------------------------------------------------------------o-----------------------------------------------o-------------------------------------------------
---------||||||--||---So--SS----oo------------------------------------------------------------------------------o-------------------------------------------------------------------------------
------%%%%%%%%%%%%|---------------------------S----------------------------------Q-----------US----------------------------------------------US----------------------2------------Q-Q--------US-
-------||||||||-|||---------------------------------------------------------------------------------------#-------------------------------------------------------------TTT-K-------------------
-------||||||||-|||---------------------------------------------------tt-----------------------------B----#----o-------------------------------------B------------B-----TTT---TT----------------
-------||||||||-|||----------g-g--ggggg---k-------kg---------kgg------tt----kkkg--ggggy---k-k-----k--b---##---##-----ggg--k-------gggggg--k-k--------b-k----k-kg--b-----TTT---TT---k--k-k---k---
XXXXXXXXXXXXXXXXX||--XXXXXXXXXXXXXXXXXXXXXXXXXXXXXXXXXXXXXXXXXXXXXXXXXXXXXXXXXXXXXXXXXXXXXXXXXXXXXXXXXXXXXXXXXXXXXXXXXXXXXXXXXXXXXXXXXXXXXXXXXXXXXXXXXXXXXXXXXXXXXXXXXXXXXXXX-XXXXXXXXXXXXXXXXXX
XXXXXXXXXXXXXXXXX||--XXXXXXXXXXXXXXXXXXXXXXXXXXXXXXXXXXXXXXXXXXXXXXXXXXXXXXXXXXXXXXXXXXXXXXXXXXXXXXXXXXXXXXXXXXXXXXXXXXXXXXXXXXXXXXXXXXXXXXXXXXXXXXXXXXXXXXXXXXXXXXXXXXXXXXXX-XXXXXXXXXXXXXXXXXX
