------------------------------------------------------------------------------------------------------------------------------------------------------------------------------------------------
------------------------------------------------------------------------------------------------------------------------------------------------------------------------------------------------
------------------------------------------------------------------------------------------------------------------------------------------------------------------------------------------------
---------------------------------------------------------------------------------SSSSSSSS---------------------------------------SSSS-S------------------------------------------SSSSSSSS--------
------------------------------------------------------------------------------------------------------------------------------------------------------------------------------------------------
------------------------------------------------------------------------------------------------------------------------------------------------------------------------------------------------
--------%%%%%%%%------QQQ------o--------------------QQQo-------U-----------------o-----------------UQ----------USSSSSSS-----------------------------------------%SSSQSS------------------------o
---------||||||-------------------------------------------------------------------------------------------------------------------------------------------------|-------------------------------
---------||||||--------------o-------------------------------oo----------------------------------------------oo-------------------------------------------------|-------------o-----------------
---------||||||------------------------------------------------------------------o------------------------------------------------------------------------------|-------------------------------
------%%%%%%%%%%-------------S------------------------------S@S----------------------------------------------US-SSSSSS-------USS--------------------------------SSQ--------SS@S-----------------
-------||||||||--------------------------TT------------K--------------------------------------------------K-------------------------------------------------------------------------------------
-------||||||||--------------------------TT---U--------B---------------#----------------------TT----------b--------------------------ttt------TT-------------------------------------tt---------
-------||||||||------kkk-------g--kggg-b-TT---gg--gk-ggg----k------k---#----kggg-----k---k--k-TT---k-kgg--k-k------k--g---k-k---k----ttt------TT---k--ok---kkkk---ggggy---k-k--------tt---------
XXXXXXXXXXXXXXXXXXXXXXXXXXXXXXXXXXXXXXXXXXXXXXXXXXXXXXXXXXXXXXXXXXXXXXXXXXXXXXXXXXXXXXXXXXXXXXXXXXXXXXXXXXXXXXXXXXXXXXXXXXXXXXXXXXXXXXXXXXXXXXXXXXXXXXXXXXXXXXXXXXXXXXXXXXXXXXXXXXXXXXXXXXXXXXXX
XXXXXXXXXXXXXXXXXXXXXXXXXXXXXXXXXXXXXXXXXXXXXXXXXXXXXXXXXXXXXXXXXXXXXXXXXXXXXXXXXXXXXXXXXXXXXXXXXXXXXXXXXXXXXXXXXXXXXXXXXXXXXXXXXXXXXXXXXXXXXXXXXXXXXXXXXXXXXXXXXXXXXXXXXXXXXXXXXXXXXXXXXXXXXXXX
