------------------------------------------------------------------------------------------------------------------------------------------------------------------------------------------------
---------------------------------------------------------------------------------K-K-----------------------------------------------------------------------------K------------------------------
--------------------------------------------------------------------------------------------------------------------------------------------------------------------------------tt--------------
--------------------------------------------------------------------------------------------------------------------------------------------------------------------------------tt--------------
--------------------------------------------------------------------------------------------------------------------------------------------------------------------------------tt--------------
--------------------------------------------------------------------------------------------------------------------------------------------------------------------------------tt--------------
--------%%%%%%%%----------oo--@%------------------------------------------------------------------------------------------------------U------------------------U-------------------------------o
---------||||||----------------|---------o-------------------------------oo------------ooooo----------------------------------------##----------------------------------------------------------
---------||||||----------------|----------------------------------------------------------------------------------------------------------------------------------------------------------------
---------||||||----------------|------------------gg--------------------------------------------------------------------------------------------------------------------------------------------
------%%%%%%%%%%---------------|------------------QQ----------------------------QQ--------------------------------------------#-Q@--------------QSQ-----------------------------QQQ-------------
-------||||||||----------------|---------------------------------------------------------------------------------------TT-----#-----------------------------------------------------------------
-------||||||||----------------|-----------B------------------------------------------------------------------------tt-TT--B--#------------------------------------------------------tt---------
-------||||||||--------------gggK----------b-----------------------------------------------------gg-----------------tt-TT--b#-#---------------ggggg-----------------------------ggg--tt---y---g-
XXXXXXXXXXXXXXXXXXXXXXXXXXXXXXXXXXXX-XXXXXXXXXX-XXXXXXXXXXXXXXXXXXXXXXXXXXXXXXXXXXXXXXXXXXXXXXXXXXXXXXXXXXXXXXXXXXXXXXXXXXXXXXXXXXXXXXXXXXXXXXXXXXXXXXXXXXXXXXXXXXXXXXXXXXXXXXXXXXXXXXXXXXXXXXXX
XXXXXXXXXXXXXXXXXXXXXXXXXXXXXXXXXXXX-XXXXXXXXXXXXXXXXXXXXXXXXXXXXXXXXXXXXXXXXXXXXXXXXXXXXXXXXXXXXXXXXXXXXXXXXXXXXXXXXXXXXXXXXXXXXXXXXXXXXXXXXXXXXXXXXXXXXXXXXXXXXXXXXXXXXXXXXXXXXXXXXXXXXXXXXXXX
