------------------------------------------------------------------------------------------------------------------------------------------------------------------------------------------------
------------------------------------------------------------------------------------------------------------------------------------------------------------------------------------------------
------------------------------------------------------------------------------------------------------------------------------------------------------------------------------------------------
--------------------------------SSSSSSSS--------SSSS----------------------------------------------------------------------------SSSSSSSSSSSS--------------------------SSS-----------------------
------------------------------------------------------------------------------------------------------------------------------------------------------------------------------------------------
------------------------------------------------------------------------------------------------------------------------------------------------------------------------------------------------
--------%%%%%%%%---------------------------------------o-----------------o--------------o--------------oo-------------SSSSS--SSS----------------------SQSSSSS-----------o--------------Qo------o
---------||||||------------------------------------------------------%oo------------------------------------------------------------------------------------------------------------------------
---------||||||------------------------------------------------------|-----------------------------------------------------------------------------------------------------------------------K--
---------||||||------------------------------------------------------|----------------------------------S--SSS--o--------------------------------------k---------------------------g---g--------
------%%%%%%%%%%-----------------------------------------------------|----------------------------######Q-------S-----------So---####----------------SSQQS--SSS-----------------########Q---SSSS
-------||||||||----------------------------------##------------------SS--------------------------###-----------------------------##---------------#-----------------------------#####-----------
-------||||||||--------------------------------TT##------------------SS-----------------------#-####-----------------------------##---------------##----------------------------####------------
-------||||||||-----gg--#----#--%------k-----k-TT##----k---kgg-------------#-k-------------##-######-------kkg-g--gggg----------###----k---kk-----#k--------k--------k------ggg-####------kgk---
XXXXXXXXXXXXXXXXXXXXXXXXXXXXXXX-XXX-XXXXXXXXXXXXXXXXXXXXXXXXXXXXXXXXXXXXXXXXXXXXXXXXXXXXXXXXXXXXXXXXXXXXXXXXXXXXXXXXXXXXXXXXXXXXXXXXXXXXXXXXXXXXXXXXXXXXXXXXXXXXXXXXXXXXXXXXXXXXXXXXXXXXXXXXXXXX
XXXXXXXXXXXXXXXXXXXXXXXXXXX-XX--X---XXXXXXXXXXXXXXXXXXXXXXXXXXXXXXXXXXXXXXXXXXXXXXXXXXXXXXXXXXXXXXXX-XXXXXXXXXXXXXXXXXXXXXXXXXXXXXXXXXXXXXXXXXXXXXXXXXXXXXXXXXXXXXXXXXXXXXXXXXXXXXXXXXXXXXXXXXXX
