---%----------------------------------------------------------------------------------------------------------------------------------------------------------------------------
---|----------------------------------------------------------------------------------------------------------------------------------------------------------------------------
---|----------------------------------------------------------------------------------------------------------------------------------------------------------------------------
---|----------------------------------------------------------------------------------------------------------------------------------------------------------------------------
---|------------------------------------------------------------------------------------------o---------------------------------------------------------------------------------
---|---------------------------U-----------------------------------------------U-------------------------------------------------------------------------------U----------------
---|--------------------------SS-------SSSSS---------SSUSS-----%-------SSS----------SSSo------------------------------------------------S--------------@S---------------SS------
---|--------------------------------------S--------------------|-----------------------------------------------------------------------------------------------@----------------
---|-------------------SSS-------------SSSS--------------------|-------SSS-------------SSSS-------------SS--------------SSS------------SSSS----------------------------SSS------
---|--------------------SSS-------------SSS--------------------|----------------------------------------SSS---------------------------------------------------------------------
-##|--------------------SSS-------SS--------------SS---SSSQQQQ-|--S-----S---------SSSS-------#----------------#--------------##---SS--------------2----SSS---------------------Q
---|TT-T-------------------------K-----------------------------|-------------#---K----------##---K--tt-------##--K--K-------###--K--K------------------------##-----tt----------
---|TT-TT------------------------S-----------------------------|------------##---S--------####------tt------###-----------#####-----------------------------###-----tt-----B----
---|TT-TT-k-----K----------y--#---K--------y-------------------|K----------####----------#####----K-tt-----####-----------######--K-------#-----K---------#####-K---tt-----b----
XXXXXXXXXXXXXXXXXXXXXXXXXXXXXXXXXXXXXXXXXXXXXXXXXXXXXXXXXXXXXXXXXXXXXXXXXXXXXXXXXXXXXXXXXXXXXX-XXXXXXXXXXXXXXXXXXXXXXXXXXXXXXXXXXXXXXXXXXXXXXXXXXXXX-XXXXXXXXXX-XXXXXXXXXXXXXXXX
XXXXXXXXXXXXXXXXXXXXXXXXXXXXXXXXXXXXXXXXXXXXXXXXXXXXXXXXXXXXXXXXXXXXXXXXXXXXXXXXXXXXXXXXXXXXXXXXXXXXXXXXXXXXXXXXXXXXXXXXXXXXXXXXXXXXXXXXXXXXXXXX-XXX-XXXXXXXXXX-XXXXXXXXXXXXXXXX
