------------------------------------------------------------------------------------------------------------------------------------------------------------------------------------------------
------------------------------------------------------------------------------------------------------------------------------------------------------------------------------------------------
------------------------------------------------------------------------------------------------------------------------------------------------------------------------------------------------
------------------------------------------------------------------------------------------------------------------------------------------------------------------------------------------------
------------------------------------------------------------------------------------------------------------------------------------------------------------------------------------------------
-------------------------------o------------------------------------------------------------------o--------------------------------------------------------------o-----------------o------------
--------%%%%%%%%SoSSSSS---------------------------------------------QQQSSS----@-------------------%---------------o-QQo--------o---------------U----Q----------U-----------------S-SQQQ---------
---------||||||-----------------------------------------------------------------------------------|---------------------------------------------------------------------------------------------
---------||||||---------------------------------------------------------------o---------------o---|--------------------------S-S-----------------------------ooo-----------------------------K--
---------||||||-------------------------------------------SS--------------------------------------|---------------------------------------------------------------------------------------------
------%%%%%%%%%%SS-SSSSSSS---@So--------------------------------QQQQ---------US--S-----------USS--|----------------------------------------------------------@S------2--------------U-----------
-------||||||||-----------------------------------------------------------------------------------|---------------------------------------B--------------TT--------------T----TT----------------
-------||||||||--------------------------TT------------------T------------------------------------|--------------------------------------TT--------------TT-------------tT----TT----------------
-------||||||||---ggggk---k--------------TT---g---b----------ggg---kggy----------ggy--gg----k----gygg--b-----ggg---kgg----k-k-----gk--gg-#T--------k-ggg-TT---k---t--k-ktt----TT---k-kg---kkk---
XXXXXXXXXXXXXXXXXXXXXXXXXXXXXXXXXoXXXXXXXXXXXXXXXXXXXXXXXXXXXXXXXXXXXXXXXXXXXXXXXXXXXXXXXXXXXXXXXXXXXXXXXXXXXXXXXXXXXXXXXXXXXXXXXXXXXXXXXXXXXXXXXXXXXXXXXXXXXXXXXXXXXXXXXXXXXXXXXXXXXXXXXXXXXXXX
XXXXXXXXXXXXXXXXXXXXXXXXXXXXXXXX--XXXXXXXXXXXXXXXXXXXXXXXXXXXXXXXXXXXXXXXXXXXXXXXXXXXXXXXXXXXXXXXXXXXXXXXXXXXXXXXXXXXXXXXXXXXXXXXXXXXXXXXXXXXXXXXXXXXXXXXXXXXXXXXXXXXXXXXXXXXXXXXXXXXXXXXXXXXXXX
