------------------------------------------------------------------------------------------------------------------------------------------------------------------------------------------------
------------------------------------------------------------------------------------------------------------------------------------------------------------------------------------------------
------------------------------------------------------------------------------------------------------------------------------------------------------------------------------------------------
--------------------------------------------------------------------------------SSS-----------------------------------------------------------------------------SSSSSSSSS-----------------------
------------------------------------------------------------------------------------------------------------------------------------------------------------------------------------------------
---------------------------------------------------------------------------------oo-------------------------------------------------------------------------------------------------------------
--------%%%%%%%%----QQQ----------------------------------------o-----------------%%-------------SSSSSSS-------oS----------------#--S@SQQ------------Q----------o-------------------SQQQ---------
---------||||||------------------------------------------------------------------||-------------------------------------------------------------------------------------------------------------
---------||||||------------------------------U----------------S------------------||---------------------------o---------------------------------------------------------------------------------
---------||||||------------------------------2-----------------------------------||-------------o-----------------------------------------------------------------------------------------------
------%%%%%%%%%%-S---------------------------U-----------------------------------||--2-----------------------SSS--------------------S------------------------US------------------#Q----------U--
-------||||||||---------------------------K---K----------------------------------||----tt------------------------------K---------------o------------------K-------------------------------------
-------||||||||---------------------------b--------------------------------------||----tt-----------------------------------------------------------------b---------tt--------------------------
-------||||||||-------------k-----kk-kgg--b-k-k---k-----#---------gg---k----kggg-||----tt---kk-----kgggg--k-------g--kkk----kk-------ggk----k-----gggggg--b---k-----tt------k-k----ggggg----k---
XXXXXXXXXXXXXXXXXXXXXXXXXXXXXXXXXXXXXXXXXXXXXXXXXXXXXXXXXXXXXXXXXXXXXXXXXXXXXXXXXXXXXXXXXXXXXXXXXXXXXXXXXXXXXXXXXXXXXXXXXXXXXXXXXXXXXXXXXXXXXXXXXXXXXXXXXXXXXXXXXXXXXXXXXXXXXXXXXXXXXXXXXXXXXXXX
XXXXXXXXXXXXXXXXXXXXXXXXXXXXXXXXXXXXXXXXXXXXXXXXXXXXXXXXXXXXXXXXXXXXXXXXXXXXXXXXXXXXXXXXXXXXXXXXXXXXXXXXXXXXXXXXXXXXXXXXXXXXXXXXXXXXXXXXXXXXXXXXXXXXXXXXXXXXXXXXXXXXXXXXXXXXXXXXXXXXXXXXXXXXXXXX
