------------------------------------------------------------------------------------------------------------------------------------------------------------------------------------------------
-------------------------------------------------------------------------------------------------------------------------------------------------K----------------------------------------------
------------------------------------------------------------------------------------------------------------------------------------------------------------------------------------------------
----------------#-------------------------------------------------------------------------------------------------------------------------------------------------------------------------------
--------------------------------------------------------------------------------------------------------------------------------------------------------------o---------------------------------
-----------------------------------------------------------------------------------------------------------------------------------------------------------------oo-----------------------------
--------%%%%%%%%---------------------------------------------------------------o----QQQQo------o---------------o---------------o----QQQQ-------U----Q---------@T-----------------oooo-ooo-----oS
---------||||||--oo-----------oo----------------------------------------------------------------------------------------------------------------------------------------------------------------
---------||||||-%%--------------------------------------------------------------------------------------------S-----------------------------------------------o---------------------------------
---------||||||-||----------#--#----------------oo----------------------------------------------------------------------------------------------------------------------------------------------
------%%%%%%%%%%||--------###--#-------------------------------------------------------------U-----------------------------------------------US--------------US---------------------------------
-------||||||||-||-------####-oo-------------------------TT-----------------------------------------------T--------------TT------##-------------------------------------TT----TT----------------
-------||||||||-||-------####-%%---------TT--------------TT----------------------------------------------TT--------------TT------##-------------------------------------TT----TT---------##-----
-------||||||||-||g-----####--|#k--------TT----g--gggg---TT----o--gy-k------ggg---ggg-------k-----gggggg-TT--------kgggg-TT------##k------k-k------gggy---k-k-----g--#--TT--k-TT----gy--###-----
XXXXXXXXXXXXXXXXXXXXXXXXXXXX--|XXXXXXXXXXXXXXXXXXXXXXXXXXXXXXXXXXXXXXXXXXXXXXXXXXXXXXXXXXXXXXXXXXXXXXXXXXXXXXXXXXXXXXXXXXXXXXXXXXXXXXXXXXXXXXXXXXXXXXXXXXXXXXXXXXXXXXXXXXXXXXXXXXXXXXXXXXXXXXXXX
XXXXXXXXXXXXXXXXXXXXXXXXXXXX--|-XXXXXXXXXXXXXXXXXXXXXXXXXXXXXXXXXXXXXXXXXXXXXXXXXXXXXXXXXXXXXXXXXXXXXXXXXXXXXXXXXXXXXXXXXXXXXXXXXXXXXXXXXXXXXXXXXXXXXXXXXXXXXXXXXXXXXXXXXXXXXXXXXXXXXXXXXXXXXXXX
