------------------------------------------------------------------------------------------------------------------------------------------------------------------------------------------------
------------------------------------------------------------------------------------------------------------------------------------------------------------------------------------------------
------------------------------------------------------------------------------------------------------------------------------------------------------------------------------------------------
------------------------------------------------------------------------------------------------------------------------------------------------------------------------------------------------
-------------------------------o--------------oo------------------------------------------------------------------------------------------------------------------------------------------------
--------------------------------Q---------------------------------------------------------------------------------------------------------------------------------------------------------------
--------%%%%%%%%---------------@----QQQ------------------------U------------------------o------o----------------------------------------------------------------SSS@QS-------S@S---------------U
---------||||||---------------------------------------------------------------------------------------------------------------------------------------------------------------------------------
---------||||||--------------oS------------------------------oo----------------------------------------------o----------------------------------------------------------------o-----------------
---------||||||------------------------------------------------------------------o-----------------------------------------------------------------------------------------------o--------------
------%%%%%%%%%%-------------U---------------oS--------------U---------------oS------------------------------U--------------S@S--------------o------------------SSQ------SSSS@S-----------------
-------||||||||-----------K-----------------------------------------------K-------K---------------------------------------K---------------------------------------------------------------2-----
-------||||||||-----------U--------------------------------------------------------------TT------------------------------------------ttt---------------------------------------------B----#-----
-------||||||||----gggg-------k---gggg----k-k------k---k----kkk---g-------k-------g---g--TT---k---gyoggg----kkk--gggggk-----------g--ttt----k-k-------gg----kkk---ggggy---k-------kggg----#----g
XXXXXXXXXXXXXXXXXXXXXXXXXXXXXXXXXXXXXXXXXXXXXXXXXXXXXXXXXXXXXXXXXXXXXXXXXXXXXXXXXXXXXXXXXXXXXXXXXXXXXXXXXXXXXXXXXXXXXXXXXXXXXXXXXXXXXXXXXXXXXXXXXXXXXXXXXXXXXXXXXXXXXXXXXXXXXXXXXXXXXXXXXXXXXXXX
XXXXXXXXXXXXXXXXXXXXXXXXXXXXXXXXXXXXXXXXXXXXXXXXXXXXXXXXXXXXXXXXXXXXXXXXXXXXXXXXXXXXXXXXXXXXXXXXXXXXXXXXXXXXXXXXXXXXXXXXXXXXXXXXXXXXXXXXXXXXXXXXXXXXXXXXXXXXXXXXXXXXXXXXXXXXXXXXXXXXXXXXXXXXXXXX
