------------------------------------------------------------------------------------------------------------------------------------------------------------------------------------------------
------------------------------------------------------------------------------------------------------------------------------------------------------------------------------------------------
------------------------------------------------------------------------------------------------------------------------------------------------------------------------------------------------
---------------------------S---S------------------------------------------------------------------------------------------------------------------------------------------------SSSSSSS---------
---------------------------------------------------------------------------------------------------------------2---------------------------------------------oo---------------------------------
--------------------------------------------------------------------------------------------------o---------------------------------------------------------------------------------------------
--------%%%%%%%%-----------------o----S--------------SSSS-----@---------------------QQQooS------%%%-----------------QQQS------SS-----------------SSS@SS------SS---------------------------------
---------||||||------------------------o---------------------------------------------------------|----------------------------------------------------------------------------------------------
---------||||||-----------SS-SSS------------------------------S-------------------------------o--|----------------------------o------------------------------K---#-----------o------------------
---------||||||-S----------SoSSS---------------------------S--So---------------------------------|---------------o-----------------------------------------------@------------------------------
------%%%%%%%%%%S-----------SSSS------------So----QoS----------------2-----------------------US--|---2--------------Q--------USS--------------------S--------U---------------oS-----------------
-------||||||||-----------------------------------------------------------K----------------------|-----tt--------------------------------TT------------------------------TT---------------------
-------||||||||----------------------------------------##----------------------------------------|-----tt-----TT------------------B------TT------------------------------TT-----------tt--------
-------||||||||--------------------ggy----k-k-kg------#-k--------------k------kg---k-k------k----ggggg-tt---k-TT---ygg----k-------b------TT---kg-----gg-----k-----kggggg-TT---k-------tt----kkk-
XXXXXXXXXXXXXXXXXXXXXXXXXXXXXXXXXXXXXXXXXXXXXXXXXXXXXXXXXX---XXXXXXXXXXXXXXXXXXXXXXXXXXXXXXXXXXXXXXXXXXXXXXXXXXXXXXXXXXXXXXXXXXXXXXXXXXXXXXXXXXXXXXXXXXXXXXXXXXXXXXXXXXXXXXXXXXXXXXXXXXXXXXXXXXX
XXXXXXXXXXXXXXXXXXXXXXXXXXXXXXXXXXXXXXXXXXXXXXXXXXXXXXXXXX--XXXXXXXXXXXXXXXXXXXXXXXXXXXXXXXXXXXXXXXXXXXXXXXXXXXXXXXXXXXXXXXXXXXXXXXXXXXXXXXXXXXXXXXXXXXXXXXXXXXXXXXXXXXXXXXXXXXXXXXXXXXXXXXXXXXX
