------------------------------------------------------------------------------------------------------------------------------------------------------------------------------------------------
------------------------------------------------------------------------------------------------------------------------------------------------------------------------------------------------
------------------------------------------------------------------------------------------------------------------------------------------------------------------------------------------------
------------------------------------------------SSSSSSSSSSSS---S--------------------------------SSSSSSSSSSSSSS--SSSSSSSS----------------------------------------SSSSSSSS------------------------
-----------------------------------------------KSS--------------------------------------------oo----------------------------------------------oo----------------------------------------------oo
------------------------------------------------SS----------------------------------------------------------------------------------------------------------------------------------------------
--------%%%%%%%%---------------#-----------------o------------SS----QSSQ------------Q----S----So-ooo----------SS----------------@S-S@SSS-----S@S------------------------------------QQQQQ----S@T
---------||||||----------------#----------------------------------------------------------------------------------------------------------------------------------------------------------------
---------||||||--------------###--------------------------------------------------------------o-----------------------------------------------o-------------------------------------------------
---------||||||-------------####----------------------------------------------------------------o--------------------------------g---------------oo---------------------------------------------
------%%%%%%%%%%------------####-------------US-------t----------------------U---------------US---------------------------------SSQ----------US-------------Soo--------------------Q------------
-------||||||||--------TT--####-----------K-----------tt----------------------------------K-------------------------------------------------------K------TT------------t------------------------
-------||||||||--------Tt--####-----------b----------ttt---------------------------------------------t----#----------tt---#------------------------------TT----@-------tt-----------------------
-------||||||||--gg----Tt--####---gggg----b----------ttt------g---ggkgk-----kkk---gggggg-------------t----#-------k--tt--#k---y---ggggy---k-k-----kggg-g-TT----g--b----t----k-kg--gg--k-#-------
XXXXXXXXXXXXXXXXXXXXXXXXXXXXXXX-XXXXXXXXXXXXXXXXXXXXXXXXXXXXXXXXXXXXXXXXXXXXXXXXXXXXXXXXXXXXXXXXXXXXXXXXXXXXXXXXXXXXXXXXXXXXXXXXXXXXXXXXXXXXXXXXXXXXXXXXXXXXXXXXXXXXXXXXXXXXXXXXXXXXXXXXXXXXXXXX
XXXXXXXXXXXXXXXXXXXXXXXXXXXXXXX-XXXXXXXXXXXXXXXXXXXXXXXXXXXXXXXXXXXXXXXXXXXXXXXXXXXXXXXXXXXXXXXXXXXXXXXXXXXXXXXXXXXXXXXXXXXXXXXXXXXXXXXXXXXXXXXXXXXXXXXXXXXXXXXXXXXXXXXXXXXXXXXXXXXXXXXXXXXXXXXX
