------------------------------------------------------------------------------------------------------------------------------------------------------------------------------------------------
------------------------------------------------------------------------------------------------------------------------------------------------------------------------------------------------
------------------------------------------------------------------------------------------------------------------------------------------------------------------------------------------------
-----------------------------------------------------------------SS------------------------------------S--------SSSSSS--------------------------SSSSSS------------------------------------------
---------------------------------------------------------------------------------------------------------------------------------------------ooo----------------------------------------------oo
------------------------------------------------------------------------------------------------------------------------------------------------------------------------------------------------
--------%%%%%%%%----------------------SSS-------------------------------------------QQQS------o--So-----------oS-------------------SQSQ------SSS-------------------------------b---SQ---------@T
---------||||||---------------------------------------------------------------------------------------------------------------------------------------------------------------------------------
---------||||||---------------------------------------------------------------SS--------------------------------------------------------------o-----------------------------------------------o-
---------||||||--------------------------------------------------o------------------------------o-oo--------------------------------------------------------------------------------------------
------%%%%%%%%%%---------------------o-------U----------------------------------Q-QQ------------S-SS----------------------------Q-QQ---------USS---------------------------------------------US-
-------||||||||----------------------------------------tt----------------------------------------------------------------------------------------------t-----------------TT---------------------
-------||||||||--------B-TT----------------------------t-------------------------------------------------TT-------B---t--------------------------------t-----------------TT----@---------TT-----
-------||||||||-g------b-TT----------kk-----kkk---gggg-t----kkk------g------kkk----kggy--------------kgg-TT-------b---ty----k-kg---kggy---k-k---TT---kkk----kkk---kggg---TT----g---ggggg-##-----
XXXXXXXXXXXXXXXXXXXXXXXXXXXXXXXXXXXXXXXXXXXXXXXXXXXXXXXXXXXXXXXXXXXXXXXXXXXXXXXXXXXXXXXXXXXXXXXXXXXXXXXXXXXXXXXXXXXXXXXXXXXXXXXXXXXXXXXXXXXXXXXXXXXXXXXXXXXXXXXXXXXXXXXXXXXXXXXXXXXXXXXXXXXXXXXX
XXXXXXXXXXXXXXXXXXXXXXXXXXXXXXXXXXXXXXXXXXXXXXXXXXXXXXXXXXXXXXXXXXXXXXXXXXXXXXXXXXXXXXXXXXXXXXXXXXXXXXXXXXXXXXXXXXXXXXXXXXXXXXXXXXXXXXXXXXXXXXXXXXXXXXXXXXXXXXXXXXXXXXXXXXXXXXXXXXXXXXXXXXXXXXXX
