------------------------------------------------------------------------------------------------------------------------------------------------------------------------------------------------
------------------------------------------------------------------------------------------------------------------------------------------------------------------------------------------------
------------------------------------------------------------------------------------------------------------------------------------------------------------------------------------------------
------------------------------------------------------------------------------------------------------------------------------------------------------------------------------------------------
------------------------------------------------------------------------------------------------------------------------------------------------------------------------------------------------
-------------------------------------------------------------------------------------------------------------------------------U----------------------------------------------------------------
--------%%%%%%%%--QSQQS@SQQQSSSS-------------------------------------------Q---Q----------------------------------------SSS----------------------------------------Q-----SSS---@----------------
---------||||||---------------------------oo----------------------------------------------------------------------------------------------o-----------------------------------------------------
---------||||||-------------------------------------------------------------------------------------------------------------------------------------------------------------------------SS------
---------||||||-----------------------------------------------------------------------------------------S------------------------------------------------------------------------------SSSS-----
------%%%%%%%%%%QSQS---SQQQQQQ----S---------------------S---------@------------Q--2---------------------S---------2-------------------------------@-----SS---Q----y---------------------SSS-----
-------||||||||------------------------TT---------------------------tt---------------------tt-------tt------------------------------tt--------------tt--------------K---------------------------
-------||||||||---------------------tt-TT---------------------------tt-----B---------------tt-------tt---------------------B--------tt--------------tt---------------------tt-------tt----------
-------||||||||---------------g-----tt-TT-------K-------------g-g---tt-----b--g------------tt---K---tt----------K-K-----------------tt----------K---tt----------K-K--------bt-------------k-----
XXXXXXXXXXXXXXXXXXXXXXXXXXXXXXXXXXXXXXXXXXXXXXXXXXXXXXXXXXXXXXXXXXXXXXXXXXXXXXXX-----X--X--XXXX-XXXXXXXXXXXXXXXXXXXXXXXXXXXXXXXXXXXXXXXXXXXXXXXX-XXXXXXXXXXXXXXXXXXXXXXXXXXXXXXXXXXXXXXXXXXXXXXX
XXXXXXXXXXXXXXXXXXXXXXXXXXXXXXXXXXXXXXXXXXXXXXXXXXXXXXXXXXXXXXXXXXXXXXXXXXXXXXXX-----X--X--XXXX-XXXXXXXXXXXXXXXXXXXXXXXXXXXXXXXXXXXXXXXXXXXXXXXX-XXXXXXXXXXXXXXXXXXXXXXXXXXXXXXXXXXXXXXXXXXXXXXX
