------------------------------------------------------------------------------------------------------------------------------------------------------------------------------------------------
------------------------------------------------------------------------------------------------------------------------------------------------------------------------------------------------
----------------#-------------------------------------------------------------------------------------------------------------------------------------------------------------------------------
----------------#--------------#-------------------------------------------------SS-----------------------------------------------------------------------------SSSSSSS-------------------------
--------------------------------------------------------------------------------------------------------------------------------------------------------------o---------------------------------
-----------------------------------------------#---------------------------------------------------g--------------------------------------------------------------------------------------------
--------%%%%%%%%----------------------------------------------------Q------------------------------2QQ---------S-------------------------------o---SQS-------------------------U----------------
---------||||||----------------%-------------------------------------------------------------------------------------------------------------------------------------------------#--------------
---------||||||------------##--|------------------------------------------------------------------------------o-------------------------------o---------------o---------------------------------
---------||||||------------##--|-----------##------------------------------------------#--------------------------------------------------------------------------------------------------------
------%%%%%%%%%%-----------#---|-----------##---------------Soo--------------US--------#--------QQQQ---------USS------------------------------S---Q----------US---------------------------#-----
-------||||||||------------#---|----------###------------------------------------------#---------------------------------TT--------------------------------------------------------------##-----
-------||||||||--------###-#%%%%---------####------------------------------------------#-----------------------------B---TT----o--------------------------------------------------TT----###-----
-------||||||||--------####--||----gggg--####-----o---------k--g--gggggg--k-k-k------k-#----kkk----k------k-------kg-g-k-TT----#--kkgggg--k---k---gggggg--k-k--------k-k------kg--TT---####-k---
XXXXXXXXXXXXXXXX-%%%--XXXXX--||-XXXXXXXXXXXXXXX-XXXXXXXXXXXXXXXXXXXXXXXXXXXXXXXXXXXXXXXXXXXXXXXXXXXXXXXXXXX-XXXXXXXXXXXXXXXXX-XXXXXXXXXXXXXXXXXXXXXXXXXXXXXXXXXXXXXXXXXXXXXXXXXXXXXXXXXXXXXXXXXX
XXXXXXXXXXXXXXXXX-|---XXXXX--||-XXXXXXXXXXXXXXX-XXXXXXXXXXXXXXXXXXXXXXXXXXXXXXXXXXXXXXXXXXXXXXXXXXXXXXXXXXX-XXXXXXXXXXXXXXXXX-XXXXXXXXXXXXXXXXXXXXXXXXXXXXXXXXXXXXXXXXXXXXXXXXXXXXXXXXXXXXXXXXXX
