------------------------------------------------------------------------------------------------------------------------------------------------------------------------------------------------
-----------------------------------------------------------------------------------------------------------------------------------------------------------------K------------------------------
------------------------------------------------------------------------------------------------------------------------------------------------------------------------------------------------
------------------------------------------------------------------------------------------------------------------------------------------------------------------------------------------------
------------------------------------------------------------------------------------------------------------------------------------------------------------------------------------------2-----
---------------------------------------------------------------------------------------------------------------U--------------------------------------------------------------------------------
--------%%%%%%%%---SSSS---SSS-@--------------------------------------------------------------------------------------------------------------------------------------------------------@-------Q
---------||||||---------------------------------------------------------------------------------------------------------------------------------------------------------------------------------
---------||||||---------------------------------------------------------------------------------------------------------------------------------------------------------------------------------
---------||||||------------------------------------------S---------------------------------------------------------------------------------------------------g----------------------------------
------%%%%%%%%%%---SSS---------S------------------------SS----------------------------------------2----------##--------------------@Q-------------------------Q-------------------2-----@----Q--
-------||||||||------------------------------##--------------#----------------------------------------------###---------------------------------------------------------------------------------
-------||||||||-----------------------------###-------------##----------------------------------------------###--------------------------TT-------------------------------------------------##--
-------||||||||----k---k--------------------###-K-------y--###-------------gg-gg----------------K-------y-#####-----y--------------ggg--kTT----g-----g---------------g-g---gg-ggg-------K--y##--
XXXXXXXXXXXXXXXXX--XXXXXXXXXXX-XXXXXXXXXXXXXXXXXRXX--XXXXXXXXXXXXXXXXXXXXXXXXXXXXXXXXXXXXXXXXXXXR---XXXXXXXXXXXXXXXXXXXXXXXXXXXXXXXXXXXXXXXXXXXXXXXXXXXXXXXXXXXXXXXXXXXXXXXXXXXXXXXXXXXXXXXXXXXX
XXXXXXXXXXXXXXXXX--XXXXXXXXXXX-XXXXXXXXXXXXXXXXXXXX-XXXXXXXXXXXXXXXXXXXXXXXXXXXXXXXXXXXXXXXXXXXXX---XXXXXXXXXXXXXXXXXXXXXXXXXXXXXXXXXXXXXXXXXXXXXXXXXXXXXXXXXXXXXXXXXXXXXXXXXXXXXXXXXXXXXXXXXXXX
