--------------------------------------------------------------------------------------------------------------------------------------------------------------------------------
--------------------------------------------------------------------------------------------------------------------------------------------------------------------------------
--------------------------------------------------------------------------------------------------------------------------------------------------------------------------------
SSSSSSSS------------------------------------------------------------------------------------------------------------------------------------------------------------------------
S-------------------------------------------------------------------------------------------------------------------------------------------------------------------------------
-------------------------------------------------------------------------------------------------------------------------------U------------------------------------------------
SSSoo------------------------------------------------------------------------------------------------------------------@S----------------------------------Q--------------------
--------------------------------------------------------------------------------------------------------------------------------------------------------------------------------
----------------------------------------S---------------------------------------------------------------------------------------------------------------------------------------
------------------1---------------------SS--------------------------------------------------------------------------------------------------------------------------------------
---------TT-------------------SQ----------------QQ------S---------@-----@S---Q----S-------------------------------2----SS-----------------------QQ------QQQQ------------S----Q--
---------TT----------------------------------------------------------------------K---------------K--K--TT--------------------##-----K-------------------------------tt----------
---------TT----#--------------------tt--------#-----tt---------------------------------TT--------------TT--B----------------###---------------------tt--------------tt------##--
-----y---TT----#-----------g----K---tt-----y###-g---tt----g-----K---------------K-K----TT---------K----TT--b----K-------U-#####---------------------tt--------ggK---tt--y--####-
XXXXXXXXXXX---XXX---XXXXXXXXXXXXXXXXXXXXXXXXXXXXXXXXXXXXXXXXXXXXXX--XXXXXXXXXXXXXXXXXXXXXXXXXXXXXXXXXXXXXXXXXXXXXXXXXXXXXXXXXXXXXXXXXXXXXXXXXXXXXXXXXXXXXXXXXXXXXXXXXXXXXXXXXXXX
XXXXXXXXXXXX--XXX---XXXXXXXXXXXXXXXXXXXXXXXXXXXXXXXXXXXXXXXXXXXXXX--XXXXXXXXXXXXXXXXXXXXXXXXXXXXXXXXXXXXXXXXXXXXXXXXXXXXXXXXXXXXXXXXXXXXXXXXXXXXXXXXXXXXXXXXXXXXXXXXXXXXXXXXXXXX
