------------------------------------------------------------------------------------------------------------------------------------------------------------------------------------------------
------------------------------------------------------------------------------------------------------------------------------------------------------------------------------------------------
------------------------------------------------------------------------------------------------------------------------------------------------------------------------------------------------
------------------------------------------------------------SS----------------------------------------------------------------------------------------------------------------------------------
------------------------------------------------------------------------------------------------------------------------------------------------------------------------------------------------
------------------------------------------------------------------------------------------------------------------------------------------------------------------------------------------------
--------%%%%%%%%-------------------------------------------------------@--------SS----------------------------------------------------U---------------------------------------------------------
---------||||||----------------y-------------------------oo------------------------oo-----------------------------------------------##%%--------------------------------------------------------
---------||||||---------------##--------------------------K---------------------------------------------S-----------------------------||--------------------------------------------------------
---------||||||--------------2##------------------------------------------------------------------------------##----------------------||------------------------------------------------SS------
------%%%%%%%%%%------------####-----------------SS--------------US-------------------------------2-----------#-----tt----------QS----||----------2-------------------------------------SS------
-------||||||||------------#####---------------T--------------------------------TT-------TT------------------##-----tt----------------||--------------------------------------------------------
-------||||||||-----------######--------------TT---------------------t----------TT-------TT----T----tt------###-----tt--------------TT||------------tt------------------T-----------------------
-------||||||||----------#######--------------TTggg-------g-----ggg--t--y-ggg-g-TT---y---TT----TK---tt-----####-g---tt--------------TT||------ggK---tt------------K----TT-------K---------------
XXXXXXXXXXXXXXXXXXXXXXXXXXXXXXXXXXXXXXXXXXXXXXXXXXXXXXXXXXXXXXXXXXXXXXXXXXXXXXXXXXXXXXXXXXXXXXXXXXXXXXXXXXXXXXXXXXXXXXXXXXXXXXXXXXXXXXXXXXXXXXXXXXXXXXXXXXXXXXXXXXXXXXXXXXXXXXXXXXX-XXXXXXXXXXXX
XXXXXXXXXXXXXXXXXXXXXXXXXXXXXXXXXXXXXXXXXXXXXXXXXXXXXXXXXXXXXXXXXXXXXXXXXXXXXXXXXXXXXXXXXXXXXXXXXXXXXXXXXXXXXXXXXXXXXXXXXXXXXXXXXXXXXXXXXXXXXXXXXXXXXXXXXXXXXXXXXXXXXXXXXXXXXXXXXXX-XXXXXXXXXXXX
