------------------------------------------------------------------------------------------------------------------------------------------------------------------------------------------------
------------------------------------------------------S-----------------------------------------------------------------------------------------------------------------------------------------
------------------------------------------------------------------------------------------------------------------------------------------------------------------------------------------------
------------------------------------------------SSSSSSS---------------------------------------------------------SSSSSSSS------------------------------------------------------------------------
------------------------------------------------------------------------------------------------------------------------------------------------------------------------------------------------
-----------------ooo----------------------------------------------------------------------------------------------------------------------------------------------------------------------------
--------%%%%%%%%%%%%SS-----------oo--------------------------------------------o--------oo---o-o--------oo-----------QQo-------o-oo-----o-----SS---------------------------------oo---Soo----oo-
---------||||||--||-------------------------------------------------------------SS--------------------------------------------------------------------------------------------------------------
---------||||||--||--------------------------------------------------------------------------------------------------------------------------------------------------------------------------SS-
---------||||||--||-------------------------------------------------------------------SoS--SSS----------------------------------oo-----------------------------------------------------g---SSSSS
------%%%%%%%%%%-||------SSSS@S---------------------------------------------------#-----------------------------######-------Q--S-----------------#-#S##-----S--------------------#---Q#Q---SSSS
-------||||||||--||----------------------------------tt--------------------------###----------------------------####----------------------------TT#----K--------------------------##-##---------
-------||||||||--||----------------------------------tt-------------------------####----------------------------####------------------#---------TT#------------------------------####-----------
-------||||||||--||kggg--------g----g-----k-k--------tt-----k-k----k-ggy----k-k-####-------gg-------------------###---kk---k-k-------##----yk---TT#----k---kk--g--gk---g--------#####kk----k----
XXXXXXXXXXXXXXXXXXXXXXXXXXXXXXXXXXXXXXXXXXXXXXXXXXXXXXXXXXXXXXXXXXXXXXXXXXXXXXXXXXX--XXXXXXXXXXXXXXXXXXXXXXXXXXXXXXXXXXXXXXXXXXXXXXXXXXXXXXXXXXXXXX--XXXXXXXXXXXXXXXXXXXXXXXXXXXXXXXXXXXXXXXXXXX
XXXXXXXXXXXXXXXXXXXXXXXXXXXXXXXXXXXXXXXXXXXXXXXXXXXXXXXXXXXXXXXXXXXXXXXXXXXXXXXXXXX--XXXXXXXXXXXXXXXXXXXXXXXXXXXXXXXXXXXXXXXXXXXXXXXXXXXXXXXXXXXXXX--XXXXXXXXXXXXXXXXXXXXXXXXXXXXXXXXXXXXXXXXXXX
