------------------------------------------------------------------------------------------------------------------------------------------------------------------------------------------------
------------------------------------------------------------------------------------------------------------------------------------------------------------------------------------------------
------------------------------------------------------------------------------------------------------------------------------------------------------------------------------------------------
----------------SSSSSSS--SSSSSSS-#----------------------------------------------SSSSSSSS-SS-----------------------------------------------------SSSSSSSS----------------------------------------
-----------------------------------------------------------------------------------------------------------------------------------------o------------------------------------------------------
--------------------------------------------------------------------------------------------------------------------------------------------------------------------------------o---------------
--------%%%%%%%%---------------o---------------o--------------------------------------------------------------------QQQQ--------S-SSSSSSSS---S-------------------------------------SQQQ---------
---------||||||------------#--##----------------------------------------------------------------------------------------------------------------------------------------------------------------
---------||||||-----------######----------------------------------------------------------------------------------------------------------------------------------------------K---------------o-
---------||||||---------########----------------------------------------------------------------------------------------------------------------------------------------------------------------
------%%%%%%%%%%--------#######----------------------------------------------------------------------------------------------U--@SQQSSSSS----USS---------------------------------#-----------US-
-------||||||||-------#########--------------------------------------------------------tt-----------------B---------------------------------------------------------------#---------------------
-------||||||||------##########----------TT--------------------------------------------tt---------B-----------------------------------------------B----------------------##---------------------
-------||||||||------##########---kkg----TT---kg--y----------g-g----gg-----------#y----tt---kkgg--b-----------kg--gk-ggk----k------k-gy---k-------b----k------kg---k---g##k-------gggggg--k-k---
XXXXXXXXXXXXXXXXXXXXXXXXXXXXXXX-XXXXXXXXXXXXXXXXXXXXXXXXXXXXXXXXXXXXXXXXXXXXXXXXXXXXXXXXXXXXXXXXXXXXXXXXXXXXXXXXXXXXXXXXXXXXXXXXXXXXXXXXXXXXXXXXXXXXXXXXXXXXXXXXXXXXXXXXXXXXXXXXXXXXXXXXXXXXXXXX
XXXXXXXXXXXXXXXXXXXXXXXXXXXRXXX-XXXXXXXXXXXXXXXXXXXXXXXXXXXXXXXXXXXXXXXXXXXXXXXXXXXXXXXXXXXXXXXXXXXXXXXXXXXXXXXXXXXXXXXXXXXXXXXXXXXXXXXXXXX-XXXXXXXXXXXXXXXXXXXXXXXXXXXXXXXXXXXXXXXXXXXXXXXXXXXX
