------------------------------------------------------------------------------------------------------------------------------------------------------------------------------------------------
------------------------------------------------------------------------------------------------------------------------------------------------------------------------------------------------
------------------------------------------------------------------------------------------------------------------------------------------------------------------------------------------------
--------------------------------------------------------------------------------SSSSSSSSS------------------------------S-SS-----SSSSSSS------------------------------SSSSS------SSSSSSSSSSSSSSSS
--------------------------------------------------------------------------------S---------------------------------------------------------------------------------------------------------------
------------------------------------------------------------------------------------------------------------------------------------------------------------------------------------------------
--------%%%%%%%%-------S-------------------------------SSS-----o----------SS--------------SSSSS--------SoS--------------------So----------------#---------------oooo----oo----S-----------------
---------||||||------------o-----------------------%%%---------#--------------------------------------------------------------------------------------------------------------------------------
---------||||||-------------------------------------|--------###--------------------------------------------------------------------------------------------------------------------------------
---------||||||-----------------oo------------------|-------####------------------------------------------------o-----------------------------------------------o------------------------o------
------%%%%%%%%%%----------------%SQS----------------|------#####-------------SSo------tt--------SSQoS-SS----------------------------------------SSS---------------------------------------------
-------||||||||-----------------|-------------------|-----######----------------------tt----------------------------------#---------------------------------------------------------------------
-------||||||||-----------------|-------------------|----#######----------------------tt----------------------------------#----------------------------##----------------##---------------------
-------||||||||-----------------|-gg----------------|----#######-------b----k---------tt---k-k%-------------------kgggg--##g------y---ky----kkkg--gggg###-----------g---###-k-----g-----------g-
XXXXXXXXXXXXXXXXXXXXXXXXXX%%%KXXXXXXXXXXXX---XXXXXXXXXXXXXXXXXX-XXXXXXXXXXXXXXXXXXXXXXXXXXXXXXXX-XXXXXXXX----XXXXXXXXXXXXXXXXXXXXXXXXXXXXXXXXXXXXXXXXXXXXXXXXXXXXXXXXXXXXXXXXXXXXXXXXXXXXXXXXXXX
XXXXXXXXXXXXXXXXXXXXXXXXXX-|-XXXXXXXXXXXXX---XX-XXXXXXXXXXXXXXXoXXXXXXXXXXXXXXXXXXXXXXXXXXXXXXXXXXXXXXXXX----XXXXXXXXXXXXXXXXXXXXXXXXXXXXXXXXXXXXXXXXXXXXXXXXXXXXXXXXXXXXXXXXXXXXXXXXXXXXXXXXXXX
