------------------------------------------------------------------------------------------------------------------------------------------------------------------------------------------------
------------------------------------------------------------------------------------------------------------------------------------------------------------------------------------------------
------------------------------------------------------------------------------------------------------------------------------------------------------------------------------------------------
--------------------------------SSSSS---------------------------SSSSSSS---------SSS---------------------------------------------SSSSSSSS--------------------------------------------------------
------------------------------------------------------------------------------------------------------------------------------------------------------------------------------------------------
------------------------------------------------------------------------------------------------------------------------------------------------------------------------------------------------
--------%%%%%%%%---------------U------oo--------------SSSS-----o--------oo-------------oo-----SS-----QQQQ------------QQQQ--------------------------------------o--------o--------o------o------S
---------||||||---------------------------------------------------------------------------------------------------------------------------------------------------------------------------------
---------||||||----------------------------------------------------------------------------------------------------------------------------------------------o----------------------------------
---------||||||---------oo----------------------S----------------------------------------------------------------------------------------------------------------------g--------oo--------------
------%%%%%%%%%%-------------o-----------------------------------##---------------####Q-Q----SSo----------------TT---SSS-----Q----------------#---#----------oS---#--###Q---SS------------------
-------||||||||-----------------------tt------------------------####-------------##-----------------------------TT-------------------------#-##------------------##-----------------------------
-------||||||||-----------------------tt------------------------####-------------##--------------##-------------TT---------------------#---#-###----------------###------------------tt---------
-------||||||||---kk-g-k-------g#-----tt----kk-----g---------#--###---g----k-k--###----k----k----##--kk-----k---TT--------k-k---------##---#####-----k----kgk---###--------kk--------tt---------
XXXXXXXXXXXXXXXXXXXXXXXXXXXXXXXXXXXXXXXXXXXXXXXXXXXXXXXXXXXXXXXXXXXXXXXXXXXXXXXXXXXXXXXXXXXXXXXXXXXXXXXXXXXXXXXXXXXXXXXXXXXXXXXXXXXXXXXXXXXXXXXXXXXXXXXXXXXXXXXXXXXXXXXXXXXXXXXXXXXXXXXXXXXXXXXX
XXXXXXXXXXXXXXXXXXXXXXXXXXXXXXXXXXXXXXXXXXXXXXXXXXXXXXXXXXXXXXXXXXXXXXXXXXXXXXXXXXXXXXXXXXXXXXXXXXXXXXXXXXXXXXXXXXXXXXXXXXXXXXXXXXXXXXXXXXXXXXXXXXXXXXXXXXXXXXXXXXXX-XXXXXXXXXXXXXXXXXXXXXXXXXXX
