------------------------------------------------------------------------------------------------------------------------------------------------------------------------------------------------
---------------------------------------------------------------------------------------------------------------------------------K--------------------------------------------------------------
------------------------------------------------------------------------------------------------------------------------------------------------------------------------------------------------
----------------SS-------------------------------SS---------------------------------------------SSSSSSSS-----------------------------------------SS---------------------------------------------
----------------------------------------------oo-----------------------------------------------------------------------------Uoo----------------------------------------------oo--------------o-
------------------------------------------------------------------------------------------------------------------------------------------------------------------------------------------------
--------%%%%%%%%----------------ooo--------------------------------SQQQSSS---SSS---------------U--------------------QS----------SSoS-----------#--------------------QQQ---------S--S@SSSSSS--S@S
---------||||||----------------#----------------------------------------------------------------------------------------------------------------------------------------------------------------
---------||||||---------------##-------------------------------------------------------------oS------------------------------U---------------ooo----------------------------------------------o-
---------||||||---------------##---------------------------------o--------------------------------------------------------------ooo-------------------------------------------------------------
------%%%%%%%%%%--------------##-------------oS--------t--------QQQ----SS---S@SS---------------------------------------------US-SSS---------SSS---------------------------------SSQ--------SS@S-
-------||||||||---------------##---------TT------------t----------------------------------B---------------#----------------------------------------------TT-------------------------------------
-------||||||||--------------###---------TT------------t----------------------------------b--------------t----B------------------------------------------B--------------------------------------
-------||||||||------------#-###---gggk--TT---kg--k---ty----kkk---gggggg--k-k-----kggggg------k---k--gtgttk---b---gggggg--k-k-k----k-kk-----------kk-k-k-t----gg---ygggg--k-k-----ggggy---k-----
XXXXXXXXXXXXXXXXXXXXXXXXXXXXXXX-XXXXXXXXXXXXXXXXXXXXXXXXXXXXXXXXXXXXXXXXXXXXXXXXXXXXXXXXXXXXXXXXXXXXXXXXXXXXXXXXXXXXXXXXXXXXXXXXXXXXXXXXXXXXXXXXXXXXXXXXXXXXXXXXXXXXXXXXXXXXXXXXXXXXXXXXXXXXXXXX
XXXXXXXXXXXXXXXXX-XXXXXXXXXXXXX-XXXXXXXXXXXXXXXXXXXXXXXXXXXXXXXXXXXXXXXXXXXXXXXXXXXXXXXXXXXXXXXXXXXXXXXXXXXXXXXXXXXXXXXXXXXXXXXXXXXXXXXXXXXXXXXXXXXXXXXXXXXXXXXXXXXXXXXXXXXXXXXXXXXXXXXXXXXXXXXX
