-------------------------S----------------------------------------------------------------------------------------------------------------------------------------------------------------------
-------------------------S----------------------------------------------------------------------------------------------------------------------------------------------------------------------
------------------------------------------------------------------------------------------------------------------------------------------------------------------------------------------------
----------------------------------------------------------------------------------------------------------------SSSSSSSS------------------------------------------------------------------------
---------------------------------------------------------------o----------------------------------------------oo-----------------------------------------------o--------------------------------
------------------------------------------------------------------------------------------------------------------------------------------------------------------------------------------------
--------%%%%%%%%-----SSS-----S-----------S-----U----QQQQ-------------------------------oo----------SQS-------SS%--------------------Q-----------S---Q----S----So-o-------------o----------------
---------||||||------------------------------------------------------------------------------------------------|--------------------------------------------------------------------------------
---------||||||------------------------------o----------------------------------------------------------------o|------------------------------o--------------oo---------------------------------
---------||||||-----------SS---S-------------------------------------------------------------------------------|---------------------------------o--------------ooo-----------------------------
------%%%%%%%%%%-SSoS----------S-------------oS--#--S#-------U-------------------------------o---QQ------S%SS@S|------------------------------S--S-----------@S--------------o------------------
-------||||||||---------#------------------------------------------------TT-----------tt------------------|----|---------------------------------------------------------TT---------------------
-------||||||||--------##------------------------------------------------TT-----------tt------------------|----|-----tt----------------------------------------------B---TT-----------tt--------
-------||||||||-------###---------kggggg------k----k--g---k-k-----gk-----TT---kg------tt---kkkk---kgggy---|----|-----tt------kkg--gggggg--k-------gggggg--k-k-----kk-goy-TT----g--b---tt----k-k-
XXXXXXXXXXXXXXXXXXXXXXXXXX--XXXXXXXXXXXXXXXXXXXXXXXXXXXXXXXXXXXXXXXXXXXXXXXXXXXXXXXXXXXXXXXXXXXXXXXXXXXXXXX-XXXXXXXXXXXXXXXXXXXXXXXXXXXXXXXXXXXXXXXXXXXXXXXXXXXXXXXXXXXXXXXXXXXXXXXXXXXXXXXXXXXX
XXXXXXXXXXXXXXXXXXXXXXXXXX--XXXXXXXXXXXXXXXXXXXXXXXXXXXXXXXXXXXXXXXXXXXXXXXXXXXXXXXXXXXXXXXXXXXXXXXXXXXXXXX-XXXXXXXXXXXXXXXXXXXXXXXXXXXXXXXXXXXXXXXXXXXXXXXXXXXXXXXXXXXXXXXXXXXXXXXXXXXXXXXXXXXX
