------------------------------------------------------------------------------------------------------------------------------------------------------------------------------------------------
------------------------------------------------------------------------------------------------------------------------------------------------------------------------------------------------
------------------------------------------------------------------------------------------------------------------------------------------------------------------------------------------------
----------------SSSSSSSSSS----------------------------------------------------------------------------------------------------------------------------------------------------------------------
------------------------------------------------------------------------------------------------------------------------------------------------------------------------------------------------
------------------------------------------------------------------------------------------------------------------------------------------------------------------------------------------------
--------%%%%%%%%-------#------------------------------------Q-@----------------------------------------------------------------------------------------------------------------o-1-------------U
---------||||||-------###-----------------------------------------------oooo------------oo------------------------------ooo--------------o-----------------------------------------------oo-----
---------||||||-S----####--------%%%%-------------%%---------------------%%----------------------------%---------------%--@---------------%-----------------------------------------------------
---------||||||-S---#####---------||----SSS-------||------------g-g------||1----o---------Q--------o---|--------g-o----|----------g-------Q-----------------------------------------------------
------%%%%%%%%%%---#####----------||--------------||---------------------||---#---%-----------#--------|---------------|------#---------------#---2----------------------------Q----------------
-------||||||||---TT#####---------||--------------||---------------------||---#---|-----------#--------|---------------|------#---------------#-----tt---------------------tt-------------------
-------||||||||--#TT#####-------T-||------------B-||------%%%%%----------||---#---|-----------#--------|---------------|------#--------------##-----tt-------#-------------tt---T----------tt---
-------||||||||-##TT#####-------T-||------------b-||-------|||g----------||---#---|-----------#--------|---------------|------#------------####-K---tt-----b###-K----------tt---T----------tt-g-
XXXXXXXXXXXXXXXXXXXXXXXXX---XXXXXXXXXX--XXXXXXXX--|%%%%%---|||---XXX-X--XXXXXXXX--|-------XXXXXXXXXXXX-XXXXXXXXX-------|--XXXXX---XX-X-XXXXXXXXXXXXXXXXXXXXXXXXXXXXX-XXXXXXXXXXXXXXXXXXXXXXXXXXX
XXXXXXXXXXXXXXXXXXXXXXXXX---XXXXXXXXXX--XXXXXXXX--|-|||----|||---XXX-X-XXXXXXXXX--|--X--XXXXXXXXXXXXXX-XXXXXXXXX-------|-XXXXXXX--XX-X-XXXXXXXXXXXXXXXXXXXXXXXXXXXXXXXXXXXXXXXXXXXXXXXXXXXXXXXXX
