------------------------------------------------------------------------------------------------------------------------------------------------------------------------------------------------
------------------------------------------------------------------------------------------------------------------------------------------------------------------------------------------------
------------------------------------------------------------------------------------------------------------------------------------------------------------------------------------------------
----------------SSSSSSSS-SSSSSSS------------------------------------------------------------------------------------------------------------------------------------------------SSSSSSS---------
------------------------------------------------------------------------------------------------------------------------------------------------------------------------------------------------
---------------------------------------%%%-------------------------------%%---------------------------------------------------------------------Q----o------------------------------------------
--------%%%%%%%%orrr-------------%%-----|-----------QS---------U-%%------||-------------------------Q----------U---------------U--------------------QQQQQS------SS--Q----------o----------------
---------||||||-%%%%%------------||-----|------------------------||------||---------------------------------------------------------------------------------------------------------------------
---------||||||-S|||------%%%S---||-----|--------------------oo--||------||--------------------------------------------------------------------------------------------------oo-----------------
---------||||||--|||-------|-----||-----|--------o---------------||--%---||------------------SS-------------------------------------------------------------------------------------------------
------%%%%%%%%%%-|||-------|-----||----tt--------2----------S@S--||--|---||------SSS------------------------SoS----------------------------------U-----------US--------------US-----------------
-------||||||||--|||tt-----|-----||----tt-----------------K------||--|---||-------------#-----------------K--------------TT------------tt-------------------------------------------------------
-------||||||||-%%||tt---#-|-----||----tt----TT------------------||--|---||------------##-----------------b--------------TT------------tt--------------------------------------------tt---------
-------||||||||-||||tt-----|-r---||----tt----TT---gggggg--k-k---%||--|-g-||--ggg------###---------gggggg--k---k---kgg----TT-------g----tt---kg-g---k--k---k-k-----ggggg---k-k-----k--tt---#-----
XXXXXXXXXXXXXXXX||XXXXXXXX-|-%%%XXX-XXXXXXXXXXXXXXXXXXXXXXXXXXXXXXXXXXXXXXXXXXXX-XXXXXXXX----X-XXXXXXXXXXXXXXXXXXXXXXXXXXXXXXXXXXXXXXXXXXXXXXXXXXXXXXXXXXXXXXXXXXXXXXXXXXXXXXXXXXXXXXXXXXXXXXXXX
XXXXXXXXXXXXXXXX||XX-XXXXX-oo-|oXXX-XXXXXXXXXXXXXXXXXXXXXXXXXXXXXXXXXXXXXXXXXXXX-XXXXXXXX------XXXXXXXXXXXXXXXXXXXXXXXXXXXXXXXXXXXXXXXXXXXXXXXXXXXXXXXXXXXXXXXXXXXXXXXXXXXXXXXXXXXXXXXXXXXXXXXXX
