----------------------------------------------------------------------------------------------------------------------------------------------------------------
----------------------------------------------------------------------------------------------------------------------------------------------------------------
-----------------------------------------------------------------------------------------------------------2-----------------------------------------------2----
---SSSSSSSSSSSSS--------------------------------------------------------------------------------------------------------------------S---------------------------
-----SSS--S-----------------------------------------------------------------------------------------------------------------------------------------------------
-----SS--S-----U-----------------------------------------------U------------------------------------------------------------------------------------------------
------SSSS-S--SS------------------SQ---@SSSS---S--QQQ-SSSQQ----Lo----o-----oo-2%----------------QSQS@QSSSSS@--@%-------@---------------#--------oo---U---ooo--@%
-------------------------------y---------------------------------------------K-|-------------------------------|-----------------------#-----------------------|
--S---SS-----------------------#--------------------------------S----#---------|------#------------------------|----------------SS----##--S--------------SSS---|
-----------------------------###-----------------------------1-------#---------|------#------------------------|---------------------###------------#----------|
------%%%%------------------####--2------------S---QQ-----QQ-#-----###----S-o--S---#--#--------------------QQQQQ--2-----------------####--S--------#------SSQ--|
-------||----------#-------#####----------------------------##------##------------##--#--------------------------------------------#####-----------#-----------|
------SSSSS--------#------######-----------B---------------###---#--##-----------####-#---------%%------B------------------B------######---------#-#-#---------|
-------------------#-----#######K----------b--g-------K-K-####--#---##-------ggg-######---------gg---K--b-ggg-g-K----------b--#--#######---------#-###-------gg|
--%%%%%--------XXXXXXXXXXXXXXXXXXXXXXXXXXXXXXXXX--XXXXXXXXXXXXXXXX--XXXX-XXXXXXXXXXXXXXXXXXXXXXXXXXXXXXXXXXXXXXXXXXXXXXXXXXXXXXXXXXXXXXX----XX-XXXXXXXXXX---@XQX
g--|||---------XXXXXXXXXXXXXXXXXXXXXXXXXXXXXXXXX--XXXXXXXXXXXXXXXXX-XXXXXXXXXXXXXXXXXXXXXXXXXXXXXXXXXXXXXXXXXXXXXXXXXXXXXXXXXXXXXX-XXXXX----XX-XXXXXXXXXX---XXXX
