--------------------------------------------------------------------------------------------------------------------------------------------------------------------------------
--------------------------------------------------------------------------------------------------------------------------------------------------------------------------------
----------------------------------------------------------------------------------------------------------------------------------------------------------------t---------------
----------------------------------------------------------------------------------------------------------------------------------------------------------------t---------------
--------------------------------------------------------------------------------------------------------------------------------------------------------------------------------
---------------------------------------------------o--------------##------------------------------------------------------------------------------------------------------------
----------------------US-------------------------------------------------------------SS------------------------o---------------------------------------------S--SSS-------------
----ooo------------%%%%-------------------o---------%-%--------------------------------------------------o------------------------------------------------o--------ooo----------
--------------------||------------------------------|-|-----------------------------------------------------------------------------------K-------------------------------------
--------------------||------------------------------|-|------------------SS-----------------------------------------------------------------------------------------------------
---------------%--TT||SS----TT----SSS---------------|-S-----TT----S-------------------------------------------------------------------------------------------TTTT-------TT-----
T--------TT----|--TT||------TT----------------------|-------TT---------TT---------------------------tt------------------------TT-------TT--------------TT-----TTTT-------TT-----
T--------TT----|--TT||------TT--------------------TT|-------TT---------TT-----#---------------------tt-TT----------------TT---TT-------TT--B-----------TT-----TTTT----tt-TT-----
T--------TT----|--TT||-ggg--TT-----gy-----k-------TT|--k----TT---------TT--kkk#----gg--k------------tt-TT----------ggg-k-TT---TTK------TT--b-----------TT-----TTTT----ttkTT-----
XXXXXXX--XX----|-XXXXXXXXXXXXXXXXXXXXXXXXXXXXXXXXXXXXXXXXXXXXXXXXXXXXXXXXXXXXXXXXXXXXXXXXXXXXXXXXXXXXXXXXXXXXXXXXXXXXXXXXXXXXXXXXXXXXXXXXXXXXXXXXXXXXXXXXXXXXXXXXXXXXXXXXXXXXXXX
XXXXXXX--XX----|XXXXXXXXXXXXXXXXXXXXXXXXXXXXXXXXXXXXXXXXXXXXXXXXXXXXXXXXXXXXXXXXXXXXXXXXXXXXXXXXXXXXXXXXXXXXXXXXXXXXXXXXXXXXXXXXXXXXXXXXXXXXXXXXXXXXXXXXXXXXXXXXXXXXXXXXXXXXXXXX
