--------------------------------------------------------------------------------------------------------------------------------------------------------------------------------
--------------------------------------------------------------------------------------------------------------------------------------------------------------------------------
----------------------------------------------------------------------------------------------------------------t---------------------------------------------------------------
--------------------------------------------------------------------------------------------------------------------------------------------------------------------------------
----------------------------------------------------------------------------------------------------------------S---------------------------------------------------------------
--------------------------------------------------------------------------------------------------------------------------------------------------------------------------------
-------------------------------USS-------------------------------------------------------------o---------------oSS-------------------------------------------------------------o
----------------------------------------------------------------------------------------ooo--------------------------oo-------------------------o------------------------o------
--------------------------------------------------------------------------------------------------------------------------------------------------------------------------------
--------------------------------------------------------------------------------------------------------------------------------------------------------------------------------
--SS---------------QQ-----------------------------------------#-------------------S-----------------------------------------------2-----S-----------------------QQ--------------
----K--------#---------------------------TT---------tt--------#---------------------tt------------TT--------------TT-----TT-----------------------TT-----TT----------------tt---
------------##------------------------B--TT---------tt------###---------------------tt-TT---------TT-------------TTT--t--TT---------tt------------TT-----TT---------tt-----tt---
-----------####-----y-g---------------b-kTT----y----tt-----####--------k-------k----tt-TT---g-----TT---------ggg-TTT--t-kTT----gK---tt----b--#----TT---k-TT---ggggg-tt-----tt-g-
XXXXXXXXXXXXXXXXXXXXXXXXXXXXXXXXXXXXXXXXXXXXXXXXXXXXXXXXXXXXXXXXXXXXXXXXXXXXXXXXXXXXXXXXXXXXXXXXXXXXXXXXXXXXXXXXXXXXXXXXXXXXXXXXXXXXXXXXXXXXXXXXXXXXXXXXXXXXXXXXXXXXXXXXXXXXXXXX
XXXXXXXXXXXXXXXXXXXXXXXXXXXXXXXXXXXXXXXXXXXXXXXXXXXXXXXXXXXXXXXXXXXXXXXXXXXXXXXXXXXXXXXXXXXXXXXXXXXXXXXXXXXXXXXXXXXXXXXXXXXXXXXXXXXXXXXXXXXXXXXXXXXXXXXXXXXXXXXXXXXXXXXXXXXXXXXX
