--------------------------------------------------------------------------------------------------------------------------------------------------------------------------------
--------------------------------------------------------------------------------------------------------------------------------------------------------------------------------
--------------------------------------------------------------------------------------------------------------------------------------------------------------------------------
-----------------------------------------------------------SSS------SSSSSSSSSSS-----------------------S--SSSSS------------------------------SS-----------------------------SSS--
--------------------------------------------------------------------------------------------------------------------------------------------SS----------------------------------
------------------------------------------------------------------------S-------------------------------SS---S------------------------------SS-------------------------------S--
-------------------SSSSSSS------------SSSS---------SSSSS----SSSS--SSSSSSSSS-S------SSSSS---SSQSSSSSS--SSSS--SSS---SSSSSUS--SSSS---SSSSSS---SSSSSSSS---SS---SSSS---SSSSSS----SSS-
---------------------------------------------------------------------------------------------------------------------------------------------S----------------------------------
--------------------------------------------------------------------------------------------------------------------------------------------------------------------------------
-------------------oo------------------------------oo--------------oo---------------------S------------------------o---------------o-------------------------------o------------
#---T------------SSSSSS------------S-------------SSSSS-----------SSSSU------S-----SSS----SSS----------------------SSSU------------SSS------------------------------S------------
#---TT---------------------------------------------------------------------------------------------------TT------------------------------TT---TTTT-------TT----T---------TT---TT
----TT------------------------------------------------------------------------------------------T--------TT--------------TT--------------TT---TTTT-------TT----T---------TT---TT
----TT-------------g---g-k---------g-k-------------kk--k-----k-----ggggk----------K-------kkkk--T-----g-kTT--------ggg---TT----------y---TT--kTTTT----g-kTT----T-----y---TT---TT
X---XXXX-------XXXXXXXXXXXXXXXXXXXXXXXXXXXXXXXXXXXXXXXXXXXXXXXXXXXXXXXXXXXXXXXXXXXXXXXXXXXXXXXXXXXXXXXXXXXXXXXXXXXXXXXXXXXXXXXXXXXXXXXXXXXXXXXXXXXXXXXXXXXXXXXXXXXXXXXXXXXXXXXXX
X---XXXX-------XXXXXXXXXXXXXXXXXXXXXXXXXXXXXXXXXXXXXXXXXXXXXXXXXXXXXXXXXXXXXXXXXXXXXXXXXXXXXXXXXXXXXXXXXXXXXXXXXXXXXXXXXXXXXXXXXXXXXXXXXXXXXXXXXXXXXXXXXXXXXXXXXXXXXXXXXXXXXXXXX
