--------------------------------------------------------------------------------------------------------------------------------------------------------------------------------
--------------------------------------------------------------------------------------------------------------------------------------------------------------------------------
--------------------------------------------------------------------------------------------------------------------------------------------------------------------------------
-------SS--SSS------------------------------------------------------------------------------------------------------------------------------------------------------------------
----SSSSSSSSS-------------------------------------------------------------------------------------------------------------------------------------------------------------------
----SkSSSSSS-----------------oo-------------------##-----------------------------------------------o------------------------------##-------------------------oo-----------------
---SSSSSSSSS-S--------SS---------------------------------------oSS----------------------S-------------------------------------------------------S-------------------------------
-----SSS------------------------------------------------oo--------------------------------------------------------------------------------S-------------------------------------
----------------------------------------------------------------------------------------------------------------------------------------SS------S-------------------------------
---oooooSooS----------------------------------------------------------------------------------------------------------------------------SSS-------------------------------------
--SSSS%%%-----S----------------------------------------------------------TT--------------------------------------------------QQQ--S----------------------TT-------2-------------
---S---|------#----------TT-------------------------tt-------------------TT------------------#-----------TT----------------------------TT----------------TT---------------------
--SSSSSSS-----#----------TT------------TT-----------tt-------------------TT-----------------##-----------TT--------------TT------------TT---------T------TT---------------------
---k-----k----#-------gg-TT-------gg---TT-k-----g---tt-------------------TT-----------------###----------TT-----------g--TT----g-------TT----k----TT-----TT----------------y#---
XXSSSS-XXXXXXXXXXXXXXXXXXXXXXXXXXXXXXXXXXXXXXXXXXXXXXXXXXXXXXXXXXXXXXXXXXXXXXXXXXXXXXXXXXXXXXXXXXXXXXXXXXXXXXXXXXXXXXXXXXXXXXXXXXXXXXXXXXXXXXXXXXXXXXXXXXXXXXXXXXXXXXXXXXXXXXXXX
XX-----XXXXXXXXXXXXXXXXXXXXXXXXXXXXXXXXXXXXXXXXXXXXXXXXXXXXXXXXXXXXXXXXXXXXXXXXXXXXXXXXXXXXXXXXXXXXXXXXXXXXXXXXXXXXXXXXXXXXXXXXXXXXXXXXXXXXXXXXXXXXXXXXXXXXXXXXXXXXXXXXXXXXXXXXX
