--%-----------------------------------------------------------------------------------------------------------------------------------------------------------------------------
--|-----------------------------------------------------------------------------------------------------------------------------------------------------------------------------
--|-----------------------------------------------------------------------------------------------------------------------------------------------------------------------------
--|-----------------------------------------------------------------------------------------------------------------------------------------------------------------------------
--|--------------------------------------------------------------------------------k--------------------------------------------------------------------------------------------
%-%%-------------------------------------------------------------------------------#-------------------------------#------------------------------------------------------------
|-||---------------------------------------------------------------------SS------------------------------------o-------------------------------o%%------------------------------
|-||----oo----o-------------------------------------------o--------------------------------------------------------------oo---------------------||------------------------oo----
|-||---%%%%%%%----------------------------------------------------------------------------------------------------------------------------------||------------------------------
|-||----|||||-@--------------------------SSS---#------------------------------------------S-----------------------------------------------------||-TT---------------------------
|-||----|||||-#--------------T----------------#---------------------------QQQ-------------------------------------------------------------------|TTTT---------Q-----------------
|-||----|||||-#---TT--------TT---K-----TT----##----------------------------------------TT---------------------------tt-TT------------tt---------|TTTT------------------TT-------
|-||----|||||##---TT--------TT---------TT---###-------------------TT--B----------------TT-----#---------------------tt-TT------------tt---------|TTTT------------------TT-------
|-||----|||####---TT--------TT----K----TT--####-------------------TT--b------ggg-------TT-----#----------------kg---tt-TT------------tt-------g-|TTTT--------ggg-gg----TT-------
|-||----XXXXXXX-XXXXXXXXXXXXXXXXXXXXXXXXXXXXXXXXXXXXXXXXXXXXXXXXXXXXXXXXXXXXXXXXXXXXXXXXXXXXXXXXXXXXXXXXXXXXXXXXXXXXXXXXXXXXXXXXXXXXXXXXXXXXXXXXXXXXXXXXXXXXXXXXXXXXXXXXXXXXXXXX
|-||----XXXXXXX-XXXXXXXXXXXXXXXXXXXXXXXXXXXXXXXXXXXXXXXXXXXXXXXXXXXXXXXXXXXXXXXXXXXXXXXXXXXXXXXXXXXXXXXXXXXXXXXXXXXXXXXXXXXXXXXXXXXXXXXXXXXXXXXXXXXXXXXXXXXXXXXXXXXXXXXXXXXXXXXX
