--------------------------------------------------------------------------------------------------------------------------------------------------------------------------------
--------------------------------------------------------------------------------------------------------------------------------------------------------------------------------
----------U---------------------------------------------------------------------------------------------------------------------------------------------------------------------
---------------------------------------SSSSSS--------------------------------------------S--SS----------------------------------------------------------------------------------
--------------------------------------------------------------------------------------------------------------------------------------------------------------------------------
---------------------------------------------So------------------------------------------------------------------------------o--------------------------------------------------
QSSQQSSSSSSS---%-------------------SSSS-----SSSS----QQSSSS-----S-------SSSSS-S--SSSoSSR-----SS---------------SSS----SSS-----SS----QSQ-SSSS------------------SQ-------SS-----SSS-
---------------|------------------SSSS-----------------------------------------------------------------------------SS-----------------------------------------------------------
---------------|------------------SSSS------------------------------------------------------------------SS----------------------------------------------SS----------------------
---------------|-------------------SS--------------------------------------------------------------------SS---------------------------------------------SSS---------------------
----------SS@--|--SSS--------------SSS-------------S--------------SS--------------SSSU------------S-----------S----------TT-------SQQ-------------S------SSS------SSo-----------
---------------|----K-------##-----------TT----T------------##---------------------------TT------------------------------TT---TT-----------------------------------------TT----T
---------------|------------##-----------TT----T------------##---------------------------TT----------t-TT----------------TT---TT---------TT------------------------------TT----T
-----k-------gg|------------##-----k-----TT--k-T---g----g-####------------ggg------g-y-k-TT-------K--t-TT-kg-------------TT---TT---gggg-kTT---------------kkkk---------k-TT----T
XXXXXXXXXXXXXXX|XXXXXXXXXXXXXXXXXXXXXXXXXXXXXXXXXXXXXXXXXXXXXXXXXXXXXXXXXXXXXXXXXXXXXXXXXXXXXXXXXXXXXXXXXXXXXXXXXXX-XXXXXXXXXXXXXXXXXXXXXXXXXXXXXXXXXXXXXXXXXXXXXXXXXXXXXXXXXXXX
XXXXXXXXXXXXXXXXXXXXXXXXXXXXXXXXXXXXXXXXXXXXXXXXXXXXXXXXXXXXXXXXXXXXXXXXXXXXXXXXXXXXXXXXXXXXXXXXXXXXXXXXXXXXXXXXXXXXXXXXXXXXXXXXXXXXXXXXXXXXXXXXXXXXXXXXXXXXXXXXXXXXXXXXXXXXXXXX
