--------------------------------------------------------------------------------------------------------------------------------------------------------------------------------
--------------------------------------------------------------------------------------------------------------------------------------------------------------------------------
--------------------------------------------------------------------------------------------------------------------------------------------------------------------------------
--------------------------------------------------------------------------------------------------------------------------------------------------------------------------------
-----------------------------------k--------------------------------------------------------------------------------------------------------------------------------------------
---------------o-----------------###----------------------------------------------##--------------------------o---##------------------------------------------------------------
----------------------------------------------------------------SSS-----------------------------S%%------------------------------------------o----------------------------------
-----------------------------------------oo--------S----------------oo-------------------o-------||---o---------------------------------oooo------oooo-------------------SS-----
-------------------------------------------------------------------------------------------------||---------------------------------------------------------------------SSS-----
-----S-----------------------------------SS----------------------------------------------SS------||---------------------------------------------------------------------SSSS----
-----S--------------------------------------------------------TTTT-------------------------------||-------------------------------------------TTTT-------TT----T--------------#-
-------------#----TT--------TT---------------------------TT---TTTT----tt-TT---------tt-TT--------||------TT---------tt-TT---------------------TTTT----tt-TT---TT-------TT-------
------------##----TT--------TT------tt-TT-----------TT---TT---TTTT----tt-TT----t----tt-TT--------|TT-----TT---------tt-TT--tt-----------------TTTT----tt-TT---TT----tt-TT-------
--kk---k-k--##----TT---k----TT------tt-TT-k---------TT---TT---TTTT----tt-TT----t----tt-TT--------|TT--g--TT---------tt-TT--tt-----------------TTTT----ttkTT---TT----tt-TT---kk--
XXXXXXXXXXXXXXXX-XXXXXXXXXXXXXXXXXXXXXXXXXXXXXXXXXXXXXXXXXXXXXXXXXXXXXXXXXXXXXXXXXXXXXXXXXXXXXXXXXXXXXXXXXXXXXXXXXXXXXXXXXXXXXXXXXXXXXXXXXXXXXXXTXXXXXXXXXXXXXXXXXXXXXXXXXXXXXXX
XXXXXXXXXXXXXXXXXXXXXXXXXXXXXXXXXXXXXXXXXXXXXXXXXXXXXXXXXXXXXXXXXXXXXXXXXXXXXXXXXXXXXXXXXXXXXXXXXXXXXXXXXXXXXXXXXXXXXXXXXXXXXXXXXXXXXXXXXXXXXXXXTXXXXXXXXXXXXXXXXXXXXXXXXXXXXXXX
