-------Q---------%%--------------------Q-----------------------------------------%----------------------------------------------------------------------------------------------
-----------------||--------------------------------------------------------------|----------------------------------------------------------------------------------------------
-----------------||--------------------------------------------------------------|----------------------------------------------------------------------------------------------
-----------------||--------------------------------------------------------------|----------------------------------------------------------------------------------------------
-----------g-----||--------------------------------------------------------------|----------------------------------------------------------------------------------------------
-----%%%%%%%-----||-------------%%%%%-------------------------------------------%%---------------%------------------------------------------------------------------------------
------|||||------||------------o-|||--U-----------------------------------------||-------------o-|----r---------------r---------------r---------------r---------------r---------
------||r||---U--||-------------%%%%%%----------%%%%%%%---------%%%%%%%%--------%%%%%%%%--------%%%%%%%%%%------%%%%%%%%%%------%%%%%%%%%%------%%%%%%%%%%------%%%%%%%%%%------
--%%%%%%%%|------||--------------||||------------|||||-----------||||||----------||||||----------||||||||--------||||||||--------||||||||--------||||||||--------||||||||-------
---||||||-|---1--||--------------||||------------|||||-----------||||||----------||||||----------||||||||--------||||||||--------||||||||--------||||||||--------||||||||-------
---||||||-|----%QQQ--tt--------tQQ|||---@--------|||||----QQ-----|TT|||----------||||||---------SS||||SSU---TT--S|||||SSU--------|TT||SSU--------||||||S@--------||||||S@S------
---||||||-|----|-----tt--------t--|||------------|||||-----------|TT|||----------|TT|||-----------||||--|---TT---|TT||--|---TT---|TT||--|---TT---|TT|||-----TT---|TT|||-----TT--
---||||||-|----|-----tt--------t--|||------------|TT||tt---------|TT|||----------|TT|||-----------||||--|---TT---|TT||--|---TT---|TT||--|---TT---|TT|||-----TT---|TT|||-----TT--
---||||||-|---g|-g---tt--------t-g|||----gg---g--|TT||tt-----gg--|TT|||--------g-|TT|||-----------||||-ggg--TT---|TT||-ggg--TT-k-|TT||-ggg--TT-k-|TT|||ggg--TT-k-|TT|||--g--TT-k
XX-||X|||-|X--X|XXXXXXXXXXXXXXXXXXXXXXXXXXXXXXXXXXXXXXXXXXXXXXXX-XXXXXXXXXXXXXXXXXXXXXXXXXXXXXXXXXXXXXXXXXXXXXXXXXXXXXXXXXXXXXXXXXXXXXXXXXXXXXXXXXXXXXXXXXXXXXXXXXXXXXXXXXXXXXXX
gX-||X|||-|X--X|XXXXXXXXXXXXXXXXXXXXXXXXXXXXXXXXXXXXXXXXXXXXXXXXXXXXXXXXXXXXXXXXXXXXXXXXXXXXXXXXXXXXXXXXXXXXXXXXXXXXXXXXXXXXXXXXXXXXXXXXXXXXXXXXXXXXXXXXXXXXXXXXXXXXXXXXXXXXXXXX
