--------------------------------------------------------------------------------------------------------------------------------------------------------------------------------
--------------------------------------------------------------------------------------------------------------------------------------------------------------------------------
--------------------------------------------------------------------------------------------------------------------------------------------------------------------------------
----S---SS----------------------------------------------SS----------------------------------------------------------------------------------------------------------------------
--------------------------------------------------------------------------------------------------------------------------------------------------------------------------------
--------------------------------------------------------------o-----------------------------------------------------------------------------------------------------------------
oSS-oo--oo----2%----SSS-------------------------SSSSooS---------------SSSSSS--------S---------SS--SSSSSS----SSSS--------------------SSS----------S-----S----SS---------------SSS
-------------U-|----------------------------------------------------------------------------------------------------------S-----------------------------------------------------
---------------|------------------------------------S-------------------------------------------------------------------SS------------------------------------------------------
------------U--|-------------------------------------------------------------g---------------------o---------------------SS------------------------g---------------------SS-----
---------USSS--|--------------SQ-------------------------TT-------SS----SS---QS---SSS-------------SSSS----------------------------SSS-------------SQ--------------S------SSS-SQQ
---------------|--------------------K--TT----------------TT----------------------------------------------TT------K-----TT-------------------------------------------------------
---------------|-----------------------TT----------------TT----#-----------------------------------------TT----T----tt-TT--------------------------------TT---------tt----------
-----U-------g-k---k-k-----k-------kR--TT----------------TT----#--------y-gk-------k-----k---------ggg---TT----T--K-tt-TT-----#----ggg-k-----------gggg-kTT---------tt----ggg---
XXXXXXXXXXXXXXXXXXXXXXXXXXXXXXXXXXXXXXXXXXXXXXXXXXXXXXXXXXXXXXXXXXXXXXXXXXXXXXXXXXXXXXXXXXXXXXXXXXXXXXXXXXXXXXXXXXXXXXXXXXXXXXXXXXXXXXXXXXXXXXXXXXXXXXXXXXXXXXXXXXXXXXXXXXXXXXXX
XXXXXXXXXXXXXXXXXXXXXXXXXXXXXXXXXXXXXXXXXXXXXXXXXXXXXXXXXXXXXXXXXXXXXXXXXXXXXXXXXXXXXXXXXXXXXXXXXXXXXXXXXXXXXXXXXXXXXXXXXXXXXXXXXXXXXXXXXXXXXXXXXXXXXXXXXXXXXXXXXXXXXXXXXXXXXXXX
