-----------------------------------------------------------------------------------------------------------------------------------------------------------------%--------------
-----------------------------------------------------------------------------------------------------------------------------------------------------------------|--------------
-------------------------------------------------------------------------------U---------------------------------------------------------------------------------|--------------
-----------------------------------------------------------------------------------------------------------------------------------------------------------------|--------------
-----------------------------------------------------------------------------------------------------------------------------------------------------------------|--------------
--##----------------------------------------------------------------------1--------------------------------------------------------------------------------------|--------------
--------------------------------------US--------------U--------------------------------------------------------o-------------------------------------------------|----r---------
----------o---------------------%---%%%%%------------------------------------------------ooo------------------------------------%--%%%%--------------------------|-%%%%%--------
--------------------------------|----|||----------------------------------------------------------------------------------------|---||---------------------------|--|||---------
--------------------------------|----|||----------------------------------------------------------------------------------------|---||---------------------------|--|||---------
Q-----------------------------SQ|SSSSS||----TT------------------------------------TT--------------------------------------------|---||----Q-------TT----U--------|--|||---------
--------------------------------|-----||----TT--------------------TT--------------TT-----------------------tt-------------------|---||------------TT-------------|TT|||---------
--------------------------------|-----||----TT--------------------TT--------------TT----------------tt-----tt-------------------|-TT||------------TT-------------|TT|||---------
-------------------g-g-----gg-g-|-----|k----TT----gg---k----------TT------g-------TT-------------g---------tt-g-ggg-----y-k-----|-TT||g------ggg--TT---gggggg-g--|TT|||g-------g
XXXXXXXXXXXXXXXXXXXXXXXXXXXXXXXXXXXXXXXXXXXXXXXXXXXXXXXXXXXXXXXX-XXXX--XXXXXXXXXXXXXXXXXXXXXXXXXXXXXXXXXXXXXXXXXXXXXXXXXXXXXXXXXXXXXXXXXXXXXXXXXXXXXXXXXXXXXXXXXXXXXXXXXXXXXXXXX
XXXXXXXXXXXXXXXXXXXXXXXXXXXXXXXXXXXXXXXXXXXXXXXXXXXXXXXXXXXXXXXX-XXXX--XXXXXXXXXXXXXXXXXXXXXXXXXXXXXXXXXXXXXXXXXXXXXXXXXXXXXXXXXXXXXXXXXXXXXXXXXXXXXXXXXXXXXXXXXXXXXXXXXXXXXXXXX
