----------------------------------%------------------------------%--------------------------------------------------------------------------------------------------------------
----------------------------------|------------------------------|--------------------------------------------------------------------------------------------------------------
----------------------------------|------------------------------|--------------------------------------------------------------------------------------------------------------
SSSSSSSSSSSSSSSS------------------|------------------------------|--------------------------------------------------------------------------------------------------------------
----------------------------------|g------------%----------------|--------------------------------------------------------------------------------------------------------------
----------------------------------|-------------|----------------|--------------------------------------------------------------------------------------------------------------
----------------------------------|-------------%----------------|--------------------------------------------------------------%%%-------------%%------------------------------
--K-------------------------------|-------------|----------------|--o-----------------------------------------------------oo-----|--------------||--------------o----------o----
--SS--K----------%%%%%%%%---------|-------------|----------------|---------------------------------------------------------------|--------------||------------------------------
--------------SS--||||||----------|-------------|----------------|---------------------------------------------------------------|--T-----------||------------------------------
%-----------------||||||----------|-------------|----------------|--------------------------##----TT--QQ-------------------------TTTT-----------|TTT--------QQQ---TT------------
|-----------------||||||-----#----|---------TT--|-TT-------------|----------------TT-------###----TT--------TT-------------------TTTT-----------|TTT--------------TT------------
%---------%%------||||||----##----|---------TT--|-TT-------------|----------------TT------####----TT--------TT-------------------TTTT-----------|TTTT------------TTT------------
|---------||------||||||---###----g---------TT--|-TT-----------g-|-----------ggg--TT---gg#####----TT--------TT-k-gg-------k-y----TTTT-#--------g|TTTT-g------ggg-TTT------------
%%%%%%%%%%%%%-----||||||--XXXXX-XXXXXXXXXXXXXXXXXXXXXXXXXXXXXXXXXXXXXXXXXXXXXXXXXXXXXXXXXXXXXX-X-XXXXXXXXXXXXXXXXXXXXXXXXXXXXXXXXXXXXXXXXXXXXXXXXXXXXXXXXXXXXXXXXXXXXXXXXXXXXXXX
g|||||||||||g----X||||||--XXXXX-XXXXXXXXXXXXXXXXXXXXXXXXXXXXXXXXXXXXXXXXXXXXXXXXXXXXXXXXXXXXXX-XXXXXXXXXXXXXXXXXXXXXXXXXXXXXXXXXXXXXXXXXXXXXXXXXXXXXXXXXXXXXXXXXXXXXXXXXXXXXXXXX
