--------------------------------------------------------------------------------------------------------------------------------------------------------------------------------
--------------------------------------------------------------------------------------------------------------------------------------------------------------------------------
--------------------------------------------------------------------------------------------------------------------------------------------------------------------------------
--------------------------------------------------------------------------------------------------------------------------------------------------------------------------------
--------------------------------------------------------------------------------------------------------------------------------------------------------------------------------
------------------------------------------------------------------------------------------------------------------------------------------------------------------##------------
---------------------------------------------------------------------------------------------------------------o-------------------------------o--------------------------------
-------------------------------------oo--------------------------------------------%%%%-------------------oo--------------------------------------------------------------------
------------------------------------------------------------------------------------||------------------------------------------------------------------------------------------
------------------------------------------------------------------------------------||------------------------------------------------------------------------------------------
SS------------------------------------------------------------QQ--------------------||----------------------------TT--o---QQQ--------Q------------TT----------------------------
--------------------------------TT----------------TT--------------------------------||----------------------------TT------------------------------TT-------------------------T--
------------T-------------------TT----tt-TT-------TT--------------------------------||----------------------------TT------------------------------TT-----------------t-T----TT--
------------T-------------------TT----tt-TT-------TT---g---gg-g--------------------ggggg-------k---gy-------------TT-----------g----g--------ggg--TT---g-------k-----t-T----TT--
XXX-XXXXXXXXXXXXXXXXXXXXXXXXXXXXXXXXXXXXXXXXXXXXXXXXXXXXXXXXXXXXXXXXXXXXXXXXXXXXXXXXXXXXXXXXXXXXXXXXXXXXXXXXXXXXXXXXXXXXXXXXXXXXXXXXXXXXXXXXXXXXXXXXXXXXXXXXXXXXXXXXXXXXXXXXXXXX
XXXXXXXXXXXXXXXXXXXXXXXXXXXXXXXXXXXXXXXXXXXXXXXXXXXXXXXXXXXXXXXXXXXXXXXXXXXXXXXXXXXXXXXXXXXXXXXXXXXXXXXXXXXXXXXXXXXXXXXXXXXXXXXXXXXXXXXXXXXXXXXXXXXXXXXXXXXXXXXXXXXXXXXXXXXXXXXX
