--------------------------------------------------------------------------------------------------------------------------------------------------------------------------------
--------------------------------------------------------------------------------------------------------------------------------------------------------------------------------
--------------------------------------------------------------------------------------------------------------------------------------------------------------------------------
------------------------------------------SS------------------------------------------------------------------------------------------------------------------------------------
--------------------------------------------------------------------------------------------------------------------------------------------------------------------------------
------go---ooo----------------------------------------------------------------g----------------------------------------------oo-------------------------------------------------
-----SS-----------SSSSS------------SQSS------------------------o---SSSS-----SSSSSSS----S-S-SSS-------SSSS-----SS----SSSS----SSS--------------SS-SS----------SS--SSS----SSSS-SS--
---SS---------------------------------------------------------------------------------------------------------------------------------------------------------------------------
-----------------------------------------------------------------------------------------------------------------------------------------SK-------------------------------------
-------------------o---------------o-------------------------------------------------------------------------------o---------------------SS-------------------------------------
----TT------------SSSQ------------SSo------------------------------S-----------U------------------SS---SUSQQ------SSSS-----------SS-----------SS---------TT-----TT--------------
#---TT---TT---------------------------------------------------------------------TT-------TT--------------------------------------------------------------TT---TTTT-------TT-----
#---TT---TT--------------TT-------------------------tt-----B--------------------TT----B--TT----T-------------------------TT------------TT-------T--------TT---TTTT----B--TT----T
#---TT---TT--------gg--k-TT----------y-g-k--#---K---tt-----b-------g-k----------TT----b-kTT----T-------gg----------gg--k-TT----k-------TT-kgg---T----y---TT---TTTT----b-kTT----T
XXX-XXXXXXXXXXXXXXXXXXXXXXXXXXXXXXXXXXXXXXXXXXXXXXXXXXXXXXXXXXXXXXXXXXXXXXXXXXXXXXXXXXXXXXXXXXXXXXXXXXXXXXXXXXXXXXXXXXXXXXXXXXXXXXXXXXXXXXXXXXXXXXXXXXXXXXXXXXXXXXXXXXXXXXXXXXXX
XXX-XXXXXXXXXXXXXXXXXXXXXXXXXXXXXXXXXXXXXXXXXXXXXXXXXXXXXXXXXXXXXXXXXXXXXXXXXXXXXXXXXXXXXXXXXXXXXXXXXXXXXXXXXXXXXXXXXXXXXXXXXXXXXXXXXXXXXXXXXXXXXXXXXXXXXXXXXXXXXXXXXXXXXXXXXXXX
