--------------------------------------------------------------------------------------------------------------------------------------------------------------------------------
--------------------------------------------------------------------------------------------------------------------------------------------------------------------------------
--------------------------------------------------------------------------------------------------------------------------------------------------------------------------------
------------------------------------------------------------------------------------------------------------------------SS------------------------------------------------------
--------------------------------------------------------------------------------------------------------------------------------------------------------------------------------
--##--------------##------------------------------------------------------------------------------##----------------------------------------------------------------------------
----------------------------------SSS---------------------------------------------------------------------------SS-----------SQo---------------o-------------o-oSSS-------------
-------------------------------------------------------------------------SSS----------------------------------------------------------------------------oo----------oo----------
------------------------------------------------------------------------SS------------------------------------------------------------------------------------------------------
------------------------SSS--------g----------------------o-------------SSS-----------------------------------------------------------------------------SSS---------------------
--S-------------------------------@SS----------------------------------------------------TT---------------------------------------------------------------------TT--------------
--------------------tt----------------------------------------------------------T--------TT----T----tt-T-----------------TT---------tt--------------tt----------TT-------TT-----
----tt--------------tt----------------------------------------------tt----------T--------TT----T----tt-TT--B--#----------TT----T----tt-TT--tt-------tt----------TT----tt-TT----T
K---tt----g---------tt--------#----gk-y-k--------------------k------tt----------T----y---TT----TK---tt-TT--b--#----------TT----Tg---tt-TT--tt-------tt-------k--TT----ttkTT----T
XXXXXXXXXXXXXXXXXXXXXXXXXXXXXXXXXXXXXXXXXXXXXXXXXXXXXXXXXXXXXXXXXXXXXXXXXXXXXXXXXXXXXXXXXXXXXXXXXXXXXXXXXXXXXXXXXXXXXXXXXXXXXXXXXXXXXXXXXXXXXXXXXXXXXXXXXXXXXXXXXXXXXXXXXXXXXXXX
XXXXXXXXXXXXXXXXXXXXXXXXXXXXXXXXXXXXXXXXXXXXXXXXXXXXXXXXXXXXXXXXXXXXXXXXXXXXXXXXXXXXXXXXXXXXXXXXXXXXXXXXXXXXXXXXXXXXXXXXXXXXXXXXXXXXXXXXXXXXXXXXXXXXXXXXXXXXXXXXXXXXXXXXXXXXXXXX
