----------------------------------%----------------------------------------------%----------------------------------------------------------------------------------------------
----------------------------------|----------------------------------------------|----------------------------------------------------------------------------------------------
----------------------------------|----------------------------------------------|----------------------------------------------------------------------------------------------
----------------------------------|----------------------------------------------|--------------------------------#----------------------------------------------##-------------
----------------------------------|g-------------------------------k-------------|-g-------------------------------k-------------------------------g---------------g##----------
----------------%%%%%-----------%-|-------------------------------##------------%%%%%----------------------------###----------------------------%%#%------------%%%%-#----------
------r--r-------|||--r---------|-|-------------------r---------------U--------U-|||--r---------------r-------------------------------r---------||-|--r----------||---U---------
SSSS-%%%--------%%%%%%%%%-------|-|-------------%-%%%%%%--------%%%%%%%%%-------%%%%%%----------%%%%%%%%%-------%%%%%%%%---o----%%%%%%%%%-------%%%%%%%%%-------%%%-%%%---------
------|----------|||||||--------|-|-------------|--||||----------|||||||---------||||------------|||||||---------||||||----------|||||||---------|||||||---------|---|----------
------|----------|||||||--------|-|-------------|--||||----------|||||||---------||||------------|||||||---------||||||----------|||||||---------|||||||---------|---|----------
S---TT|----------||||||So-------|-|-----U-------|--||||---------QQS|||||U--------||||---U--------|TT||SSo--------||||||------T---|TT||SSU---TT---Q||||||U-------QQS--|------TT--
----TT|-----TT---|||TT|-----TT--|-|---------TT--|--||||-----TT-----|||||----TT---||||-------TT---|TT||------TT---||||||-----TT---|TT||------TT----||||||----TT-------|------TT--
----TT|--TT-TT---|||TT|-----TT--|-|---------TT--|--||||-----TT-----|||||----TT---||||-------TT---|TT||------TT---||||||-----TT---|TT||------TT----||||||----TT-------|------TT--
----TT|k-TT-TT---|||TT|--y--TT--|gg-----y---TT--|--||||ggg--TT-k-gg|||||y---TT-k-||||----gg-TT---|TT||--gg--TT---|g||||---k-TT---|TT||-ggg--TT----||||||-gg-TT---gg--|--g---TT--
XXXXXXXXXXXXXXXXXXXXXXXXXXX-XXXXXXXXXXXXXXXXXXXXXXXXXXXXXXXXXXXXXXXXXXXXXXXXXXXXXXXXXXXXXXXXXXXXXXXXXXXXXXXXXXXXXXXXXXXXXXXXXXXXXXXXXXXXXXXXXXXXXXXXXXXXXXXXXXXXXXXXXXXXXXXXXXXX
XXXXXXXXXXXXXXXXXXXXXXXXXXX-XXXXXXXXXXXXXXXXXXXXXXXXXXXXXXXXXXXXXXXXXXXXXXXXXXXXXXXXXgXXXXXXXXXXXXXXXXXXXXXXXXXXXXXXXXXXXXXXXXXXXXXXXXXXXXXXXXXXXXXXXXXXXXXXXXXXXXXXXXXXXXXXXXXX
