-------------------------------------------------%---------------%-----------------------------------------------%--------------------------------------------------------------
-------------------------------------------------|---------------|-----------------------------------------------|--------------------------------------------------------------
-------------------------------------------------|---------------|-----------------------------------------------|--------------------------------------------------------------
----------SSSSSS---------------------------------|---------------|-----------------------------------------------|--------------------------------------------------------------
-------SSSS--------------------------------------|---------------|-----------------------------------------------|--------------------------------------------------------------
-------SSS------%%-------------------------------|---------------|-----------------------------------------------|--------------------------------------------------------------
-------------S--||----r---------------r----------|----r----------|----r---------------r---------------r----------|----r---------------r---------------r---------------r---------
----------------%%%%%%%%%-------%%%%%%%%%%------%%%%%%%%%%------%%%%%%%%%-------%%%%%%%%%%------%%%%%%%%%%------%%%%%%%%%%------%%%%%%%%%-------%%%%%%%%%-------%%%%%%%%%-------
-----------------|||||||---------||||||||--------||||||||--------|||||||---------||||||||--------||||||||--------||||||||--------|||||||---------|||||||---------|||||||--------
-------r--S-SSS--|||||||---------||||||||--------||||||||--------|||||||---------||||||||--------||||||||--------||||||||--------|||||||---------|||||||---------|||||||--------
---%%%%%%%%-%%S--|||||||---------|||||SQQS-------|||||QQQQQ------Q|||||SQQQ-----S|||||SSUS-------|||||SSU--------|||||SSUS-------|||||||---------||||||SQ--------||||||S@-------
----||||||--||---|||||||---------|TT||-----------|||||------------|||||----------|TT||--|---TT---|TT||--|---TT---|||||--|---TT---|TT||||---------|TT|||-----TT---|TT|||-----TT--
----||||||%%%%---|||||||---------|TT||-----------|||||------------|||||----------|TT||--|---TT---|TT||--|---TT---|TT||--|---TT---|TT||||---------|TT|||-----TT---|TT|||-----TT--
----||||||-g|----||||||k-------k-|TT||-ggg--gggg-|||||---g----g---|||||--g----g--|TT||-ggg--TT-k-|TT||-ggg--TT-k-|TT||-ggg--TT-k-|TT|||ggg-----k-|TT|||ggg--TT-k-|TT|||ggg--TT-k
----||||||XX|-XXXXXXXXXXXXXXXXXXXXXXXXXXXXXXXXXXXXXXXXXXXXXXXXXXXXXXXXXXXXXXXXXXXXXXXXXXXXXXXXXXXXXXXXXXXXXXXXXXXXXXXXXXXXXXXXXXXXXXXXXXXXXXXXXXXXXXXXXXXXXXXXXXXXXXXXXXXXXXXXXX
----||||||XX|-XXXXXXXXXXXXXXXXXXXXXXXXXXXXXXXXXXXXXXXXXXXXXXXXXXXXXXXXXXXXXXXXXXXXXXXXXXXXXXXXXXXXXXXXXXXXXXXXXXXXXXXXXXXXXXXXXXXXXXXXXXXXXXXXXXXXXXXXXXXXXXXXXXXXXXXXXXXXXXXXXX
