--------------------------------------------------------------------------------------------------------------------------------------------------------------------------------
--------------------------------------------------------------------------------------------------------------------------------------------------------------------------------
--------------------------------------------------------------------------------------------------------------------------------------------------------------------------------
---------------------------S-SSS------------------------------------------------------------------------------------------------------------------------------------------------
------------------------------Ko------------------------------------------------------------------------------------------------------------------------------------------------
--------------------Sk-------SSS--------------------------------------------------------------o---------------------------------------------------------------------------------
-------S----------SSSSSSSS-----------SSSSSS--------------------Q---K------------SSSSSSSS---------------SSS-S--2%------------SQ---SS------S--SS------------------SS----2------1--
---------------y--------------------------------------------------------------------S--------------------------|----------o------------------------------S----------------------
-------SS--------------SSSS-----------------------------------------------------------------------------SS-----|----------------------------------------SS----------------------
-------------------SSS--SSSS----------o------------------------------------------------------------------------|----------------------------------------SSSS--------------------
-----%%SSS---#-----SS----------------SS-----------S--------------------------------------TT------SSS---SSSSSS--|-SSS------------------------------S--------------SSS-----TT-----
-----||----###---KSSK------------------------#------tt-----------------------------------TT--------------------|----------------TT-------TT---TT-------------------------TT-----
-----||-S--###--SSSSS--TT-------------------##------tt-----------------------------------TT--------------------|----------------TT-------TT---TT----tt-TT----------------TT-----
-----||---####---S-kS--TT---------kg-------####-----tt------y------------------------y---TT-------------y-k-y--|----------------TT----g-kTT---TT--K-tt-TT---kk#----------TT-----
-----||---XX----XXXXXXXXXXXXXXXXXXXXXXXXXXXXXXXXXXXXXXXXXXXXXXXXXXXXXXXXXXXXXX-XXXXXXXXXXXXXXXXXXXXXXXXXXXXXXXXXXXXXXXXXXXXXXXXXXXXXXXXXXXXXXXXXXXXXXXXXXXXXXXXXXXXXXXXXXXXXXXXX
-----||---------XXXXXXXXXXXXXXXXXXXXXXXXXXXXXXXXXXXXXXXXXXXXXXXXXXXXXXXXXXXXXXXXXXXXXXXXXXXXXXXXXXXXXXXXXXXXXXXXXXXXXXXXXXXXXXXXXXXXXXXXXXXXXXXXXXXXXXXXXXXXXXXXXXXXXXXXXXXXXXXX
