--------------------------------------------------------------------------------------------------------------------------------------------------------------------------------
--------------------------------------------------------------------------------------------------------------------------------------------------------------------------------
--------------------------------------------------------------------------------------------------------------------------------------------------------------------------------
o-------------------------------------------------------------------------------------------------------------------------------------------------------------------------------
-------------------------------------------------------------------k------------------------------------------------------------------------------------------------------------
-----%%%--------%-------------------------------------------------#-------------------------------##----------------------------------------------------------------------------
------|---------|-----------------------------------SSS--S------------------------SSSSS--------------------------------------Q--------------------------------------------------
------|---------|----------------------------------------------------------------------------------------o-----------------------------------------------oo---------o-----------
-%%%%%%---------|----------------------------------------------------------------------------------------S----------------------------------------------------------------------
--||||----------|--g------o-----------------------oo---------------------SS-----------------------------SSS---------------------------------------------------------------------
--||||%%--------|--Q----------#--------------#----SS--------------S-------------------------------------------------Q-------------S-----------------------------TT--------------
--||||||--------|-------------#-------------##------K---------------K--------------------TT------------------------------TT------------TT-----------------------TT----tt-TT----T
--||||||---B----|-------------#----------K--##------------------------------##--T--------TT---------tt-TT----------------TT---------tt-TT--B--------------------TT----tt-TT----T
--||||||---b----|----gg--k----#-----------#####----kk-----------------------##--T---ggg-kTT---------tt-TT-------T--gggg-kTT----y----tt-TT--b--------------k-----TT----ttkTT----T
--||||||-----%%-XXXXXXXXXXXXXXXXXXXXXXXXXXXXXXXXXXXXXXXXXXXXXXXXXXXXXXXXXXXXXXXXXXXXXXXXXXXXXXXXXXXXXXXXXXXXXXXXXXXXXXXXXXXXXXXXXXXXXXXXXXXXXXXXXXXXXXXXXXXXXXXXXXXXXXXXXXXXXXXX
--||||||-----||-XXXXXXXXXXXXXXXXXXXXXXXXXXXXXXXXXXXXXXXXXXXXXXXXXXXXXXXXXXXXXXXXXXXXXXXXXXXXXXXXXXXXXXXXXXXXXXXXXXXXXXXXXXXXXXXXXXXXXXXXXXXXXXXXXXXXXXXXXXXXXXXXXXXXXXXXXXXXXXXX
