--------------------------------------------------%-----------------------------------------------------------------------------------------------------------------------------
--------------------------------------------------|-----------------------------------------------------------------------------------------------------------------------------
--------------------------------------------------|-----------------------------------------------------------------------------------------------------------------------------
--------------------------------------------------|-----------------------------------------------------------------------------------------------------------------------------
--------------------------------------------------|---------------------------------------------------------------------------------------------%-------------------------------
----------------------------ooo-------------------|-----U---------------------------------------------------------------------------------------|-------------------------------
--------------------------------------------------|-------------S--------------------------------------------------------------o----------------%%------------------------------
------------------------------------------oo------|----------------oooo-------------------------------------------------------------------------o|------------------------------
-------S------------------------------------------|---------------------------------------------------------------%%----------------------------||------------------------------
ooo---SSSooo---#----------------------------------|---------------------------------------------------------------||----------------------------||------------------------S-----
%%%%%%%%------#-----------------------------------|----------------------TT---------------------------------------||----------------------------|TTT----------------------------
-||||||------##---TT--------TT----TT---TT---------|----------------------TT-------TT------------------------------||----------------------------|TTTT---------------------------
-||||||-----###---TT--------TT----TT---TT---------|--------------TTT-----TT-------TT------------------------------||----------------------------|TTTT-----------------------##--
-||||||----####---TT---k----TT---kTT---TT---------|------g-------TTT--g--TT----y-kTT----y-k----k------------------||---------------------g-----k|TTTT--------ggg------------###-
%|%%%%|---XXXXXX-XXXXXXXXXXXXXXXXXXXXXXXXXXXXXXXXXXXXXXXXXXXXXXXXXXXXXXXXXXXXXXXXXXXXXXXXXXXXXXXXXXXXXXXXXXXXXXXXXXXXX-XXXXXXXXXXXXXXXXXXXXXXXXXXXXXXXXXXXXXXXXXXXXXXXXXXXXXXXXX
g|-||-|---XXXXUXXXXXXXXXXXXXXXXXXXXXXXXXXXXXXXXXXXXXXXXXXXXXXXXXXXXXXXXXXXXXXXXXXXXXXXXXXXXXXXXXXXXXXXXXXXXXXXXXXXXXXX-XXXXXXXXXXXXXXXXXXXXXXXXXXXXXXXXXXXXXXXXXXXXXXXXXXXXXXXXX
