--------------------------------------------------------------------------------------------------------------------------------------------------------------------------------
--------------------------------------------------------------------------------------------------------------------------------------------------------------------------------
--------------------------------------------------------------------------------------------------------------------------------------------------------------------------------
------------------------------------------------------------------------------------------------------------------------------------SSSSSSS-------------------------------------
--------------------------------------------------------------------------------------------------------------------------------------------------------------------------------
---------------------------------------------------------------------------------------------ooo--------------------------------------------------------------------------------
---------------------------------------SS---------------S----------QSS--------SS--SSSSS--------------------------------------Q---SS----SSSS---------------------SSSSS-------SSQ-
---------oo---------------------------------------------------------------------------------------------------------------------------------------------------------------------
----------%%%-----------------------------------------------------------------------S-------------------SS----------------------------------------------SS----------------------
-----------|------------------------------o----------------------------------1--------------------------------------------------------------------------SSSS--------------------
-----------|-------------------------------------------------#-----S-------QQS-----SSU----------------------------SS------------------------------------------#-----------------
----tt-TT--|------------------------------------------------##---------------------------TT------K---------------------------------------TT----------t-TT-----#----------TT-----
----tt-TT--tt----------------------------------------------###---------------------------TT---------tt-TT--------------------------------TT---------tt-TT-----#----------TT-----
----tt-TT--tt------g---------k-------gg--k----#-----------####--------------y------k-y---TT-------K-tt-TT----------gg--------------------TT-------K-tt-TT---#-#----ggg---TT----T
XXXXXXXXXXXXXXXXXXXXXXXXXXXXXXXXXXXXXXXXXXXXXXXXXXXXXXXXXXXXXXXXXXXXXXXXXXXXXXXXXXXXXXXXXXXXXXXXXXXXXXXXXXXXXXXXXXXXXXXXXXXXXXXXXXXXXXXXXXXXXXXXXXXXXXXXXXXXXXXXXXXXXXXXXXXXXXXX
XXXXXXXXXXXXXXXXXXXXXXXXXXXXXXXXXXXXXXXXXXXXXXXXXXXXXXXXXXXXXXXXXXXXXXXXXXXXXXXXXXXXXXXXXXXXXXXXXXXXXXXXXXXXXXXXXXXXXXXXXXXXXXXXXXXXXXXXXXXXXXXXXXXXXXXXXXXXXXXXXXXXXXXXXXXXXXXX
