--------------------------------------------------------------------------------------------------------------------------------------------------------------------------------
--------------------------------------------------------------------------------------------------------------------------------------------------------------------------------
--------------------------------------------------------------------------------------------------------------------------------------------------------------------------------
----------------------------------------------------------SSSSSS----------------------------------------------------------------------------------------------------------------
-------------------------------------------------------------------------------------------S------------------------------------------------------------------------------------
------------------------------------------------------------------------------K-------------------------------------------------------------------------------------------------
----Q-------US-o----------------------------------------------------------------------SUSSSSSS@S--------SS-------------SSSS------------SSS--------------------------------------
------------------------oooo-------------oo--------------SS---------------o----------------------------------------------------------------------------------------------S------
--------------------------------------------------------SSS------------SSSSS------------SSS--------------------------------------------SSS---------------SS-------------SS------
------------------o------SS-------------S---------------SSS--------------SS------------------------------------------------------------------2##------------------------SSS-----
-Q-Q-----------------------------SSS--------------S---------------SS-------------SSS----S---------2--------------US--------------------------##--------------#----S-----SSS---#-
--------------------------------------------TT---K---------------K--K------------------------------------------------------------K----------###--K--K-------##----------------#-
-----------------------TT-------------------TT---S-----TT-------------------------------------------tt-----B-------------------------------####-----------####----------------#-
---g-----------T-------TT---------------gkk-TT----K----TT---------K--------gg-----------y---y---K---tt--y--b------------g-K-----k-K-------#####-----------####----------------#-
XXXXXXXXXXXXXXXXXXXXXXXXXXXXXXXXXXXXXXXXXXXXXXXXXXXXXXXXXXXXXXXXXXXXXXXXXXXXXXXXXXXXXXXXXXXXXXXXXXXXXXXXXXXXXXXXXXXXXXXXXXXXXXXXXXXXXXXXXXXXXXXXXXXXXXXXXXXXXXXXXXXXXXXXXXXXXXXX
XXXXXXXXXXXXXXXXXXXXXXXXXXXXXXXXXXXXXXXXXXXXXXXXXXXXXXXXXXXXXXXXXXXXXXXXXXXXXXXXXXXXXXXXXXXXXXXXXXXXXXXXXXXXXXXXXXXXXXXXXXXXXXXXXXXXXXXXXXXXXXXXXXXXXXXXXXXXXXUXXXXXXXXXXXXXXXXX
