--------------------------------------------------------------------------------------------------------------------------------------------------------------------------------
--------------------------------------------------------------------------------------------------------------------------------------------------------------------------------
--#-----------------------------------------------------------------------------------------------------------------------------------------------------------------------------
-##--#---------------------------------------------------------------------S---S-SSS------SSSSSS----------SSSSSS----------SS---S-----------S---------------S---S---------------S
-##k##-----------------------------------------------------------------------------------------------------S--------------------------------------------------------------------
-###----------------------------------------------------------------------------------------------------------------------------------------------------------------------------
------r-----------------------------------SSSSSS-----------o--@S--------------SS-----------S-SSS--------------SS--------------SS--------------SS--------------SS--------------SS
%%%%%%%%---------------------------------------------------S-----------S----------K--------S------------------------------------------------------------------------------------
-||||||---------%%%%-----------------------------------SS-SS-----------SSS--------------S-SS--K--------SS----SSS-------SS----SSS-------SS----SSS-------SS----SSS-------SSSS--SSS
-||||||----------||----oooo---------------------------------------o---SrSSS--SS-o-SoS---------SSo-ooSSSSSSS--SSSo-ooSSS-SSS---SSo--oSSSSSSS---SSo-oo--S-SSSS-SSSK--o----SSS---SS
QSS||||----------||----SSS--------------------------%%SSSSS------%%%%%%%%-------%--S%%%------------%%%%-S----------%%%%------------%%%%-SS----------%%%-S----------@%%--S-------
---||||-----TT---||---------------------------------||------------||||||-U------|----|--------------||--------------||--------------||---------------|--------------||---U------
---||||-----TT---||-----------------------------S---||%-%%%%%%%---||||||--%%----SS---|----%%%-------||--S%%---------||---%%%--------||--SS-----------|---%%%%-------||---%%%----
---|y||k----TT---||---------------------------------|||--|||||----||||||--||---------|-----|--------||---||---------||----|---------||---------------|----||--------||----|-----
XXXXXXXXXXXXXXXX-||%%-%----2X-XX--%%%-----------%-%%%%|--%||%%--%-%%%%||--||----%-%%%%%-%%%%%---%-%%%%---||-----%-%%||----|-----%---||----------%----|----||--------||----|-----
XXXXXXXXXXXXXXXX-||||-g-----X-XX--g|------------g-g||-|--|||||--g--||-||--||----g--|||g-g|g|----g--||----||-----g-||||----|-----g---||----------g----|----||--------||----|---X-
