--------------------------------------------------------------------------------------------------------------------------------------------------------------------------------
--------------------------------------------------------------------------------------------------------------------------------------------------------------------------------
--------------------------------------------------------------------------------------------------------------------------------------------------------------------------------
------------------------------------------SSSSSS--SSSSSSSSSSSSSS-----------------------------------------------------------S----------------------------------------------------
---------------------------------------------S------SSSSSS-SSSS--------------------------------------------S-K------------------------------------------------------------------
------go---ooo-------------------------------S------SSS-SS--SSS------------------------------------------------U----------------------------------------------------------------
-----SS------------------------------S--SS-SSSS----S-S-----SSSS--------SSS----SS-------------------S---SSSSS---%-------@SSSS------S---SSSSSS-----------SSS--------------S-------
---SS-----------------------------------SSSS-------------S-SSS-------------------------------------------------@---------------------------------------------------------------y
----------------------------------------SSS-----------------------------SS--------------SSS------------SSSS------------SSSS----------------------------SSS--------------SS------
------------------------SSS--------oS--SSSSS-------ooS-SoSSSS------------------------------------------------------------S-----------------------------------2------------K---#-
----TT------------S-----SS--------SS-----SS---SS-SSSS---SSSSSSS---S-----------Q-------------------------S---------SS---SS-----Q---S---------------2S----S----##--------------##-
#---TT---TT----------------------------------------------------------------------K--K--------#---K----------------------------------------------------------###--K----------###-
#---TT---TT---------------------------------------------------------tt-----------------TT---##------------------------------------------------------------#####------------####-
#---TT---TT-----K-------y-gy-----------T---g---------------kk-------tt-----------------TT---##--K-K-------------K-------y---------------U---------------U-######k-K-------#####-
XXX-XXXXXXXXXXXXXXXXXXXXXXXXXXXXXXXXXXXXXXXXXXXXXXXXXX-XXXXXXXXXXXXXXXXXXXXXXXXXXXXXXXXXXXXXXXXXXXXXXXXXXXXXXXXXXXXXXXXXXXXXXXX-XXXXXXXXXXXXXXXXXXXXXXXXXXXXXXXXXXXXXXXXXXXXXXXX
XXX-XXXXXXXXXXXXXXXXXXXXXXXXXXXXXXXXXXXXXXXXXXXXXXXXXXXXXXXXXXXXXXXXXXXXXXXXXXXXXXXXXXXXXXXXXXXXXXXXXXXXXXXXXXXXXXXXXXXXXXXXXXX-XXXXXXXXXXXXXXXXXXXXXXXXXXXXXXXXXXXXXXXXXXXXXXXX
