--------------------------------------------------------------------------------------------------------------------------------------------------------------------------------
--------------------------------------------------------------------------------------------------------------------------------------------------------------------------------
--------------------------------------------------------------------------------------------------------------------------------------------------------------------------------
--------------------------------------------------------------------------------------------------------------------------------------------------------------------------------
------------------------------------------------------------------------------o------------------------------------------------------------------------------K------------------
---------------------------------------------------------------------k-------------------------------------------------------------------------U--------------------------------
---------------------------------------SSS-------------------------SSSS-SS------------SSSS-----%--------------------SSSS-------%------------------------SSS---------------------
-----------------------------------------------------------------------------------------------@-------------------------------|-------------------------U----------------------
--------------------------------------------------------SS-------------SSSS------------SS---------------SS--------------S------|-----------------------SSSS------------SS-------
---------------------------------------------------------------------------------------------------------------------------gU--|---------S-------------------2---------SSS------
---------TT-------SS--------------S----SSS--------SS--------------SSS-------------2S---SSS--------S----------#-----------------|--2-----S-----#--------------#---------SSS----#-
---------TT------------------#-------------------K--K-------TT---K--K------------------------##--K----------##-----------------|-------------##--K----------##---------------##-
---------TT-----------------##------------------------------TT------------------------------###-------------##-----------------|------------###-----------####--------------###-
-----y---TT----T--------k---##----------y---------K---------TT------------k-y---K---------#####---K-------####-----------------|K-------y-#####-K-K-------#####-----------#####-
XXXXXXXXXXXXXXXXXXXXXXXXXXXXXXXXXXXXXXXXXXXXXXXXXXXXXXXXXXXXXXXXXXXXXXXXXXXXXXXXXXXXXXXXXXXXXXXXXXXXXXXXXXXXXXXXXXX-XXXXXXXXXXXX-XXXXXXXXXXXXXX-XXXXXXXXXXXXXXXXXX---XXXXXXXXXX-
XXXXXXXXXXXXXXXXXXXXXXXXXXXXXXXXXXXXXXXXXXXXXXXXXXXXXXXXXXXXXXXXXXXXXXXXXXXXXXXXXXXXXXXXXXXXXXXXXXXXXXXXXXXXXXXXXXX-XXXXXXXXXXXXXXXXXXXXXXXXXXX-XXXXXXXXXXXXXXXXXX---XXXXXXXXXX-
