--------------------------------------------------------------------------------------------------------------------------------------------------------------------------------
-----------------------------K--------------------------------------------------------------------------------------------------------------------------------------------------
------------------------------Q-------------------------------------------------------------------------------------------------------------------------------------------------
--------------------------------------------------------------------------------------------------------------------------------------------------------------------------------
--------------------------------------------------------------------------------------------------------------------------------------------------------------------------------
-----%%%-----------------------------------------------------------------------U-----------------------------------------------U----------------------------------------------K-
------|-----------------------------------------------------------------S------S-------------------------------o-------SSS-----S---------SSS--SQ-------------------Q----S------S
------|-----------------------U---------o---------------------------------------------------------------------------------------------------------------------------------------
------|---------------------------------%%-----------------------------SSS--------------S------------------------------SSS--------------S------------------------------SSS------
------|----------------SSSS---1---------||----o-gooo-------K----------------------------SSK-------------------------------------------------------------------------------------
------|-----------%--------------%%%%%--||---%%%--------------#--------------------%%-------------------S---------2-----S---------2------------Q------------------S-------------
------|-----------|---------------|||---||----|---------------#--K-----------------||---------#--------------------------------------------------K---------------K--------------
------|-----------|---------------|||---||----|---------------#--------------##----||---------#------------B---------------B---------------B------------------------------------
------|-----------|---------------|||---||----|-------------#-#-K-K---------###----||------y--#-K----------b----K----------b----K-K--------b------K-------------K-K-------------
XXXXXXXXXXXX--%%--|--X--XXXXXXX---|||%%-||-X--X---------XXXXXXXXXXXXXXXXXXXXXXXX---||X----XXXXX-X----XXXXXXXXXX-XXXXXXXXXXXXXXX-X----XXXXXXXXXXXXXXXXXXXXXXXXXXXXXXXXXXXXXXXXXXX
XXXXXXXXXXXX--||--|--X--XXXXXXX---|||||-||-X--XX--------XXXXXXXXXXXXXXXXXXXXXXXX---||X---XXXXXX-X----XXXXXXXXXX-XXXXXXXXXXXXXXX-X----XXXXXXXXXXXXXXXXXXXXXXXXXXXXXXXXXXXXXXXXXXX
