--------------------------------------------------------------------------------------------------------------------------------------------------------------------------------
--------------------------------------------------------------------------------------------------------------------------------------------------------------------------------
--------------------------------------------------------------------------------------------------------------------------------------------------------------------------------
-----------------------------------------SSSSSS----------------------------------------------------------------------------S---S------------------------------------------------
-------------------k-----------------S--------K---------------------------------------------------------------------------------------------------------------------------------
-------------------------------------SS--------------------------------------------------------U--------------------------------------------------------------------------------
-------------------------------------SS--S---------------SSS-----------@SS---------SSSSKSS----SS---------------------------------------USSSS-----------@S-----------------------
---------oo------------------------------S--------------------------------------------------------------------------------------------------------------------------------------
----------%%%---------------------------SSS---------------------------------------------S---------------SS--------------SSS--------------------------------------------SSS------
-----------|-----------------------o-----S----------------------------------------------SSS--------------SS---------------S-----------------------------------------------------
-----------|------S-----------#---SSS-------------S------------o--S----SSSQQQQ----------------S---SS----------Q-------------------------S--QQQQ---2----SSS---##-----------------
----tt-TT--|-----------------##-------------------------------------tt-----------K---------------K---------------K------------------------------------------###--K--------------
----tt-TT--tt---------------###--S----------------------------------tt-------------------------------t-----------S-----------------------------------------####-------------###-
----tt-TT--tt---------------###----kk-------y--------------g----g---tt----------K-K--------y------K--t------------K-----------------------------K---------#####-K-K--------####-
XXXXXXXXXXXXXXXXXXXXXXXXXXXXXXXXXXXXXXXXXXXXXXXXXXXXXXXXXXXXXXXXXXXXXXXXXXXXXXXXXXXXXXXXXXXXXXXXXXXXXXXXXXXXXXXXXXXXXXXXXXXXXXXXXXXXXXXXXXXXXXXXXXXXXXXXXXXXXXXXXXXXXXXXXXXXXXX-
XXXXXXXXXXXXXXXXXXXXXXXXXXXXXXXXXXXXXXXXXXXXXXXXXXXXXXXXXXXXXXXXXXXXXXXXXXXXXXXXXXXXXXXXXXXXXXXXXXXXXXXXXXXXXXXXXXXXXXXXXXXXXXXXXXXXXXXXXXXXXXXXXXXXXXXXXXXXXXXXXXXXXXXXXXXXXXXX
