--------------------------------------------------------------------------------------------------------------------------------------------------------------------------------
--------------------------------------------------------------------------------------------------------------------------------------------------------------------------------
--------------------------------------------------------------------------------------------------------------------------------------------------------------------------------
--------------------------------------------------------------------------------------------------------------------------------------------------------------------------------
--------------------------------------------------------------------------------------------------------------------------------------------------------------------------------
-----------------------------------------------U--------------------------------------------------------------------------------------------------------------------------------
---------------------------------------USS---------------------------SSUSS-------------USS-----S----------------------------------------S---------------SS----------------------
----S--------------------------------------------------------------------------------------------------------------------------------------------------------------------------@
--SSS-#-----------------S--------------SSS---------------------------------------------SSS----------------------------------------------SS--------------------------------------
-----###----------------SSSS-------------S-----------------------------------------------SS----------------------------------g------------------------------------------SS------
----####-------#--------------#---SS---SSS---##-------------------2-----S----QQ---SS------------------------------SS----@----#----S-------------o-----------K-----2----SSS---Q#-
---#####-------#--------------#-------------###-----K--TT------------------------K---------------K--K-----------------------###-------------###------------------------------##-
--######-------#------------###------------####--------TT---------------------------tt-------#---------TT------------------###------tt-----####---------------------tt------###-
-#######-------#--K---------###-K-------y-######-------TT----k--K-------y--y------K-tt----#-##----K----TT-----------------#####-K---tt----#####-----------------K----------####-
XXXXXXXXXXXXXXXXXXXXXXXXXXXXXXXXXXXXXXXXXXXXXXXXXXXXXXXXXXXXXXXXXXXXXXXXXXXXXXXXXXXXXXXXXXXXXXXXXXXXXXXXXXXXXXXXgXXXXXXXXXXXXXXXXXXXXXXXXXXXXXXXXXX-XXXXXXXXXXXX-XXXXXXXXXXXXXXX
XXXXXXXXXXXXXXXXXXXXXXXXXXXXXXXXXXXXXXXXXXXXXXXXXXXXXXXXXXXXXXXXXXXXXXXXXXXXXXXXXXXXXXXXXXXXXXXXXXXXXXXXXXXXXXXXXXXXXXXXXXXXXXXXXXXXXXXXXXXXXXXXXXX-XXXXXXXXXXUX-XXXXXXXXXXXXXXX
