--------------------------------------------------------------------------------------------------------------------------------------------------------------------------------
--------------------------------------------------------------------------------------------------------------------------------------------------------------------------------
--------------------------------------------------------------------------------------------------------------------------------------------------------------------------------
--------------------------------------------------------------------------------------------------------------------------------------------------------------------------------
--------------------------------------------------------------------------------------------------------------------------------------------------------------------------------
--------------------------------------------------------------------------------------------------------------------------------------------------------------------------------
----------------------------------------------------------------------------------------------------------------Q---------------------------------------------------------------
------------------SS-----------------------------------------------------------------------------------------------------o------------------------------------------------------
----------------------------------------------------------U---------------------------------------------------------------------------------------------------------------------
--------------------------------------------------o---------------------------------------------------------------g-----------------------o---##--------------------------------
--------------------TT------------------------------------------------------------2-----------#-------------TT--QQ----------------2-----------#---S-----------Q-QQ--------------
----------------#---TT------TT------------------------------------------------------tt-------##-------------TT-------------------------------##--K------------------------------
-------TT-----------TT------TT-------------------------TT---------------------------tt------###-------------TT----------------------tt------###-----tt-----B--------------------
-------TT-----------TT------TT-------------------------TT---------------y---#---K---tt-----####---------y---TT--------------g-g---K-tt-----####---K-tt-----b-------------------g
XXXXXXXXXXXXXXXXXX--XXXXXXX-XXXXXXXXXXXXXXXXXXXXX------XXXXXXXXXXXXXXXXXXXXXXXXXXXXXXXXXXXXXXXXXXXXXXXXXXXXXXXXXXXXXXXXXXXXXXXXXXXXXXXXXXXXXXXXXXXXXXXXXXXXXXXXXXXXXXXXXXXXXXXXX
XXXXXXXXXXXXXXXXXXX-XXXXXXX-XXXXXXXXXXXXXXXXXXXXX------XXXXXXXXXXXXXXXXXXXXXXXXXXXXXXXXXXXXXXXXXXXXXXXXXXXXXXXXXXXXXXXXXXXXXXXXXXXXXXXXXXXXXXXXXXXXXXXXXXXXXXXXXXXXXXXXXXXXXXXXX
