--------------------------------------------------------------------------------------------------------------------------------------------------------------------------------
--------------------------------------------------------------------------------------------------------------------------------------------------------------------------------
------------------------------------------------------------------U-------------------------------K-----------------------------------------------------------------------------
--------------------------------------------------------------------------------------------------------------------------------------------------------------------------------
---------------------------------------------------k----------------------------------------------------------------------------------------------------------------------------
--##----------------------------------------------##----------------------------------------------------------------------------------------------------------------------------
---------------------SKS-----S--------------------------------------------------------------------------------------------------------------------------------------------------
---------------------SSS----------------oo--------------ooo--------------oo-----------------------------------------##----------------------------------------------------------
--------------------------------------------------------------------------------------------------------SSS---------------------------------------------------------------------
------------------S----S-SSS-----------------------------SS-----------------------------SSS-----------------------------------------------------------------------------SS------
--S---------------S-----------------------------------------------S---------------------------#----S---------#---#----------------------------#-------------------------SSS-----
--------------------TT--------TT--------------------tt-T----------------------------tt-------##--K--K-------##-------------------------------##--K------------------------------
----tt--------------TT--------TT--------------------tt-TT-----------tt--------------tt------###-----------####----------------------tt------###-----tt-----B--------------------
K---tt----g---------TT--kk----TT--------y-----------tt-TT-----------tt----k---------tt--y-######----------####----------------ggK---tt-----####-K-K-tt-----b--------------------
XXXXXXXXXXXXXXXXXXXXXXXXXXXXXXXXXXXXXXXXXXXXXXXXXXXXXXXXXXXXXXXXXXXXXXXXXXXXXXXXXXXXXXXXXXXXXXXXXXXXXXXXXXXXXXXXXXXXXXXXXXXXXXXXXXXXXXXXXXXXXXXXXXXXXXXXXXXXXXXXXX--XXXXXXXXXXXX
XXXXXXXXXXXXXXXXXXXXXXXXXXXXXXXXXXXXXXXXXXXXXXXXXXXXXXXXXXXXXXXXXXXXXXXXXXXXXXXXXXXXXXXXXXXXXXXXXXXXXXXXXXXXXXUXXXXXXXXXXXXXXXXXXXXXXXXXXXXXXXXXXXXXXXXXXXXXXXXXX---XXXXXXXXXXXX
