--------------------------------------------------------------------------------------------------------------------------------------------------------------------------------
--------------------------------------------------------------------------------------------------------------------------------------------------------------------------------
------------------------------------------------------------------------------------------------------------------------------------------------tt------------------------------
------------------------------------------------------------------------------------------------------------------------------------------------tt------------------------------
t-----------------------------------------------------------------------------------------------------------------------------------------------tt------------------------------
------------------------------------------------------------------------------------------------------------------------------------------------tt------------------------------
-----------QQQ-o-----------------------------------------------------------------------------------------------------------------------------------------------o----------------
------------------------------------------------------------------------ooo---------------oo-------------o----------o-----------------------------------ooo---------------------
%%%%%-----------S---------------------------------------------------------------------------------------S-----------------------------------------------%%%%%-------------------
-|||------------------------------------SS---------------SSS---#--go------Q---------------S--------------------------------------------------------------|||--------------------
-|||----------------------------------------------------------#-----------------------------------S-------------------------------2-------------Q----tt--|||-----------------##-
-|||---------------------------------------------K-----------##-------------------------------------------------TT------------------tt---------------tt--|||--------t--------##-
-|||--------------------------------------------------------###------------------------TT-----------------------TT------------------tt---------------tt--|||--------tt------###-
-|||----------g-----------------K----------#------K--------####------------------------TT---#---K---------------TT-------------yK---tt--------#------tt--|||--g-K---tt----#####-
-XXXXXXXXXXX--X-XXXXX-XXX----XX--XXX-XXXXXXXXXXXXXXXXXXXXXXXXXXXXXXXXX-XXXXXXXXXXXXXXXXXXXXXXXXXXXXXXXXXXXXXXXXXXXXXXXXXXXXXXXXXXXXXXXXXXXXXXXXXXXXXXXXXXXXXXXXXXXXXXXXXXXXXXXXX
XXXXXXX-XXX---X-XXXXXXXXX----XX--XXX-XXXXXXXXXXXXXXXXXXXXXXXXXXXXXXXXXXXXXXXXXXXXXXXXXXXXXXXXXXXXXXXXXXXXXXXXXXXXXXXXXXXXXXXXXXXXXXXXXXXXXXXXXXXXXXXXXXXXXXXXXXXXXXXXXXXXXXXXXXX
