--------------------------------------------------------------------------------------------------------------------------------------------------------------------------------
--------------------------------------------------------------------------------------------------------------------------------------------------------------------------------
--------------------------------------------------------------------------------------------------------------------------------------------------------------------------------
-------------------------------------------------------------------------------------------------------------------------------------------g-------------------------------g----
---------------------------------------------------------------------------------------------K---------------------------------------------S-------------------------------S----
---------------------------------------------------------------------------------------------------------------U---------------------------------------------------------------U
---r--r--------------------------------------------SSSSSSS----SS-------------SSS--------SSSS---S-------SS------S-------USSSS--@%-------SSS-----%--SQ---SSSSSQQSS---QS-SSSSSS---%
%%%%%%%%%%---------------------y--------------U--------S-------S---------------------------------------------------------------|---------------|-------------------------------|
-||||||||-------------------------------S-------------SSS------S-----------------------SSSS------------SSSS------------SSSS----|-------SSSS----S--------S--------------SSS-----|
-||||||||-----------------o----#--g---SSSSS---S----ooSSSSoo-------o-----SSS-----------------------------SS---------------------|---------------------------------------------2-|
oR|||||||----------U----------##--------SS----S----SSSSSSSS----#------------------2---------------------S-----SQ--SS---SS------|--------S---------2----SS---------2S---SS------|
-||||||||--------------------##------------------K----------S-##-K---------------K-------------------------------K-------------|-K-------------------------t-------------------|
-||||||||---TT--------------###------------------SSSS--SS--S--##---------------------------B---------------B-------------------|---------------------------tt------------------|
-|||y||k|y--TT-k-----------#####K----------y-------------k----##--K--------g----K-K--------b----K----------b------------U------|k---------#-----K----------tt-g-K-------U-#----|
XXXXXXXXXXXXXXXX%----XXXXXXXXXXXX----X----XXX-X-X----XXXXXXXXXXXXXX--XXXXXXXXXXXXXXXXXXXXXXXXXX-XXXXXXXXXXXXXXX-XX--XXXXXXXXXXX|XX---XXXXXXXXXXX-----XXXX--XXXX-R----XXXXXXXXXX|
XXXXXXXXXXXXXXXX|----XXXXXXXXXXXX----X----XXX-X-X----XXXXXXXXXXXXXX--XXXXXXXXXXXXXXXXXXXXXXXXXXXXXXXXXXXXXXXXXX-XX--XXXXXXXXXXXXXX-X-XXXXXXXXXXX-----XXXX--XXXX-X----XXXXXXXXXX|
