----------------------------------------------------------------------------------------------------------------------------------------------------------------
-------------------------------------------------------------------Q--------------------------------------------------------------------------------------------
------------------------------------------------------------------##--------------------------------------------------------------------------------------------
-----------------------------------------------------------------#####----------------------------------------------SS------------------------------------------
-----------------------------------------------------------------##k##----------------------------------SS------------------------------------------------------
----------------------------------------------------------------####------------------------------------SS------------------------------o-----------------------
-----------------------#------2%-----------------------------------------------------Q-SSSS@-------------------------USoo--o--@%-------SSS---------------------o
----------------------##-------|--------------------------------%#-##----ooo--------------------------------------K------------|------------------------oo------
---------------------###-------|--------------------------------|-----------------------------------------------SSSS-SS-SSS----|--------------------------------
--------------------####-------|--------------------------------|--------------------------------------------------------------|--------------------------------
--------------##---#####-------|------------------2-----@----##-|-S---------TT---oo----So-----Q----------%---------------SSSS--|------SSS-----------------------
-------------##---######-------|TT--------------------------###-|------T----TT------------------T--------|----------------SS---|-------------#-------t-----tt---
------------###--#######-------|TT-------------------------####-|---TT-TT---TT------------------T--------|---------------SS----#------------##------tt-----tt---
-k---------####-########-------|TT---y-g------ggK---------#####-|-k-TT-TT-k-TTT-ggg------gggg-g-T--------|---------------------#-------ggg--##--g---tt-----tt---
XXXXXXXXXXXXXXXXXXXXXXXXXXXXXXXXXXXXXXXXXXXXXXXXXXXXXXXXXXXXXXX-XXXXXXXXXXXXXXXXXXXXXXXXXXXXXXXXX-----%%%|-----XX---XXXX----XX-XXXXXXXXXXXXXXX--XXXXXXXXXXXXXXXX
XXXXXXXXXXXXXXXXXXXXXXXXXXXXXXXXXXXXXXXXXXXXXXXXXXXXXXXXXXXXXXX-XXXXXXXXXXXXXXXXXXXXXXXXXXXXXXXXX------|-|-----XX---XXXX----XX-XXXXXXXXXXXXXXX--XXXXXXXXXXXXXXXX
