-------------------------------------------------------------------------------------------------------QQQ------------------------------------------------------
---------------------------------------------K-------------------------------------------------------------K-K--------------------------------------------------
---------------------------------------------------------------------------------------------------------------U------------------------------------------------
----------------------------------------------------------------------SS--------------------------------------------------------SS------------------------------
-----------------o------------------------g---------------------------------------------------------------------------------------------------------------------
%%%%%%%---------%%%-------------------%%%%%%------------------------------o---------------------%%%%%%%%%-@-----------------------------------------------------
-|||||-----------|---------------------||||----------U-------------------------------------------|||||||--------------------------------------------------------
-|||||-----------|-----------------ooo-||||------------------------------------------------------|||||||--------------------------------------------------------
-|||||-----------|-------------------%%%%||-%-------------------------SS---------------------y---|||||||%%%%%%--------------------------------------------------
-|||||-----------|-----SS-----oo------||-||-|-r--------------#--ooSSSSS----S-SSS-------------2---|||||||-||||---------------------------------------------------
-|||||-----------|-----U------S-TT----||-||-%%%%---###------##-#--------------SS%%%%%%%%%----#---||%%%%%%%|%|-%%--Q-------------------------------------------#-
-|||||-----------|--------------TT----||-||--||---####-----###-#-----------------|||||||----##---||-|||||-|||-||-------------------------TT---TT--------------#-
-|||||-----tt----|--------------TT----||-||--||--######---####-#SSSS------------%|||||||---###---||-|||||-|||-||-------------------------TT---TT-------------##-
-g||||-----tt----|gg----kk------TT----||-||--||-#######--#####-#----------------||||||||k-####---||-||||g-|||-||-------------------------TT---TT------------###-
-XXXXXXXXXXXXXX--XXX---XXXXXXXXXTX----%%%%%%%%|-XXXXXXXXXXXXXXXX---%%---------X-||||||||XXXXXXXX-||-|||||-|||-||XXXXXXXXXXXXXXXXXXXXXXXXXXXXXXXXXXXX-X-XXXXXXXXX
-XXXXXX-XXXXXXX-XXXX----XXXXXXXXTX-----||||||-|-XXXXXXXXXXXXXXXX---||-------X-X-||||||||XXXXXXUX-||-|||||-|||-||XXXXXXXXXXXXXXXXXXXXXXXXXXXXXXXXXXXX-X-XXXXXXXXX
