----------------------------------------------------------------------------------------------------------------------------------------------------------------
----------------------------------------------------------------------------------------------------------------------------------------------------------------
----------------------------------------------Q----------------------------------------------------------------------------------------------------o------------
--------------------------------oo--------------------------------------------------------------------------------------------------------------SSSS--------SSSS
------------------------------------------o---------------------------------------------------------------------------------------------------------------------
---------------------------------------%%%%---------------------------------------------------------------------------------------------------------------------
---------------S---oS-------------------||--------------------------------------SSSL----------@-------------o--------------------------#------------------------
----------------------------------------||----U---SS----------------------------------------------------------------------------oS----##------------------------
-----##----------------------------%%%%-||--%----------------------------------------#------------------------------------------SS---####------------%%%---%----
----###---------------------U-------||--||--|---------------------------------------##----------------------------------------------#####-------------|----|----
---####---------o--------U----------||--||--|------------TT------------------------###---##-----------------------------------------#####-------------|----|----
--###-#-------------------------TT--||--||--|------------TT------------------------###---##-----------------------------------------#####-------------|----|----
-####-#-------------------------TT--||--||--|---#---#----TT----T-----------------#-###---##-----T----------%%--------------------#--#####---------TT--|----|----
#####-#------k-------y-k-------gTT--||--||--|---#---#-#--TT----T-------g-----ggg-#-###---##-----T----------||--------y-----------########---------TT--|----|----
XXXXXXXXXXXXXXXXXXXXXXXXXXXXXXXXXXX-||--||XX|--XXXXXXXXXXXX----XXXXXXXXXXXXXXXXXXXXXXXXXXXXXXXXXXXXX------XXXXXXXXXXXXXXXXXXXXXXXXXXXXXXXX-XXXXX-XXXX-|----|----
XXXXXXXXXXXXXXXXXXXXXXXXXXXXXXXXXXX-||--||XX|--XXXXXXXXXXXX----XXXXXXXXXXXXXXXXXXXXXXXXXXXXXXXXXXXXXX-----XXXXXXXXXXXXXXXXXXXXXXXXXXXXXXXX--XXXX-XXXX-|----|--X-
