----------------------------------------------------------------------------------------------------------------------------------------------------------------
----------------------------------------------------------------------------------------------------------------------------------------------------------------
----------------------------------------------------------------------------------------------S-------------------Q---------------------------------------------
-----------------------------------------------------------------------------------SSSSSSSSSSSSS----------------------------------------------------------------
-----------------------g---------------------------------------------------------------SSSo---------------------------------------------------------------------
-----------------------------%%%--------------------------------------o----------------SSSS---------------------------------------------------------------------
--SQ------o-------------------|----------------------@----------------------------------------------Q-----------SSSSo-------------SSSSSooS-----%------r---------
------------------------oo----|--------------------------------y----S---------------------------------------------SS---------------------------g-o--o%%%--------
---------S------------%%%%%%%%|---------------------------------------------------------------------------------------------------SSSS-SSSS--g##------|---------
----------------g------||||||-|------------------------------#------------------------------------------------------------------------------y###------|---------
------------##---------||||||-|--------##-------------------##-#TT----------------------------S--oSSo---------------------------------------####-##-TT|---------
---#-------###---------||||tt-|----------------------------###-#TT------------TT--------------------------------T--------TT----------------######---TT|-----TT--
---#------##--------ttt||||tt-|--------------------#-#----####-#TT-------TT---TT--------------------------------T-----B--TT----#---#------######----TT|-----TT--
-#-#-#---####---g---ttt||||tt-|--------------------#-#---#####-#TT---y---TT---TT----------kkk----------gg-------T-----b-kTT----#---K-U---#######----TT|k----TT--
XXXXXXXXXXXXXX-XXXXX-XX|||XXXXX-XXXXXXXXX---XXXXX--XXXXXXXXXXXXXXXXXXXXXXXXXXXXXXXXXX--XXXXXXXXXX---XXXXXXXXXX--XXXXXXXXXXXXXXXXX--XXXXXXXXXXXXXXXXXXXXXXXXXXXXX
XXXXXXXXXXXXXX-XXXXXXXX||XXXXXX-XXXXXXXXX---XXXXX--XXXXXXXXXXXXXXXXXXXXXXXXXXXXXXXXXX--XXXXXXXXXXXXXXXXXXXXXXX-XXXXXXXXXXXXXXXXXX--XXXXXXXXXXXUXXXXXXXXXXXXXXXXX
