----------------------------------------------------------------------------------------------------------------------------------------------------------------
----------------------------------------------------------------------------------------------------------------------------------------------------------------
----------------------------------------------------------------------------------------------------------------------------------------------------------------
------------------------------------SSS-----S--------------------------------------------------------------------------------------------------@--SSSSSSSSSSSSSS
----------------------------------------------------------------------------------------------------------------------------------------------------SSSSSSSS----
---------------------------------------------------------------------------------------------------k-ggg--------------------------------------------SSSS-SSS---U
-----SSSSSSS--%%----------------------------o-----------------------------------%%%---------------###-----------SSSK------------------------------SSSSSSSSS---SS
%------S------||--------------------o----------------r---------------------------|---oo----------SSSSS-----------------------------------------------SSSSS------
|-------------||----------------------------------%%%%%%%------------------------|----------------S--#---TT-------------------------------------------SSS-------
|-------------||-----------------------------------|||||-------------------------|------------------##---TT-----------------------g-----------@---ooSSSSSSoS----
oUSSSSSSoS----||---#--------##--------------S------|||||-%%%%---------SQ@--------|--------------###-##---TT---TT------------------------S%%--------SSSS-SS---SSS
|-----------TT||---#-------###--TT--------------TT-|||||--||---------------------|--------------###-##---TT---TT----------T--------------||------K----------SSS-
|-----------TT||-###-#----####--TT--------------TT-|||||--%%%%%%-----------------|-------------T###-##---TT---TT---------TT--------------||------SS-------------
|------kgg--TT||-###-#-k-#####--TT--------------TT-|||||---||||--g-g------ggg-gg-|-------------T#-#-###--TT---TT---ggg---TT----g---------||----------k--------#-
XXXXXXXXXXXXXXXXXXXXXXXXXXXXXX-XXXXXXXX-XXXXX-XXXX-|||||---||||-XXXXXXXXXXXXXXXXXXXXX----XX----XXXXXXXXXXXXXXXXXXXXXXXXXXXXXXXXX%%---XX--||---%-X----XXXXXXXXXXX
XXXXXXXXXXXXXXXXXXXXXXXXXXXXXX-XXXXXXXX-XXXXXXXXgX-|||||---||||-XXXXXXXXXXXXXXXXXXXXX----XX----XXXXXXXXXXXXXXXXXXXXXXXXXXXXXXXXXg|g--X---||---|-X----XXXXXXXXXXX
