----------------------------------------------------------------------------------------------------------------------------------------------------------------
----------------------------------------------------------------------------------------------------------------------------------------------------------------
----------------------------------------------------------------------------------------------------------------------------------------------------------------
-----------------------------------o----SS----S---SSSSSSSSSSSSSS-----------------------------------------------------------------------------o------------------
---------------------------------------------------SSSSSSS---SS-------------------------------------------------------------------------------K-----------------
------------------------------------------------SSSSSSSSSSS-SS--------------------------------------------------------------------------------------------------
----------------SSS---------QQSQ------------------------S--SSS---SSSSSSSSSoU--@------------------------------------------------------S--------------------------
----------------------------------------------K------SSSSSSSSS-----------------------------------------------------------SSS-------------------y----------------
----------K----------------------------------------------SSSSS----------------------------------------------------------SSSS-------SS-SSSSSS---#----------------
----------S----------------------------r---------KS----SSSSSSSS-------------y----------------------oo--------------------SS-----o---S----------#----------------
--------------#------------------%%%%%%%%%%%%%%--SS-----SSSSSSS-------------##-----Q---------------S----------------------------S---SS------##-#----------------
--------------#-------------------||||||||||||--SS-------------------------###-------------------------------------------------------------###-#----------------
-------TT---###----------#--------|||||||%||||------TT----------------B---####--------------##----------------------------------SSSS---S--####------------------
--k----TT---###-------g--TT--ggg--||||||||||||------TT----kkk---------b--#####-----ggggg----##---------k----------k--T----k--------------#####------y-------TT--
XXXXXXXXXXXXXXXXXXXXXXXXXXXXXXXX--|%%%%%%|||||--XXX-XXXXXXXXXXXXXXXXXXXXXXXXXXXXXXXXXXXXXXXXXXXXXXXXXXXXXXXXXXXXXXXXXXXXXXXXXXXXX--SXXXXX---XX-XXXXXXXXXXXXXXXXX
XXXXXXXXXXXXXXXXXXXXXXXXXXXXXXXX--|-||||-|||||--XXXXXXXXXXXXXXXXXXXXXXXXXXXXXXXXXXXXXXXXXXXXXXXXXXXXXXXXXXXXXXXXXXXXXXXXXXXXXXXXX----XXXX---XX-XXXXXXXXXXXXXXXXX
