----------------------------------------------------------------------------------------------------------------------------------------------------------------
-----------------------------------------------------------------------------L----------------------------------------------------------------------------------
-------------------------------------------------------------------------------U--------------------------------------------------------------------------------
----------------------------------------------------------------------------------------------------------------------------------------------------------------
--------------------------------------------------------------------------g-------------------------------------------------------------------------------S-----
--------------------------------------------------------------------------L-------------------------------------------------------------------------------------
----------Soo-------------------------USSSS@--2------------------------------------------------S--------------------------------SSS---S-SSS-------USQUSSSS------
------------------------ooo---------------------------------------------r----------------------------------S----------------------------------------------------
%%---------------------------------------------------------------------%%-----------------------------------S---------------------------------------------------
||---------------------------------------------------------------------||------------------------------o-SSSSSSS------------------------------------------------
||----SSSS--------SS----------------Q--S-USS---------------------%%----||-%%-------------SSS--------%%%%%%--%%%%--#-TT----------------------##------------%-----
||----------------------------------------------TT---------------||----||-||-------------------#-----||||----||-#---TT----------------------##------------|-----
||------%%%%%%%%--------------------------------TT---------------||----||-||-------------------#-----||||----||-----TT---TT-----------B---#--#--B---------|-----
||-------||||||---k-------k--------ggg-g--------TT-----------ggg-||----||-||-------------------#-----||||--o-||-----TT---TT-----------b---#--#--T-----g---|-----
||-------%%%%%%-XXXXXXXXXXXXXXXXXXXXXXXXXXXXXXXXXXXXXXXXXXXXXXXX-||--X-||-XX--X-X---XXXXXXXXXXXX---%-||||----||-XXX-XXXXXXXXXXXXXXXXXXXXXXXXXXXXXXXXXXXXXXXXXXXX
||--------||||--XXXXXXXXXXXXXXXXXXXXXXXXXXXXXXXXXXXXXXXXXXXXXXXX-||--X-||-XX--X-X---XXXXXXXXXXXX---|-||||----||-XXX-XXXXXXXXXXXXXXXXXXXXXXXXXXXXXXXXXXXXXXXXXXXX
