-----------------------------------------------------------------------------------------------------------------------------------------------------------%----
-----------------------------------------------------------------------------------------------------------------------------------------------------------|----
-----------------------------------------------------------------------------------------------------------------------------------------------------------|----
----------------S----SS---------SSSSS--SSSSSSSSS----------------------------------------------------------------------SS--S--------------------------------|----
----------------S-----------------------------------------------------------------------------------------------------S---SS-------------------------------|----
----------------------------------------------------------------------------------------------------------------------SS--S----U---------------------------|----
------------------S---------------o-------o--------------------------------------------o-----------------------o-----SSSSSS----S------------QQQQSSS--------|----
--------------------S-#-------------------------------------------------------------------------------------------KS-S---------S----------------SS---------|----
----------------SSS--##----------------%%----------%-------------------------------------------#------------------SS-SSS-----------------------------------|----
--------------------###----------------||----------|-----------------------------------------###---g------g-------SSSSS-----------------------------#------|----
-------T------TT--#####--#T-##-#%%%%%%%%%----%%----|---------------------------------SS-----####--Q-----QQQQQQ--SS---SSSSS-----#--TT-------QQQQ-----#----TT|----
-------TT-----TT-######--##----#-|||||||-----||-T--|---------------------TT----------------#####-------------------------------#--TT------------TT-------TT|----
-------TT-----TT#######--##----#%|||||||--%%%%|-T--|--------------TT-----TT--------#------######---------------------SSSSSSS---#--TT------------TT#-#----TT|----
-------TT-----TT#######--##----#||||||||---||-|-T--|--------------TT-----TT----k---#-----#######-------------------------------#--TT----------g-TT--#-#--TT|----
XXXXXXXXXXXXXXXXXXXXXXXXXXX-XX-X||||||||---||-|-XX-|XX-------%%-XXXXXXXXXXXXXXXXXXXXXXXXXXXXXXXXXXXXXXXXXXXXX-XX--%%%----------XXXXXXXXXXXXXXXXXXXXXXXXXXXXXXXXX
XXXXXXXXXXXXXXXXXXXXXXXXXXX-XX-X||||||||---||-|-XX-|XX-------||-XXXXXXXXXXXXXXXXXXXXXXXXXXXXXXXXXXXXXXXXXXXXXXXX---|------XX---XXXXXXXXXXXXXXXXXXXXXXXXXXXXXXXXX
