---------------------%------------------------------------------------------------K-----------------------------------------------------------------------------
---------------------|------------------------------------------------------------------------------------------------------------------------------------------
---------------------|------------------------Q-----------------------------------------------------------------------------------------------------------------
--SSSSSSSSSSSS%%-----|-------------o---------------------------------SSS------------------------------------------S-SSS--SSS------------------------------------
--------------||-----|------------------------------------------------------------------------------------------------------------------------------------------
--------------||-----|---------------------------------------------------------U-----------------------------------------------U--------------------------------
--------------||-----|--------------------------SS-------Q-QQ-----------------------------------------------------@SS@SSoSo----------------------SS----SSSSSSSSS
--------------||----o|---------------r--------U--------------------------------------------------------ooooo----------------------------------------------------
-------%%%%%--||-----|-----------%%%%%%%------------------------------------------------------------------------------------------------------------------------
--------|||---||-----|------------|||||-------------------------------------y----------------------------------o-------------R----------------------------------
%%%%%%%%%%%%%%%%-----|--------T---|||||--%%%%%%-----------%%%-------%%%------#---------------##----------------Q-----------U##-----------------Q--------------SQ
-||||||||||||||------|--------TT--|||||---||||-------------|---------|-------#--------------###----------------------------###-------------tt-------------------
-||||||||||||||------|--------TT--|||||---||||%-T-----tt---|-%%%%----|-----###-------------####-----------------------B-K-##----B----------tt-------------------
-||||||||||||||------|--------TT--|||||---|||||-T-----tt---|--|-|----|----####-----k------#####-----------------------b---##----b----------tt-g----g-ggg------g-
-|||||%||%%%%||-XXXXXXXXXXXXXXXX-XX||||---|||%%-XXXXXXX----|--%-|----|---------XXXXXXXXXXXXXXXXX-XXX------XXXXXXXXXXXXXXXXXXXXXXXXXXXXXXXXXXXXXXXXXXXXXXXXXXXXXX
-||||||||-g|g||-XXXXXXXXXXXXXXXX-XXX|||---|||||-XXXXXXX----|--|-|----|---------XXXXXXXXXXXXXXXXX-XXX-----XXXXXXXXXXXXXXXXXXXXXXXXXXXXXXXXXXXXXXXXXXXXXXXXXXXXXXX
