----------------------------------------------------------------------------------------------------------------------------------------------------------------
-------------------------------------------K-K---------------K--------------------------------------------------------------------------------------------------
-----------------------------------------------U---------------U------------------------------------------------------------------------------------------------
--------------------------------------SSSSSSS%%%----------------------------------------------------------------------------------------------------------------
----------------------------------------------|-----------------------------------------------------------------------------------------------------------------
------------------------------------------K---|-%%%%%--------------------------------------------------o---o----------------------------------------------------
----------------------------------------------|--|||----------------------------------U-----SS------------------------r-Q----------SSSS-----SSSSQ-SQQSSSUSoS--@%
--------------------------------------r-r-----U--|||--------------------oooooo------#--------S----S------------------%%----------------------------------------|
---------------------------------%%%%%%%%-----|--|||-----------Q-----------------------------------------------------||------------SSS-------------------------|
----------------------------------|||||r---r--@--|||---r--------------------------#----------------------------------||----------------------------------------|
-----------------------TT-------%%%%%%%%%%%%%%%--|%%%%%%%%-----------------------##-TT-----------##------------------||---QQQ-----SSSS----------------SSSSSSQS-|
----K--TT-----------K--TT--------|||||||||||||---|-||||||----#---------TT-------#---TT--------TT#---TT------TT-------||----------------------------------------|
-------TT--------------TT--------|||||||||||||---|-||||||---##---------TT-----------TT--------TT#---TT------TT-------||-------------------------%%-------------|
-------TT--------------TT--------|||||||||||||---|-||||||---##---------TT-----------TT---TT---TT#---TT---y--TT-------||-----gggg-------k-------k|g-g--y-ggggggg|
XXXXXXXXXXXXXXXXXXXXXXXXXXXXXXXX-%%%%%%%%%||||--%|%||||||-------XXXXX--XXXXXXXXXXXX-XXXXXXXXXXXXX---XXXXXX--XX-XXXXXXXXXXXXXXXXX----KXXXXXXXX-XXXXXXXXXXXXQQXXXX
XXXXXXXXXXXXXXXXXXXXXXXXXXXXXXXX--|||||||-g|||--g||||||||-------XXXXX--XXXXXXXX-XXXXXXXXXXXXXXXXX---XXXXXX--XX-XXXXXXXXXXXXXXXXX----XXXXXXXXXXXXXXXXXXXXXXXXXXX-
