----------------------------------------------------------------------------------------------------------------------------------------------------------------
---------------------------------------------------------------------------------------------------------------------------------------------K------------------
----------------------------------------------------------------------------------------------------------------------------------------------------------------
------------------------------------------------------------------------------------------S--SSSSSSSSSSSSSSSSSSS------------------------------------------------
-----------------------------------g------------------------------------------------------------------S------------k-------------------g------------------------
--------------------------------%%%%-----------------------------------o----------------------------------S-------##--------------%%%---------------------------
---------------S---SSSS-------SS-||---U--------------------------------------------------------------------------------------------|--------------SSSSSSSSS@--@%
--------------------------------%%|-------------------------------ooo---------------------------------------------------oooo-------|-----o----U----------------|
-------SSSS---------------------|||--------------------%%%%%-----------------------------------#%%%---S----------------------------|------K--------------------|
---oS----SS---------------------|||---------------------|||------------------------oS--------T---|---------S-SSS-------------------|-----S---------------------|
---SS---------------------------|@SS---SU---------------|||---#-TT----------------SSSS------####%%---%%-%%-------------------------|---------------2-----@S-QQ-|
-K-----------------------------y|-----------------------|||-----TT-------TT---------S------#####||---||-||-------------------------|---------------------------|
-S-----------------------------#|------------T----------|||---#-TT--TT---TT-----SSS-------######%|---||-|%%%%----------TT---TT-----|------------------B--------|
----------gg-----------k-------#ggg----ggg--TT----------|||---#-TT--TT---TT--------------#######||---||-|-||-----------TT-k-TT-----|---------------gggb-------y|
XXX-XXXXXXXXXXXXXXXXXXXXXXXXXXXXXXXXXXXXXXXXXXXX-X-X----XXXXXXX-XXXXXXXXXXXXXXXXX---XXXXXXXXXXXX||-%%|%-%%%%%---XXXXXXXXXXXXXXXX---|-X-XXXXXXXX-XXXXXXXXXXXXXXXX
XXX-XXXXXXXXXXXXXXXXXXXXXXXXXXXXXXXXXXXXXXXXXXXX---X---XXXXXXXX-XXXXXXXXXXXXXXXXX---XXXXXXXXXXXX||-|||g-g|g|g---XXXXXXXXXXXXXXXX---|-X-XXXXXXXX-XXXXXXXXXXXXXXXX
