----------------------------------------------------------------------------------------------------------------------------------------------------------------
----------------------------------------------------------------------------------------------------------------------------------------------------------------
-------------------------------------------------------------------------------------------------------------------------------------------1--------------------
---------------------------------SSSSSSSSSS---------------------------------------------------------------------------------------------------------------------
----------------------------------------------------------------------------------------------------------------------------------------------------------------
----------------------------------------------------------------------------------------------------------------------------------------------------------------
---------o----2%-----------------------------o----SSSUSSUS-o--2%--------------@---------------------------------S--------------S---ySSSSSSoo-----S--------------
------%%-------|---------------------------------------------U-|%---------------------------------Ko------------------------------------------------------------
------||-------|-------%--%%-----------------------------------||---------S-------------------------------------------------------------------------------------
------||-------|-------|--||--------------------------------U--||-----------------------------------------------------------------------------------------------
oSS---||-SSS---S-------|--||------------------------------SS---||------SS----#-----------------S--------------#------------QQ-----------------------------------
------||---------------|--||------TT-----TT--------------------||-----------TT--------------------------------#---------------------------------T---------------
------||---------------|--||------TT-----TT-----------B--------||-----------TT---------TT---------------------#---------------------------------T---------------
------||---ggggg-k-----|--||------TT-----TT--------ggyb------ggg|-------gg#-TT---------TT--ggggg------------k-#-------g-------gg-----g-g--------T---------------
XXXXXXXXXXXXXXXX-XXX---|--||----XXXXXXXXXXXXXXXXXXXXXXXXXXXXXXXXXXXXXXXXXXXXXX-XXXXXXXXXXXXXXXXX%%%%%------XXXXXXXXXXXXXXXXXXXXXXXXXXXXXXXXXXXXXXXXXXXXXXXXXXXXX
XXXXXXXXXXXXXXXX-XXX---|--||--X-XXXXXXXXXXXXXXXXXXXXXXXXXXXXXXXXXXXXXXXXXXXXXX-XXXXXXXXXXXXXXXXXg|||-------XXXXXXXXXXXXXXXXXXXXXXXXXXXXXXXXXXXXXXXXXXXXXXXXXXXXX
