----------------------------------------------------------------------------------------------------------------------------------------------------------------
----------------------------------------------------------------------------------------------------------------------------------------------------------------
----------------------------------------------------------------------------------------------------------------------------------------------------------------
--------------------------------S-------------------------------------------------SS---SSSSSSSSS------------------------------------------------SSSSSS----------
--------------------------------------------------------------------------------------S--SS---------------------------------------------------------------------
-----------------------------------------------------------------------%--------------S-SSSS--------------------------------------------------------------------
---------------------------------SS------------------------SSQ---------|------------------SS------------------------S----SS------------------SS--------------SSS
-------------------------------------oo--------------------------------|------U------------------------------------------------------------------SS-------------
------------------------------------------------------------------%----|-------------------------------------------------------------#----------SSSS--#----S----
------------------------------------------------------------------|----|S--------------r---r--rS----------------------------y-------##----------------#---------
-----------------------S--------------------------S----SSSSSSS----|----|--------%%%%%%%%%%%%%%%%-----------------------------#----#-##----------S---#-#---------
----------------------------TT--TT--------------------------------|----|---------||||||||||||||-----------------------------##--#-#-##---TT----T#---#-#---------
-----------B----------------TT--TT----B-------------------------T-|----|---------||||||||||||||----------------------------#----###-##---TT----T#---#-#---%%----
-----------bg-g----------y--TT--TT----b-----------------ggggg-ggT-|----|---------||||||||||||||--------------------g-g-----#----#-#-###--TT----T#---#-#---||----
XXXXXXXXXXXXXXXXXXXXXXXXXXXXXXXXXX-------XX-----XXXXXXXXXXXXXXXXXX|--X-|---X--X-%%%%%%%%%%|||||-XXXXXXXXXXXXXXXX---XXXXXXXXXXXXXXXXXXXXXXXXXXXXXX---X-X---%%%---
XXXXXXXXXXXXXXXXXXXXXXXXXXXXXXXXXX-------XX-----XXXXXXXXXXXXXXXXXX|--X-|--XX--XX-||||||||-|||||-XXXXXXXXXXXXXXXX---XXXXXXXXXXXXXXXXXXXXXXXXXXXXXX---X-X---g|----
