-------------------------------------------------%---%%---------------------------------------------------------------------------------------------------------
---------------------------K---------------------|---||------------------------------------------------------------------------------------------------K-----K--
-------------------------------------------------|---||--------------------------------------------------------------------------------------------------------U
----------------SoooS--%%%----S------------------|---||-------------------------------------------------------------------------------------------------------%-
--------------------Q-o-|------------------------|---||-----------------------------------------------------------------------------------------------S-------|-
-----------------------%%%%----------------------|---||-------------------------------------------------------------------------------------------------------|-
---QQQSSSSo-------------||------%%%--------------|---|r---------------oo-ooo--2%----------------------------------SSSSSSSSS---SS---------Q-QQQ----------------|-
---------------------r--r|-------|---o-----------|%%%%%%%%----------------r--U-|---------------y---------ooo--------------------------------------------------|-
----------------%%%%%%%%%%-------|---------------|-||||||----------------------|-------S----------------------------------------------------------------------|-
-------------1---||||||||----SrS-|---------------|-||||||-------------------U--|--------------##--------------------------o----------------------------r---r--@-
-----------------||||||||%%%%%%%-|TT-------------2-||||||@S-----o--------------|-------------###-------TT---------SSSS----------QQQ-----SSSS----%%%%%%%%%%%%--%-
-----------------||||||||-|||||--TTT-------------|-||||||---TT------TT------TT-|------------###--------TT----------------------------tt----------||||||||||---|-
-----------------||||||||-|||||--TTT-------------|-||||||---TT------TT------TT-|-----------####--------TT-----#----------------------tt----------||||||||||---|-
-----K----##-----||||||||-|||||--TTT-------------|-||T||gg--TT------TT-k----TT-k---k------######-------TT---kk#----g-kR--------------tt-------g--||||||||||---|-
XXXXXXXXXXXXXXXX-|||||%%%%%%%%|-XXXXXXXXXXXXXXXXXXXXXXXXXXXXXXXXXXXXXXXXXXXXXXXX---X---XXXXXXXXXXXXXXX-XXXXXXXXXXXXXXXXXXXXXXXXXXXXXXXXXXXXXXXXX%|%%%%%||||X--|-
XXXXXXXXXXXXXXXX-|||||-||||||-|-XXXXXXXXXXXXXXXXXXXXXXXXXXXXXXXXXXXXXXXXXXXXXXXX---X---XXXXXXXXXXXXXXX-XXXXXXXXXXXXXXXXXXXXXXXXXXXXXXXXXXXXXXXXXg|-|||-||||X--|-
