----------------------------------------------------------------------------------------------------------------------------------------------------------------
----------------------------------------------------------------------------------------------------------------------------------------------------------------
----------------------------------------------------------------------------------------------------------------------------------------------------------------
SSSSSSSSSSSSSSSS------------------------------------------------------------SS----------------------------------SSSSSSSSSSSSSSSS--------------------------------
-S--------------------------------------------------------------------------------------------------------------SSS---------------------------------------------
----------------------------------------------------------------------------------------------------------------S-----------------------------------------------
-----------o------------------------------------o---So----------------------------QQQQQQQQQ----@-----------------------------------------------o---SQSS---------
-----------------------------------------oo---------S-------------------r---------------------------------------o-----#-----------------------------------------
S-------------------------U--------------------------------------%%%%%%%%%--------------------------------------S-----#----------------------------------------#
--------------S---------------------------------------------------|||||||---------------------------------------S-----#----------------------------o---------2##
-------%%%%%%%%%ooo------------------------tt---#---##---##-##----|||||||-%%-------QQ-@---@QQQ----------------#-------#------%%%--------S------Q----o--------###
--------|||||||---------------------tt-TT--tt---#---##---##----#--|||||||-||----------------------------------#---##--#-------|------------tt---------------####
--------||%||%%---------------------tt-TT--tt---#---##---##----#--|||||||-%%%%--------------------------------#--####-#-------|-----tt-----tt-------------#####-
--------|||||||-gg------g-ggg-g-----tt-TT--tt---#---##---##----#--|||||||--||------------------------------#--#-#######-------|-g---tt-----tt-g-----------######
--XX----|%%%%%%-XXXXXXXXXXXXXXXXXXXXXXXXXXXXXXXXX---XXXXXXXXXXXX--|||%%||--||---XXXXXXXXXXXXXXXX---X-XX-XXXXXXXXXXXXXXXX---%%-|-XXXXXXXXXXXXXXXXX-XXXXXXXXXXXXXX
--XX----|-||||--XXXXXXXXXXXXXXXXXXXXXX-XXXXXXXXXX---XXXXXXXXXXXX--|||||||--||---XXXXXXXXXXXXXXXX--XX-XX-XXXXXXXXXXXXXXXX---||-|-XXXXXXXXXXXXXXXXX-XXXXXXXXXXXXXX
