----------------------------------------------------------------------------------------------------------------------------------------------------------------
----------------------------------------------------------------------------------------------------------------------------------------------------------------
-----------------------------------------------------------------------------------------------------------2----------------------------------------------------
----------------------------------------------------------------------------------------------------------------SSSSSSSS-SS-------------------------------------
------------------------------------------------------------------------------------------------------------------S---------------------------------------------
--##--------------------------K-------gg----------------------------------------------------------------------------S------o-oo---------------------------------
---------------o----SUSooooo--@%-##----------------------------o----Q---------------------------QSQQQQ-@SSo2--@---SSSSS-------SS-------------------SSSS---------
--------oooo-------------------|-SSS---------------------o-------------------------------o------------------------SSSS-------SS--------------------------------y
------------------------SSS-y--|-----#---------------------------------------------------------------------------SSSSSS--------------------------------------y##
----------------------------2--|----##---------------------------------------1----------SSS----------------gg1-----SS---------------------------------------y###
----tt--------------------SSS--|###-##---##------------------------Q------QQ-#------------------ooo---------Q#-----SSUS----------------------------So-------###-
----tt-----tt------------------|###-##--------------tt-----tt---------------##---------TT---------------B--###-----------------#---------------------------#####
----tt-----tt------------------|###-##--------------tt-TT--tt--------------###---------TT---------------b-##-------------------#--------------------------#####-
----tt-----tt------K-U---------|#---###---------g---tt-TT--tt--------g----#####--------TT-k------y---K--b-##-------------------#---------------------g---#######
XXXXXXXXXXXXXXXXXXXXXXXXXXXXXXXXXXX-XXXXX------XXXXXXXXXXXXXXXXXXXXXXXXXXXXXXXXXXXXXXXXXXXXXXXXXgXXXXXXXXXXXXXXX----XXX--XX----XXXXXXXXXXXXXXXXXX---XXXXXXXXXXXX
XXXXXXXXXXXXXXXXXXXXXXXXXXXXXXXXXXX-XXXXX------XXXXXXXXXXXXXXXXXXXXXXXXXXXXXXXXXXXXXXXXXXXXXXXXXXXXXXXXXXXXXXXXX----XXX--XX----XXXXXXXXXXXXXXXXXX---XXXXXXXXXXXX
