-------------------------------------------------------------------------------Q--------------------------------------------------------------------------------
---oo----------------------------------------------------------------------K-K----------------------------------------------------------------------------------
------------------------------------------------------------------------------Q---------------------------------------------------------------------------------
----------------------------------------------------------------ooooo---------%%-----------------oo------------------S--SSSSS-SS-----------------------------S-S
-------------------------------------------------------------------QQ-K-------||--------------------------------------------------------------------------------
------------------------------------------%%%%----------------------%%%%%%%%--||--------------------------------------------------------------------------------
#####--------------------------------------||------------------------||||||---||-----------------------------o--------ooSSS-------U-----------------------------
------------------------------------oooo---||------------------------r||r||---U|-----------------o--------SSSSS------------------------------------------SSSS---
-----------------------------------%%--%%%-%|-------------------%%%%%%%%%%%%%-||----------------------------SS-------------------------%%%%---------------------
-----------------------------------||---|--||--------------------|||||||||||--r|----------------------o----SSSS-------------------------||---------------SS-----
--------------TT----------------TT-||-tt|--||----------QQ------Q-||||||||||%%%%%---------------------SSUSSS--%%------SSS--S-K-----------||----------------------
-------T------TT----TT----------TT-||-tt|--||--T-----------------||||||||||-|||------------------------------||-------------------------||-------------TT-------
-------TT-----TT----TT-TT-------TT-||-tt|--||--T-----------------||||||||||-|||-------------------------SS%%-||-------------------------||-------------TT-------
-------TT-----TT----TT-TT-k-----TT-||-tt|--||--T---g---ggg----gg-||||||||||-|||--------k-------k----------||-||----g---k----------------||-y-----------TT-------
XXXXXXXXXXXXXXXXXXXXXXXXXXXXXXXXXXXXXXXXXXXX|-XXXXXXXXXXXXXXXXXX-||%%%%|%%%%%%|-XXXXXXXXXXXXXXXX-XXX-----%%|-||-XXXXXXXXXXXXXXXXXXXXXX--XXXXXXXXXXXXXX-XXXXXXXXX
XXXXXXXXXXXXXXXXXXXXXXXXXXXXXXXXXXXXXXXXXXXX|--XXXXXXXXXXXXXXXXX-||-gg-|g|||g-|-XXXXXXXXXXXXXXXX-XXX-----|||-||-XXXXXXXXXXXXXXXXXXXXXX--XXXXXXXXXXXXXX-XXXXXXXXX
