----------------------------------------------------------------------------------------------------------------------------------------------------------------
----------------------------------------------------------------------------------------------------------------------------------------------------------------
----------------------------------------------------------------------------------------------------------------------------------------------------------------
--SSSS------------------------------------------------------------------------------------------------------S-SS--SSSSSSSSSSSSSS--------------------S-----------
-----------------------------------------------------------------------------------------------------------------------------S----------------------------------
-----------------------------------------------------------------------------------------------------------------------------SS---------------------------------
-------#------------SQ-----------------------------------------------------------------SSS-------------------------S--------------------------SS----------S-----
------##--------------------------------------------oo-------------------------------------------o--------SS-----------------------------------S----------------
-----###---------------------------------------------------------------------------------------------------S----------------------SSS--S--SS--SS----------------
----####---------------------R------------------------------------------------o-------------U1------------SS---------------------------#------------------------
---#####-------T---oo--------#---------------------------TT----------------------oo----So---@-------------------SS--------------------S#S-SS-S-S------SUSSS-----
--######------TT------------##---------------------------TT---TT-------TT-------------------------------------------------------------##------------------------
-#######-TT---TT-----------###------------------T--------TT----T-------TT------------------------------##------------------------S-S--##-SSS--------------%%%%%-
########-TT---TT---g-gg---#####---------------g-T----y---TT---TT-------TT-------ggg-----ggggg----k------#-----------------------------##-------------------gg|--
XXXXXXXXXXXXXXXXX-XXXXXXXXXXXXXX%-%%----X---XXX-XXXXXXXXXXXXXXXXXXXX---XX-XXXXXXXXXXXXXXXXXXXXXXXXXXX--XX----XX-XXXXXXXXXXXXXXXXXXXXXXXXX---XX-XXXXXXXX----|||--
XXXXXXXXXXXXXXXXX-XXXXXXXXXXXXXXgg||---XX---XXX-XXXXXXXXXXXXXXXXXXXX---XX-XXXXXXXXXXXXXXXXXXXXXXXXXXX--XX-----X-XXXXXXXXXXXXXXXXXXXXXXXXX---XX-XXXXXXXX----|||--
