----------------------------------------------------------------------------------------------------------------------------------------------------------------
----------------------------------------------------------------------------------------------------------------------------------------------------------------
----------------------------------------------------------------------------------------------------------------------------------------------------------------
--------------------------------SSSSSSSSSSSSSSSS------------------------------------------------SSSSSSSSS---SSSS------------------------------------------------
---------------------------------SSSSSSSSSSSSSSS-------------K------------------------------------S-------------------------------------------------------------
---------------------------------SSSSSSSSSSSSSSS-------------------------------------------------SS----o--------------------------------------------------------
--------------------SSo--ooo--@%------SSSSSSSSSS-------U--------------------------------------------------------------------------------------------------------
------#------------------------|---------SSSSSS-------------------------------------------------SSSS-----------------------------------------------------------y
S----##--------------S---SS-y--|-ySS------SSSSS--------------y#Q--------------------------------SS-------------------------%---------------------------#-------#
----###--------------------K2--|USS---S--SSSSSSS-------------2#-----------oo--SS-----------------KS------------------------|---------------------------##----###
--#####--##----------------SS--|SS----SS%SSSSSSS--2S---S----###------%%%%%----S---------------------##-##------------------|--%%--------------#--------##---####
--#####--##--------#-----------|--------|------------------####-------|||-----#---------------------##-##---------TT-------|--||--------------#--------##--#####
-######--##--------#-----------|-S----S-SS%%-SS-----------#####-------|||---#-#---------------------##-##---------TT-------|--||--------------#-------##--######
#######--##------#-#-#---------|----------||----K--------#######------|||--####---------------------##-T#---------TT-------|--||------------#-#-------##########
XXXXXXXXXXX----XXXXXXXXXXXXXXXXX-%%%%-%-%%%%%---XXXXXXXXXXXXXXXX-XXX--||XXXXXXXXXX--XXXXXXXX--XXXXXXXXXXXXXXXXXXXXXXX--XX--|--||X-XX---XX--XXXXXXXXXXXXXXXXXXXXX
XXXXXXXXXXX----XXXXXXXXXXXXXXXXX--||--|--|||----XXXXXXXXXXXXXXXX-XXX--||XXXXXXXXXX--XXXXXXXX--XXXXXXXXXXXXXXXXXXXXXXX--XX--|--||X-X----XX--XXXXXXXXXXXXXXXXXXXXX
