----------------------------------------------------------------------------------------------------------------------------------------------------------------
----------------------------------------------------------------------------------------------------------------------------------------------------------------
-----------1---------------------------------------------------------------------------K-------------------R----------------------------------------------------
----------------SSSSSSSSSSSSSSSS--------------------------------------------------------------------------------------------------------------------------------
----------------SSS---------------------------------------------------------------------------------------------------------------------------------------------
-----------------SSSS--------------------------------------------------o----------------------------------------------------------------------------------------
----SSSooooo---%--------------S--------------------S-----------S----------------o--------g--------ooSUSUSSSSS-@%------UR----------------------------------------
---------------|--SSS------------o--------------------------------oo-----------------%%%-----U-----------------|--%%%%%%----------------------------------------
---------------|SSSS-------------------##---------------------------------------------|------------------------|---||||-----------------------------------------
------------U--|-----------------------##---------------------------------------------|------------------------|---||||----------------------------g---------g--
-2-------@SS---|S-#-#-----------------###---------%%%%%%%--------##-------------o2----|------------------@SSQQQQQQQQQ||-----------------------------------------
---------------|#-#-#----##----#------###----------|||||--------#------TT------T------|-----TT-----------------------||--------------------------------------#--
---------------|###-#-#--#-----#------###----------|||||--%%%---T------TT------T-----B|--TT-TT-----#--B--------------||-------------TT----------------------##--
----gR---------|#---#-#--------#------###----------|||||--g|----T------TT------T-----b|k-TT-TT-k---#-rb------ggg-g-gggg--------k----TT------#-----------K--###--
X---XXXXXXXXXXXXX---XXXX-X-----XXXXXX--XX-----XX---|||||---|----XXXXXXXXXXXXXXXXXX--XXXXXXXXXXXXXXXXXXXXXXXXXXXXXXXXXXXXXXXXXXXXXXXXXXXXXXXXXXXXXXXXXXXXXXXXXXXX
X---XXXXXXXXXXXXX---XXXX-------XXXXXX-XXX-----XX---|||||---|----XXXXXXXXXXXXXXXXXXX-XXXXXXXXXXXXXXXXXXXXXXXXXXXXXXXXXXXXXXXXXXXXXXXXXXXXXXXXXXXXXXXXXXXXXXXXXXXX
