----------------------------------------------------------------------------------------------------------------------------------------------------------------
----------------------------------------------------------------------------------------------------------------------------------------------------------------
----------------------------------------------------------------------------------------------------------------------------------------------------------------
-----------------------------------------------SSSS-SSS-----------------------SSSSSSSSSSSSSSSSSS----------------SSSSSSSSSSSSSSSS----------------S--SSSSSS-------
----------o-----t-----------------S-------------------------------------------------SSSS--S----------------------SSSSSSSSSSSSSSS--------------------------------
%--------S------t--------------------------------------------------------------------SS--SSS--------------------SSSSSSSSSSSSSSS---------------------------------
|------------------------------o----------SSSSSS--------------------Q--------------S------SS-------------------o------S----KSSS---------------@%--S-------------
|---------------------------------S-------SSSSS------oo----------------------------------------------%---------------------SS------------------|----------------
|--------------------------------------SSSSSSSS-%----%%%%%-%%--------------------------SS------------|-----------------------------------------|-----#----------
|--------o------------------------S--SS--SSSSS--|-----|||--||--------------------------r-------S-----|------------SSo-ooo---oSSS---------------|----##----------
|------------------------------S----SSSSSSSSSSS-|-----|||--||-------------------%%%%%%%%%%------QQQ--|-QQ----------SSS%--%%%%%%%---#-----------|---####--##-----
|------------------------------t--------S-------|-T---|||--||----------------#---||||||||----#-------|----------------|---|||||----#-----------|--#####--##-----
|--------------------------tt--t-------SSS%%-SS-|-TT--|||--||----------------#--S|||||||S----#-------tt---------S-----|--S||||S----#-----------|-######--##-----
|--------k-------g---------tt-kt----------||----|-TT--|||--||----kkg-------###---|||||||---------g---tt------ggg------|---||||-----#-#---------|#######--##-----
XX-------XXXXXXXXXXXXXXXXXXXXXXXS--%------%%----|XXXX-|||--||---XXXXXXXXXXXXXXXX%|%%%%%%%-------XXXXXXXXXXXXXXXX-%%%%%%%%%%%||--XXXXXXXXXXXXXXXXXXXXXXXXXXXX----
XX-------XXXXXXXXXXXXXXXXXXXXXXX---|------||----|XXXX-|||--||---XXXXXXXXXXXXXXXXg|-|||||--------XXXXXXXXXXXXXXXXg-|||||||||-||--XXXXXXXXXXXXXXXXXXXXXXXXXXXX----
